Humid,Nitrogen_oxide,NO,NO2,Temprature,oxidant,PM_2_5
57,21,0,21,140,29,17
56,29,1,28,133,19,17
58,16,0,16,126,27,17
60,11,0,11,124,33,10
58,15,0,15,116,28,12
61,29,2,27,108,13,15
58,41,11,30,111,5,20
51,37,11,26,122,10,22
39,24,6,18,157,25,26
36,16,3,13,172,35,27
39,12,2,10,169,41,22
42,10,2,8,175,47,18
38,9,2,7,171,46,15
44,10,2,8,160,47,15
50,9,2,7,143,47,12
54,8,1,7,132,48,15
57,8,1,7,121,48,16
59,7,1,6,113,49,20
57,5,0,5,113,50,23
55,6,0,6,109,49,21
64,5,0,5,104,50,24
69,7,1,6,94,49,21
66,8,1,7,94,47,17
64,5,0,5,95,46,17
62,6,0,6,92,43,15
62,6,0,6,89,43,13
65,5,0,5,88,43,11
61,6,0,6,89,41,12
58,8,0,8,91,37,14
56,10,0,10,92,34,14
56,11,0,11,93,30,16
53,11,1,10,97,31,17
52,11,1,10,99,30,18
52,13,1,12,104,28,15
52,16,2,14,110,30,14
52,15,3,12,119,32,12
51,13,2,11,123,36,11
49,12,2,10,128,38,10
50,10,1,9,132,40,8
54,10,1,9,133,41,11
57,11,1,10,129,38,10
60,11,1,10,123,37,6
62,9,0,9,120,37,9
66,7,0,7,114,38,9
66,7,0,7,112,37,10
70,7,0,7,111,37,12
78,7,0,7,106,33,11
81,6,0,6,104,34,10
81,5,0,5,104,34,10
84,6,0,6,103,31,11
84,5,0,5,101,32,12
83,5,0,5,103,32,11
82,6,0,6,103,29,14
83,7,0,7,105,26,18
83,13,0,13,105,20,16
83,14,1,13,106,22,18
83,12,1,11,108,24,18
83,16,2,14,115,21,17
84,21,4,17,123,19,20
77,30,8,22,143,18,23
72,32,7,25,145,21,33
72,32,5,27,152,21,26
70,32,6,26,161,22,20
67,31,5,26,168,24,24
67,24,2,22,168,29,19
69,15,1,14,166,37,13
73,16,0,16,162,35,14
71,27,1,26,162,22,14
68,19,1,18,162,29,14
66,15,0,15,161,30,16
67,10,0,10,159,33,17
69,9,0,9,159,34,14
75,8,0,8,160,34,15
82,13.50684932,1.493150685,12.01369863,155,30,16
85,12,0,12,151,24,13
86,12,0,12,152,23,12
88,11,0,11,156,23,11
88,17,1,16,158,18,7
88,25,2,23,159,12,7
89,28,3,25,167,12,5
86,25,3,22,174,17,5
83,40,10,30,173,9,10
84,42,12,30,172,9,12
82,36,14,22,177,9,8
70,28,10,18,198,17,8
63,29,7,22,211,21,30
60,25,5,20,213,25,17
66,21,3,18,200,27,6
65,19,3,16,143,28,0
70,9,2,7,115,35,2
71,6,1,5,110,38,0
71,4,0,4,108,40,0
69,4,0,4,109,42,1
71,4,0,4,109,41,3
73,3,0,3,108,42,4
78,4,0,4,105,39,3
80,3,0,3,102,36,3
80,3,0,3,102,36,2
83,3,0,3,99,36,4
85,3,0,3,98,34,2
85,4,0,4,98,34,2
86,7,0,7,99,33,1
85,10,1,9,97,29,3
83,9,1,8,99,29,6
76,14,3,11,102,28,6
64,13.90006523,1.823744292,12.07632094,108,31.53333333,8
63,17,4,13,112,30,3
58,18,4,14,115,29,9
55,21,5,16,118,27,7
53,23,5,18,121,25,10
53,22,4,18,122,24,11
52,24,5,19,126,24,12
50,22,3,19,125,25,14
52,20,1,19,124,26,10
54,21,1,20,122,24,9
57,17,1,16,121,25,9
57,16,0,16,119,24,8
56,22,1,21,119,19,10
62,25,1,24,110,15,14
65,32,1,31,103,8,13
68,39,6,33,97,4,11
72,66,29,37,95,1,12
73,71,34,37,92,1,13
74,71,35,36,88,1,15
77,75,38,37,86,1,19
79,93,59,34,85,1,18
79,68,38,30,90,2,15
75,95,59,36,104,3,20
57,89,50,39,134,5,29
47,60,27,33,156,11,28
38,43,14,29,173,19,30
28,36,8,28,192,29,31
33,40,9,31,196,31,24
32,48,10,38,194,28,27
27,38,7,31,202,35,16
28,26,3,23,191,43,22
36,24,1,23,181,44,5
48,20,1,19,171,45,7
54,30,1,29,166,33,8
56,27,0,27,165,34,10
59,20,0,20,164,43,10
60,20,0,20,163,41,15
62,19,0,19,161,41,17
64,24,0,24,156,32,17
66,22,0,22,153,29,17
67,20,0,20,152,29,15
66,24,0,24,150,22,16
66,28,1,27,151,17,15
66,22,0,22,150,21,15
71,35,3,32,148,11,13
78,44,7,37,142,4,15
83,53,17,36,138,2,13
84,66,31,35,129,2,17
85,60,25,35,125,2,16
85,56,20,36,124,3,12
86,43,9,34,124,10,12
86,30,4,26,126,18,10
87,26,4,22,130,22,7
86,24,3,21,132,24,7
85,33,4,29,132,19,7
85,39,4,35,136,14,4
84,56,11,45,140,6,13
84,36,2,34,134,11,10
83,29,1,28,132,13,6
83,18,1,17,131,20,9
82,18,0,18,132,20,8
81,22,1,21,133,15,11
78,19,1,18,132,17,10
79,21,1,20,131,12,8
79,27,1,26,128,7,6
80,33,3,30,126,3,8
81,30,4,26,125,4,9
82,53,23,30,122,1,9
82,107,74,33,121,1,10
70,68,38,30,137,5,11
53,32,9,23,161,14,14
55,21,5,16,173,23,18
49,13,3,10,185,28,11
44,13,3,10,201,30,12
35,10,2,8,213,34,6
32,8,1,7,221,44,16
46,12,1,11,202,51,9
46,14,1,13,193,43,2
47,14,1,13,176,43,0
49,16,1,15,166,41,6
55,13,0,13,161,42,0
56,12,0,12,156,44,2
59,16,0,16,150,37,4
61,18,1,17,147,34,11
60,13,0,13,146,39,11
61,13,1,12,142,40,13
62,11,0,11,139,39,16
61,8,0,8,137,42,13
62,9,0,9,135,42,16
65,12,0,12,128,34,14
66,16,0,16,125,27,13
67,18,0,18,122,24,15
67,39,5,34,125,9,15
65,41,8,33,133,13,17
59,30,6,24,151,23,24
56,40,9,31,173,25,28
47,27,4,23,193,41,27
40,17,2,15,204,44,29
37,11,1,10,216,45,11
36,9,1,8,220,46,16
37,8,1,7,215,47,11
42,8,1,7,208,50,7
44,6,0,6,203,49,7
54,7,0,7,195,49,7
61,9,0,9,187,49,7
65,11,0,11,183,47,8
64,15,0,15,178,45,11
54,15,0,15,176,47,12
54,17,0,17,172,46,15
55,16,0,16,168,45,15
55,23,0,23,164,36,18
57,23,0,23,159,33,22
64,24,0,24,151,27,19
70,24,0,24,144,17,16
73,24,1,23,140,12,15
73,22,0,22,138,11,15
73,25,2,23,140,11,17
71,28,5,23,145,8,17
66,35,9,26,155,10,18
59,23,5,18,174,20,25
50,16,3,13,199,32,29
39,12,1,11,220,42,35
26,11,1,10,234,50,22
18,7,0,7,242,56,26
22,6,0,6,240,64,20
22,11,0,11,236,70,20
33,11,0,11,219,68,17
39,17,0,17,211,58,14
44,20,0,20,199,51,10
48,16,0,16,189,50,18
65,8,0,8,135,43,16
66,5,0,5,125,43,1
67,5,0,5,118,43,10
70,4,0,4,116,43,9
72,4,0,4,113,40,11
71,4,0,4,115,40,10
70,3,0,3,112,41,14
70,3,0,3,111,41,12
70,3,0,3,112,39,11
69,6,0,6,114,36,12
71,7,0,7,112,36,14
68,9,0,9,114,33,14
63,10,1,9,115,35,14
77,16,2,14,109,31,14
70,17,3,14,103,27,13
60,22,6,16,119,26,13
25,16,4,12,155,30,15
20,7,1,6,156,42,15
19,6,1,5,157,40,5
18,6,1,5,154,43,8
17,6,1,5,146,43,7
18,7,1,6,128,42,6
18,7,1,6,115,42,3
20,4,0,4,105,44,2
25,5,0,5,94,42,5
30,4,0,4,85,43,8
31,4,0,4,81,44,10
32,4,0,4,79,45,13
36,7,0,7,74,39,16
37,6,0,6,69,40,14
38,20.03172421,4.027610924,16.00411328,69,40,14
39,7,0,7,65,39,18
43,9,0,9,60,37,18
45,16,0,16,56,31,17
48,17,1,16,51,31,22
43,20,2,18,58,28,22
32,14,2,12,76,34,27
29,19.894995,3.957148919,15.93784608,104,30.28137255,26
20,12,3,9,116,36,25
20,10,2,8,124,37,19
19,7,1,6,135,39,18
22,9,1,8,137,41,20
21,9,1,8,142,47,22
26,10,1,9,149,51,21
30,10,1,9,143,48,11
33,11,1,10,136,45,15
41,12,1,11,132,48,3
43,12,0,12,129,44,6
48,9,0,9,128,46,9
50,9,0,9,130,44,11
52,10,0,10,132,42,11
53,9,0,9,133,42,11
55,10,0,10,134,40,13
56,11,0,11,136,38,15
57,10,0,10,138,39,14
50,20,0,20,127,26,15
52,19,0,19,121,29,19
61,18,0,18,116,28,16
68,25,0,25,116,20,17
70,41,3,38,117,9,21
75,44,5,39,116,7,17
77,59,16,43,113,4,21
81,85,37,48,125,3,22
78,64,19,45,136,6,24
74,63,18,45,144,7,23
65,77,27,50,160,7,24
53,14,2,12,177,40,18
48,9,1,8,193,44,13
52,9,1,8,188,42,14
54,9,1,8,178,44,13
60,13,0,13,173,41,4
63,14,0,14,169,40,5
68,14,0,14,166,39,8
76,13,0,13,161,37,10
83,13,0,13,155,34,10
84,10,0,10,154,36,6
86,13,0,13,156,27,5
87,13,0,13,156,26,11
87,15,0,15,157,19,10
87,17,0,17,155,15,11
87,15,0,15,150,13,6
86,13,0,13,140,17,1
87,11,0,11,135,25,2
87,12,1,11,139,26,2
87,14,1,13,144,23,5
86,24,3,21,145,15,11
86,24,5,19,149,18,8
84,21,5,16,151,22,7
82,21,5,16,155,23,8
81,17,4,13,160,26,13
77,17,3,14,163,27,12
73,17,4,13,171,28,12
70,14,3,11,182,31,12
69,12,2,10,182,35,16
70,12,1,11,176,36,9
72,11,0,11,170,34,0
75,16,0,16,164,27,7
76,15,0,15,158,25,10
77,21,1,20,157,20,6
78,19,0,19,156,18,8
78,21,1,20,155,16,6
79,23,1,22,156,15,5
67,28,2,26,158,11,11
45,19,1,18,159,28,9
36,9,0,9,163,43,12
37,11,0,11,151,40,14
29,13,0,13,152,37,11
27,12,1,11,156,36,8
26,10,1,9,165,36,10
22,9,1,8,181,38,13
23,9,2,7,187,41,16
23,8,2,6,187,40,7
19,7,1,6,192,40,9
16,7,1,6,195,41,8
15,7,1,6,195,42,9
14,7,1,6,197,43,0
15,6,1,5,185,45,9
14,10,2,8,179,43,0
16,9,1,8,169,44,8
16,9,0,9,157,42,4
17,12,0,12,148,38,1
20,16,0,16,141,33,7
21,19,0,19,134,29,6
21,22,0,22,129,25,7
20,18,0,18,124,28,7
26,19,0,19,119,26,3
22,21,0,21,121,23,9
39,16,0,16,119,27,9
45,16,0,16,113,24,10
46,18,0,18,110,23,10
48,16,0,16,111,27,9
45,13,1,12,116,30,10
43,12,1,11,128,30,10
38,17,3,14,144,30,17
36,13,2,11,154,33,19
39,13,2,11,169,35,20
41,11,2,9,185,39,23
48,9,1,8,196,42,24
50,8,1,7,197,42,3
48,8,1,7,204,43,10
37,9,1,8,202,44,8
39,10,1,9,194,54,8
52,13,0,13,183,54,4
57,23,0,23,178,43,2
59,24,0,24,176,39,12
56,23,0,23,176,41,14
56,17,0,17,174,47,13
46,11,0,11,175,53,11
57,16,0,16,172,43,13
66,15,0,15,172,43,12
66,10,0,10,178,45,11
67,7,0,7,177,46,9
62,3,0,3,178,51,7
63,4,0,4,177,51,8
63,3,0,3,177,52,7
64,5,0,5,179,51,9
63,6,0,6,182,48,10
60,6,1,5,187,46,10
62,4,0,4,187,48,12
66,4,0,4,189,45,11
71,5,1,4,187,41,12
84,3,0,3,177,43,12
82,4,0,4,187,41,3
68,5,1,4,218,34,9
61,5,1,4,233,33,22
63,6,1,5,226,34,30
58,4,0,4,229,37,12
71,6,0,6,207,36,7
69,11,0,11,208,31,16
72,10,0,10,199,33,16
75,9,0,9,195,34,19
79,7,0,7,187,36,16
81,6,0,6,182,37,19
79,7,0,7,180,38,17
75,11,0,11,180,37,19
79,11,0,11,175,39,18
78,14,0,14,173,34,18
77,16,0,16,173,33,18
77,25,1,24,172,27,17
68,31,5,26,182,22,21
67,36,12,24,184,12,34
61,32,10,22,199,19,27
47,23,5,18,223,28,27
44,25,5,20,233,32,20
40,20,3,17,243,43,20
39,16,2,14,230,48,21
41,19,1,18,217,51,18
43,24,1,23,211,47,0
44,22,1,21,204,48,11
51,34,2,32,199,36,5
56,16,1,15,184,48,26
67,8,0,8,161,51,9
63,8,0,8,151,50,10
62,8,0,8,143,52,11
63,7,0,7,142,51,10
62,8,0,8,143,47,14
62,7,0,7,143,44,17
65,9,0,9,142,36,17
63,18.19938484,3.118479572,15.08090526,142,32,15
63,8,0,8,142,34,15
64,14,0,14,141,27,17
67,19,0,19,138,20,16
68,40,6,34,134,7,16
56,21,3,18,144,22,17
46,11,2,9,157,31,23
39,18.20802959,3.100954851,15.10707474,176,31.86548797,22
37,12,3,9,191,35,30
33,17,3,14,199,34,17
37,13,2,11,201,46,14
37,10,1,9,209,50,15
41,9,1,8,210,52,20
41,9,1,8,215,52,19
41,8,1,7,209,55,17
45,11,1,10,198,56,7
52,13,1,12,193,50,17
59,7,0,7,145,53,2
64,6,0,6,131,52,6
62,5,0,5,130,53,4
63,5,0,5,130,53,10
65,8,1,7,129,49,12
66,7,0,7,120,45,13
63,9,0,9,120,47,11
62,10,0,10,118,45,15
59,8,0,8,114,44,11
64,8,0,8,108,39,12
70,9,0,9,103,34,10
70,12,1,11,103,31,8
62,11,1,10,115,33,10
52,10,2,8,131,35,13
45,10,2,8,154,39,12
38,9,2,7,161,42,16
34,7,1,6,173,44,15
31,9,1,8,180,46,22
31,11,1,10,185,50,13
25,10,1,9,184,57,9
35,10,1,9,180,55,9
36,13,1,12,185,54,18
34,9,1,8,182,54,2
39,8,0,8,174,55,8
42,9,0,9,166,51,2
45,10,0,10,164,50,9
50,10,0,10,160,49,5
55,10,0,10,159,47,8
61,12,0,12,164,45,10
60,16,0,16,165,41,10
58,15,0,15,166,42,12
57,19,0,19,158,30,13
58,27,1,26,154,19,14
58,35,1,34,146,8,15
60,40,3,37,141,4,13
60,48,11,37,137,2,12
60,40,9,31,137,7,18
66,44,11,33,170,11,22
63,43,13,30,184,20,25
63,16,2,14,191,40,16
58,12,2,10,196,43,18
56,11,1,10,195,44,8
55,13,1,12,195,42,12
57,13,1,12,194,42,16
65,17,1,16,185,41,4
66,15,1,14,185,40,12
69,20,1,19,181,35,12
80,14,1,13,173,40,13
81,11,0,11,170,42,10
62,10,0,10,163,46,10
70,15,0,15,160,44,11
76,15,0,15,156,43,13
82,15,0,15,153,40,12
85,11,0,11,151,37,11
85,8,0,8,151,34,9
85,9,0,9,146,32,11
85,9,0,9,139,34,9
85,7,0,7,139,40,8
83,13,0,13,140,34,6
83,15,1,14,141,30,9
79,14,2,12,148,30,9
71,10,2,8,166,33,15
59,13,3,10,187,33,19
58,13,3,10,210,35,21
59,11,3,8,209,36,14
56,11,3,8,213,34,5
54,10,2,8,221,39,8
52,16,3,13,220,40,11
52,11,2,9,213,43,13
55,8,1,7,196,45,3
58,8,1,7,181,46,3
61,7,1,6,170,48,2
64,7,1,6,160,49,2
66,6,0,6,155,48,1
66,5,0,5,154,50,1
66,4,0,4,152,51,4
68,5,1,4,149,52,5
71,3,0,3,146,53,6
72,2,0,2,143,53,7
72,2,0,2,143,52,5
72,2,0,2,142,53,9
73,2,0,2,140,51,7
74,2,0,2,140,50,6
74,6,0,6,140,45,6
73,8,0,8,142,38,11
70,10,1,9,149,38,14
64,17,3,14,164,32,16
59,12,2,10,178,35,21
57,19,3,16,189,33,27
56,18,3,15,203,41,19
50,10,1,9,216,46,9
48,8,1,7,221,47,18
48,8,1,7,222,46,11
49,8,1,7,220,48,11
56,14,1,13,213,44,5
62,17,1,16,204,40,2
67,14,0,14,199,39,4
71,19,1,18,197,30,8
72,26,1,25,195,22,2
74,22,0,22,193,25,12
78,20,0,20,190,25,11
79,22,1,21,190,22,11
81,22,1,21,189,19,6
82,20,1,19,187,18,12
83,14,0,14,184,24,10
83,16,0,16,183,21,11
80,15,0,15,177,18,12
83,3,0,3,135,56,17
84,3,0,3,127,56,22
84,3,0,3,125,53,25
86,4,0,4,128,51,24
83,4,0,4,132,50,27
70,5,1,4,142,47,31
47,5,1,4,165,43,29
33,3,0,3,176,44,31
28,3,0,3,187,44,24
25,3,0,3,194,47,25
25,3,0,3,189,50,28
35,3,0,3,178,53,12
40,4,0,4,170,54,16
48,7,0,7,163,49,19
53,12,0,12,161,41,23
55,11,0,11,161,42,25
61,12,0,12,157,38,27
60,7,0,7,153,43,25
61,7,0,7,151,43,21
58,8,0,8,150,38,23
58,5,0,5,147,43,20
56,5,0,5,146,43,15
56,6,0,6,145,43,15
57,8,0,8,143,40,19
61,9,0,9,142,35,14
58,13,1,12,148,28,16
52,14,2,12,161,26,20
45,13,3,10,186,29,26
41,12,3,9,203,33,38
39,9,1,8,209,35,23
35,12,2,10,219,37,18
33,11,2,9,223,47,21
32,10,1,9,226,43,7
31,9,1,8,223,44,15
32,10,1,9,217,45,10
35,11,1,10,210,44,5
42,12,1,11,199,42,0
48,10,0,10,192,41,7
50,10,0,10,188,40,5
52,11,0,11,185,38,1
55,18,1,17,182,31,10
57,19,0,19,177,28,7
59,20,0,20,175,23,9
61,30,1,29,173,12,9
63,16.51204833,2.549951896,13.96209644,169,8,11
65,25,1,24,167,14,11
67,28,1,27,163,11,10
69,39,3,36,158,4,13
72,46,13,33,153,3,12
70,48,17,31,162,6,12
61,38,11,27,182,13,19
56,16.71752154,2.600445791,14.11707575,199,33.76921085,12.97697368
45,16,3,13,219,34,18
41,11,2,9,228,42,19
38,10,1,9,233,46,20
38,8,1,7,240,48,16
40,10,1,9,243,49,18
41,9,1,8,241,54,17
44,11,1,10,235,59,15
48,11,1,10,229,48,13
48,16,1,15,219,40,12
52,18,0,18,211,37,0
59,17,0,17,199,36,16
63,14,0,14,191,36,3
64,13,0,13,189,38,10
67,10,0,10,187,39,9
69,13,0,13,185,33,12
71,13,0,13,180,32,11
72,15,0,15,179,29,12
74,17,0,17,176,24,11
74,19,0,19,176,19,12
74,22,1,21,167,11,13
78,13,1,12,163,18,8
71,8,1,7,158,30,9
67,9,1,8,170,36,10
63,9,2,7,182,39,15
60,11,2,9,193,39,18
56,12,2,10,203,41,22
55,12,2,10,205,45,34
54,16,2,14,213,43,20
56,12,2,10,200,45,23
57,13,2,11,200,44,6
59,12,2,10,195,46,24
62,11,1,10,186,46,7
66,9,1,8,172,48,20
68,8,0,8,164,47,14
70,8,0,8,162,44,12
73,7,0,7,160,44,14
74,10,1,9,158,41,18
80,8,1,7,151,42,19
81,4,0,4,145,43,15
83,4,0,4,144,44,15
84,4,0,4,141,45,15
85,3,0,3,140,46,16
85,3,0,3,137,43,14
86,4,0,4,137,42,12
86,5,0,5,134,40,7
87,6,0,6,135,39,3
87,6,0,6,134,39,3
87,8,1,7,136,38,5
87,11,1,10,139,35,3
88,16,3,13,145,32,3
88,17,4,13,150,32,4
87,11,2,9,149,36,5
87,11,2,9,151,37,2
87,14,2,12,154,36,4
88,14,2,12,155,35,1
87,14,2,12,152,32,0
87,14,1,13,150,27,0
87,13,1,12,149,30,0
87,14,1,13,147,29,3
87,11,0,11,148,29,4
87,9,0,9,146,31,3
88,9,0,9,147,30,3
87,10,0,10,148,30,3
82,12,0,12,150,28,3
68,10,0,10,153,33,2
55,5,0,5,160,40,1
49,4,0,4,164,44,0
45,4,0,4,159,46,0
45,5,0,5,152,44,4
39,6,0,6,158,41,5
34,5,1,4,166,42,7
31,3,0,3,170,44,4
28,5,1,4,178,44,5
27,3,0,3,186,42,3
27,3,0,3,187,41,6
24,4,1,3,190,42,7
25,4,1,3,196,42,4
24,3,0,3,191,43,5
25,3,0,3,179,45,4
24,3,0,3,165,45,2
25,3,0,3,155,46,2
29,3,0,3,144,48,0
29,4,0,4,141,48,1
34,5,0,5,133,46,7
37,8,0,8,127,41,4
40,13,1,12,121,37,11
40,10,0,10,118,38,10
40,11,0,11,116,37,10
38,11,0,11,117,36,10
38,15,0,15,112,31,12
42,15,0,15,109,31,13
44,14,0,14,108,35,8
45,23,1,22,111,27,7
37,20,2,18,132,29,10
29,19,4,15,153,33,17
23,12,2,10,175,39,19
22,9,1,8,193,40,16
22,9,1,8,201,40,20
30,15,2,13,205,39,29
38,12,2,10,196,44,14
40,9,1,8,195,49,2
44,8,1,7,197,54,12
46,7,1,6,192,53,10
48,8,1,7,182,51,18
45,7,0,7,175,54,0
52,8,0,8,169,59,7
54,11,0,11,169,56,10
55,12,0,12,166,53,15
59,13,0,13,164,48,16
60,17,0,17,160,41,16
60,21,0,21,155,33,17
64,22,0,22,147,23,18
64,18,0,18,144,23,19
66,20,0,20,138,19,15
68,16,0,16,132,21,14
70,16,0,16,129,18,13
72,23,2,21,128,12,16
66,16,2,14,143,18,18
57,11,2,9,165,26,24
52,14,3,11,184,32,32
48,14,3,11,196,35,35
41,11,1,10,217,41,17
37,11,1,10,231,50,25
34,16,1,15,237,63,27
32,19,1,18,249,70,29
33,14,1,13,248,68,29
37,9,0,9,242,79,25
43,12,0,12,233,80,23
47,23,1,22,224,57,29
50,16,0,16,202,61,21
52,8,0,8,188,69,17
60,6,0,6,173,67,18
66,6,0,6,165,61,14
69,6,0,6,161,55,16
74,5,0,5,154,53,14
75,4,0,4,144,48,15
74,3,0,3,142,51,14
74,2,0,2,137,50,14
74,3,0,3,138,51,17
72,4,0,4,136,48,18
71,5,0,5,139,45,15
71,9,1,8,142,39,20
69,8,1,7,144,39,19
64,8,2,6,159,38,13
62,11,2,9,165,40,24
60,11,2,9,175,41,17
56,11,2,9,189,41,23
52,12,2,10,206,45,40
50,12,2,10,215,49,32
50,11,1,10,219,54,31
50,10,1,9,221,55,29
54,12,1,11,213,52,29
57,12,0,12,206,50,15
60,12,0,12,198,47,23
63,12,0,12,193,46,21
68,12,0,12,187,44,25
73,11,0,11,183,40,15
74,13,0,13,182,36,11
72,11,0,11,183,38,17
73,11,0,11,181,40,19
75,15.43949365,2.211536394,13.22795726,179,39,15
75,11,0,11,180,32,12
74,11,0,11,180,32,21
75,11,0,11,179,33,23
76,12,0,12,181,33,24
75,12,1,11,189,39,24
69,10,1,9,202,44,32
62,11,1,10,210,47,43
59,15.40078521,2.195473646,13.20531157,221,35.40083578,22
52,6,1,5,237,44,37
40,6,1,5,241,46,32
45,5,1,4,240,49,25
51,5,1,4,224,49,26
60,5,1,4,221,48,19
62,5,1,4,215,43,27
67,6,1,5,207,36,18
73,9,1,8,202,31,19
72,8,0,8,199,32,12
71,7,0,7,199,35,18
74,4,0,4,198,38,14
73,3,0,3,198,40,12
75,2,0,2,198,43,10
72,2,0,2,200,43,8
67,5,0,5,203,39,9
66,4,0,4,206,39,11
68,2,0,2,207,39,8
67,4,0,4,208,37,12
65,1,0,1,212,40,4
82,1,0,1,196,39,13
86,2,0,2,194,37,5
85,2,0,2,199,36,0
84,1,0,1,205,36,3
69,4,1,3,225,31,10
47,5,1,4,234,38,27
40,5,1,4,241,44,28
39,5,1,4,235,48,15
39,5,1,4,238,51,20
34,7,1,6,251,54,17
19,8,1,7,269,51,19
21,5,0,5,258,52,15
23,6,0,6,248,55,14
30,8,0,8,234,58,8
34,10,0,10,223,55,5
31,13,0,13,221,50,18
32,10,0,10,215,52,14
28,11,0,11,216,51,22
29,8,0,8,214,56,13
31,6,0,6,210,57,18
33,5,0,5,209,58,11
38,4,0,4,201,57,16
41,5,0,5,195,53,17
45,5,0,5,194,54,16
43,6,0,6,195,51,15
36,8,1,7,211,48,22
31,7,1,6,225,47,33
23,7,1,6,244,50,35
18,4,0,4,257,51,23
17,3,0,3,265,49,21
16,4,0,4,269,52,19
18,4,0,4,266,55,16
19,5,0,5,271,65,19
20,7,1,6,267,64,11
20,7,1,6,270,68,13
22,9,1,8,256,68,17
24,13,1,12,250,65,17
34,12,1,11,237,62,12
41,6,1,5,214,72,10
43,5,0,5,205,73,12
43,6,0,6,197,68,17
46,7,0,7,190,59,14
44,8,0,8,187,53,19
36,8,0,8,184,48,15
35,11,0,11,179,32,10
34,11,0,11,173,33,7
36,12,0,12,168,30,4
37,20,0,20,166,23,6
37,24,1,23,169,20,5
35,31,4,27,177,17,8
40,12,1,11,189,34,10
46,15,3,12,206,33,15
48,12,2,10,214,36,28
45,11,2,9,222,41,12
44,13,3,10,227,42,11
46,10,1,9,223,46,12
48,9,1,8,216,45,12
58,11,1,10,203,44,0
59,13,1,12,200,41,6
61,14,1,13,200,39,7
73,11,0,11,190,43,14
79,13,0,13,187,37,5
81,13,0,13,185,32,11
81,11,0,11,184,37,11
76,10,0,10,173,48,13
74,8,0,8,172,52,12
72,10,0,10,169,50,11
52,10,0,10,178,48,10
40,5,0,5,189,56,12
39,3,0,3,190,59,8
39,3,0,3,190,59,7
49,4,0,4,186,59,7
53,6,0,6,182,56,7
54,10,1,9,189,50,8
55,10,1,9,198,47,12
50,12,2,10,219,47,15
52,11,2,9,224,43,20
54,8,2,6,222,41,6
55,7,1,6,226,40,13
57,7,1,6,225,39,11
57,10,2,8,230,42,14
56,12,2,10,234,43,13
55,9,1,8,237,45,12
56,10,1,9,233,44,7
58,14,1,13,228,44,13
63,16,0,16,219,42,5
67,20,0,20,213,37,10
68,23,1,22,212,31,10
64,22,1,21,216,29,19
62,10,0,10,216,41,20
62,6,0,6,209,44,15
59,7,0,7,202,40,2
48,10,0,10,197,37,20
33,6,0,6,194,44,13
34,5,0,5,188,45,22
35,5,0,5,183,44,25
36,6,0,6,182,42,29
28,6,1,5,192,41,31
24,3,0,3,208,42,35
18,3,0,3,223,44,34
15,2,0,2,237,43,17
14,2,0,2,248,40,23
10,2,0,2,259,39,15
10,2,0,2,264,40,11
12,2,0,2,267,43,15
15,4,0,4,266,50,14
31,13,1,12,253,64,21
38,9,1,8,222,55,24
36,8,1,7,215,53,19
45,7,0,7,206,52,10
53,10,0,10,203,46,34
58,11,0,11,200,43,21
60,5,0,5,198,49,33
61,4,0,4,197,51,33
66,5,0,5,194,49,31
66,6,0,6,193,46,32
70,6,0,6,190,44,32
70,8,0,8,186,39,30
68,10,0,10,184,34,30
68,16,0,16,182,28,27
66,27,2,25,183,18,30
64,29,4,25,190,17,30
55,24,4,20,205,25,29
50,16,2,14,208,35,35
48,13,2,11,214,38,16
43,13,2,11,218,38,24
44,11,1,10,219,44,14
46,10,1,9,217,44,17
52,9,1,8,212,46,11
63,11,1,10,201,44,19
76,12,1,11,188,43,21
80,15,1,14,182,43,2
82,14,0,14,179,42,14
83,24,1,23,178,32,8
85,19,0,19,175,34,6
84,13,0,13,173,38,7
85,9,0,9,169,42,10
86,7,0,7,168,43,13
86,5,0,5,168,42,11
87,6,0,6,168,40,8
87,14.26980885,1.920041085,12.34976777,168,40,5
87,7,0,7,168,35,3
88,9,0,9,169,30,2
88,9,0,9,167,32,2
88,17,1,16,167,25,2
88,20,1,19,168,23,1
88,17,2,15,171,28,1
85,14.26279736,1.912074723,12.35072264,177,36.90979898,4
82,12,2,10,185,29,3
78,13,2,11,193,29,6
72,13,3,10,204,33,8
64,11,2,9,217,38,17
60,12,2,10,228,43,18
60,14,2,12,232,47,15
60,28,2,26,229,40,9
62,29,1,28,220,43,7
71,19,0,19,208,42,1
77,9,0,9,191,36,7
80,8,0,8,183,36,0
82,7,0,7,174,38,1
83,5,0,5,168,41,1
85,6,0,6,163,39,2
79,5,0,5,162,39,0
86,5,0,5,160,37,1
87,5,0,5,162,35,0
88,8,0,8,167,27,0
87,12,0,12,168,22,5
88,19,1,18,173,12,4
93,29,7,22,202,2,9
87,17,5,12,217,4,9
79,15,6,9,233,8,14
73,15,6,9,238,10,25
72,12,4,8,240,13,23
66,14,5,9,255,14,14
69,11,3,8,245,21,20
72,12,3,9,238,24,17
70,12,2,10,243,24,5
71,13,2,11,232,25,15
67,16,2,14,229,30,2
70,16,1,15,222,34,14
71,14,0,14,217,36,0
72,12,0,12,210,37,12
70,16,0,16,209,31,2
70,20,0,20,207,26,11
66,26,1,25,211,20,14
64,20,1,19,211,24,17
66,20,1,19,209,22,7
74,30,4,26,204,7,16
70,17,1,16,196,13,5
76,12,0,12,193,17,4
69,14,0,14,183,14,6
53,24,1,23,179,13,0
49,18,1,17,178,25,1
44,13,2,11,191,31,5
38,11,2,9,210,31,17
33,8,1,7,225,36,4
31,8,1,7,239,37,0
32,7,1,6,244,40,7
30,8,1,7,254,42,5
28,8,1,7,263,48,9
24,8,1,7,273,56,8
33,11,1,10,276,59,8
38,13,1,12,265,53,7
43,11,1,10,248,44,6
47,12,1,11,232,45,5
49,14,0,14,223,39,0
54,15,0,15,211,33,0
61,13,0,13,200,33,3
63,14,0,14,195,31,0
66,20,0,20,194,24,4
69,18,0,18,194,27,8
69,9,0,9,194,40,6
70,17,0,17,192,28,5
71,22,0,22,188,19,12
72,26,1,25,180,14,2
74,29,2,27,173,9,8
74,31,4,27,179,8,6
71,22,4,18,194,18,12
62,27,5,22,207,24,26
54,14,2,12,215,42,24
43,10,1,9,234,45,16
34,11,2,9,242,40,8
22,12,2,10,252,39,12
20,9,1,8,262,40,11
24,9,1,8,266,45,6
28,8,1,7,265,50,7
32,9,1,8,261,53,8
30,9,1,8,250,52,11
50,21,1,20,235,51,11
50,28,1,27,221,44,9
58,29,1,28,214,37,0
60,26,1,25,207,37,21
64,16,0,16,203,44,2
64,14,0,14,202,42,13
68,15,0,15,200,34,12
70,20,0,20,200,26,12
71,22,0,22,197,20,13
69,21,0,21,193,18,15
69,19,0,19,193,21,5
70,24,1,23,189,15,16
71,32,5,27,190,10,14
66,39,9,30,199,11,19
58,27,4,23,213,19,38
47,15,2,13,231,33,10
45,9,1,8,235,43,27
43,6,1,5,232,48,12
43,5,0,5,232,48,10
41,4,0,4,235,50,17
40,6,1,5,233,49,10
41,6,1,5,229,51,19
41,6,1,5,225,52,7
40,6,1,5,199,51,13
38,4,0,4,189,51,2
42,4,0,4,180,51,4
51,4,0,4,170,51,5
55,4,0,4,162,51,8
59,4,0,4,154,48,9
61,4,0,4,150,47,8
61,4,0,4,146,45,7
64,3,0,3,142,44,8
66,3,0,3,139,42,8
65,3,0,3,137,40,8
66,3,0,3,134,40,8
66,3,0,3,135,40,7
62,4,0,4,142,44,8
58,3,0,3,156,45,12
52,3,0,3,174,49,19
48,3,0,3,194,50,23
44,6,1,5,201,47,20
43,3,0,3,209,49,8
41,4,0,4,220,48,17
41,3,0,3,222,49,16
41,4,0,4,228,50,15
40,4,0,4,234,52,15
44,3,0,3,220,51,14
48,4,0,4,207,48,11
52,4,0,4,198,48,0
56,5,0,5,184,45,6
59,12,0,12,175,37,15
62,15,0,15,167,32,17
65,12,0,12,162,33,13
70,7,0,7,156,36,9
69,5,0,5,155,40,9
71,6,0,6,154,37,12
71,8,0,8,153,33,13
72,6,0,6,152,33,11
75,7,0,7,150,32,10
74,12,0,12,150,26,14
72,17,1,16,152,22,12
69,12,1,11,158,29,14
67,16,2,14,168,28,15
58,21,4,17,193,26,18
52,15,2,13,206,43,30
45,11,1,10,229,48,30
42,9,1,8,231,57,22
43,9,1,8,235,56,25
45,9,1,8,230,57,22
48,11,1,10,223,50,16
50,11,1,10,221,46,16
53,9,1,8,217,46,27
57,11,1,10,209,46,10
60,12,0,12,206,43,18
62,11,0,11,204,42,9
64,12,0,12,203,39,7
57.81743869,11,0,11,202,38,10
68,10,0,10,202,38,10
65,11,0,11,202,36,9
72,10,0,10,200,35,6
72,13.99940589,1.784534491,12.21487139,202,33,10
73,7,0,7,203,38,10
71,7,0,7,203,37,9
77,9,0,9,199,35,11
82,11,0,11,195,32,8
84,16,1,15,197,28,7
86,22,2,20,198,24,8
86,13.98861772,1.77760355,12.21101417,199,36.7129137,11
87,19,3,16,201,22,7
86,16,2,14,205,25,6
87,9,1,8,205,32,9
86,28,5,23,190,15,0
87,26,4,22,185,16,6
86,16,2,14,178,22,2
85,11,2,9,176,30,1
86,11,1,10,173,31,0
86,11,1,10,172,29,3
86,10,1,9,170,29,4
85,11,1,10,169,28,2
84,11,1,10,167,26,1
84,10,1,9,162,27,1
84,9,1,8,158,27,3
85,8,0,8,154,26,5
85,9,0,9,153,23,5
85,12,0,12,152,19,7
85,13,0,13,149,17,7
86,14,0,14,147,14,4
85,31,6,25,140,3,7
86,32,10,22,138,5,7
82,35,14,21,150,6,10
50,34,13,21,176,14,18
37,13,2,11,202,33,23
37,14,3,11,217,34,30
34,13,2,11,232,39,17
27,11,1,10,245,45,15
28,9,1,8,255,49,17
30,11,1,10,261,53,19
27,10,2,8,262,51,14
26,8,1,7,255,50,8
28,9,1,8,232,50,6
31,7,1,6,221,51,6
34,7,0,7,212,51,0
40,10,0,10,201,48,10
43,10,0,10,190,47,12
47,9,0,9,182,47,12
49,10,0,10,178,43,14
50,13,0,13,174,37,14
50,21,0,21,169,29,15
50,22,0,22,169,29,16
50,17,0,17,164,29,16
55,21,0,21,158,20,15
58,32,2,30,152,9,17
53,33,5,28,153,10,20
50,31,6,25,170,15,21
42,29,7,22,195,17,32
30,15,3,12,217,37,19
31,9,2,7,232,45,19
31,9,2,7,239,43,14
29,7,1,6,244,44,17
29,7,1,6,244,44,10
36,8,2,6,235,45,13
35,7,1,6,237,45,13
32,7,1,6,231,46,13
36,7,1,6,216,46,3
48,6,0,6,204,49,9
46,5,0,5,193,50,7
57,3,0,3,179,51,13
61,4,0,4,174,49,11
63,6,0,6,169,45,10
64,4,0,4,166,45,10
64,4,0,4,163,45,9
65,4,0,4,158,43,9
63,5,0,5,156,38,9
60,4,0,4,156,38,6
64,8,0,8,151,33,4
65,17,0,17,144,20,5
64,22,2,20,147,18,5
57,15,2,13,163,26,6
54,9,1,8,173,31,14
52,9,2,7,181,32,7
49,8,2,6,184,34,7
48,8,2,6,190,33,11
47,10,3,7,195,32,2
47,9,2,7,196,35,13
47,8,2,6,198,33,0
46,9,2,7,199,34,7
45,8,2,6,198,36,0
46,8,2,6,195,36,8
49,6,1,5,191,38,0
54,5,0,5,182,38,2
59,8,1,7,175,34,0
62,5,0,5,168,34,3
65,7,1,6,163,31,1
67,8,1,7,160,29,0
68,7,0,7,154,27,0
69,8,0,8,150,25,3
70,9,0,9,145,23,2
70,11,0,11,143,22,2
70,13,0,13,142,19,4
71,19,1,18,140,13,3
71,24,3,21,142,11,5
64,23,5,18,155,13,8
57,21,6,15,174,17,14
50,17,5,12,188,23,20
42,11,2,9,206,31,29
39,8,1,7,225,35,11
33,9,1,8,233,39,12
38,7,1,6,246,44,11
41,6,1,5,248,42,13
38,6,1,5,253,37,9
42,5,1,4,244,38,6
50,5,1,4,220,37,3
59,6,1,5,210,32,0
64,6,1,5,206,31,0
66,6,0,6,195,31,2
75,4,0,4,190,35,0
74,5,0,5,184,34,1
75,7,0,7,185,32,0
72,12,0,12,187,24,2
73,10,0,10,185,22,4
73,10,0,10,182,19,3
72,9,0,9,179,20,3
73,6,0,6,176,21,3
74,6,0,6,174,20,2
72,7,1,6,178,18,2
66,7,1,6,191,18,6
58,8,2,6,209,19,15
52,6,1,5,232,22,22
46,5,1,4,246,25,7
41,5,1,4,257,27,13
38,4,1,3,266,28,6
32,3,0,3,275,36,6
26,3,0,3,285,45,15
20,3,0,3,296,55,18
32,3,0,3,272,51,22
30,3,0,3,250,49,14
30,3,0,3,241,56,17
34,4,0,4,226,51,13
42,5,0,5,215,49,19
47,6,0,6,203,43,14
47,5,0,5,197,42,22
49,9,0,9,194,37,13
47,10,0,10,192,35,18
42,12,0,12,192,36,17
45,20,0,20,189,26,23
50,32,1,31,184,13,22
45,43,3,40,183,6,22
47,35,1,34,182,12,27
52,56,15,41,184,5,27
50,48,15,33,197,9,30
47,27,6,21,216,19,34
41,21,5,16,240,25,21
36,23,5,18,263,28,34
30,22,4,18,280,38,31
29,15,2,13,294,45,33
27,11,1,10,299,49,21
21,11,1,10,313,56,26
25,14,1,13,313,67,20
25,17,1,16,311,74,26
24,16,1,15,301,78,26
28,20,1,19,289,101,28
36,36,1,35,264,57,35
32,27,1,26,256,58,29
39,34,1,33,245,43,26
45,50,1,49,238,25,25
52,52,1,51,227,20,40
55,43,1,42,220,21,29
58,38,1,37,215,23,33
57,13.94448667,1.754495484,12.18999118,212,27,30
60,35,1,34,210,23,28
65,40,1,39,203,14,31
65,41,1,40,199,11,35
67,44,4,40,205,15,33
63,70,22,48,213,7,44
52,81,29,52,234,9,47
44,14.12209064,1.791583786,12.33050685,260,36.15740074,42
37,56,11,45,273,26,44
35,37,5,32,275,42,40
30,18,2,16,283,52,28
26,11,1,10,282,60,26
20,11,1,10,280,62,29
19,10,1,9,277,69,31
21,12,1,11,270,71,35
30,12,1,11,261,69,32
36,16,1,15,250,62,31
45,18,1,17,237,61,23
51,18,0,18,226,56,24
62,9,0,9,218,64,24
61,12,0,12,218,60,29
60,8,0,8,217,66,23
67,7,0,7,214,67,25
72,8,0,8,213,63,31
70,6,0,6,209,63,20
73,6,0,6,209,62,27
76,7,0,7,209,58,25
76,7,0,7,211,55,19
74,12,0,12,216,47,26
73,15,1,14,220,43,31
68,12,1,11,228,45,30
66,9,1,8,228,49,22
63,8,1,7,231,50,29
63,7,1,6,232,50,21
65,10,1,9,231,48,25
64,9,1,8,231,48,26
63,9,1,8,235,48,20
64,8,1,7,233,49,35
62,7,0,7,230,50,18
66,9,0,9,223,48,31
66,10,0,10,223,47,17
67,13,0,13,222,44,32
69,13,0,13,218,42,20
69,13,0,13,218,40,29
70,16,0,16,217,35,26
72,12,0,12,214,40,18
73,10,0,10,213,39,31
75,7,0,7,212,41,21
78,8,0,8,209,37,25
81,10,0,10,207,33,27
81,10,0,10,208,33,20
80,8,0,8,209,34,24
79,20,2,18,214,23,23
76,25,3,22,222,21,33
73,25,4,21,228,22,23
68,20,4,16,237,26,22
68,18,3,15,238,29,30
67,14,2,12,239,34,16
60,11,2,9,249,35,21
60,10,2,8,248,37,20
58,7,1,6,254,38,16
57,6,1,5,253,38,16
59,6,1,5,251,37,12
63,8,1,7,243,34,14
65,8,1,7,236,34,9
70,11,0,11,229,30,3
75,11,0,11,225,25,14
77,11,0,11,223,24,3
80,11,0,11,221,23,14
80,12,0,12,221,21,5
80,10,0,10,221,22,10
79,12,0,12,222,19,6
81,14,0,14,220,16,9
79,13,0,13,221,17,6
83,11,0,11,218,18,9
87,18,0,18,213,11,2
87,23,2,21,216,8,6
87,28,6,22,218,7,0
88,28,7,21,223,8,8
88,28,8,20,222,7,5
84,19,5,14,191,23,5
85,17,3,14,189,41,0
80,23,5,18,190,38,1
76,15,4,11,193,43,9
76,17,3,14,185,47,11
78,24,5,19,190,42,3
72,14,2,12,194,49,14
72,13,1,12,193,52,17
71,7,0,7,190,56,18
72,6,0,6,185,59,5
74,7,0,7,180,57,14
75,8,0,8,177,54,14
77,9,0,9,174,50,13
78,11,0,11,171,43,13
79,17,0,17,170,31,13
80,15,0,15,166,33,14
81,14,0,14,165,34,15
80,14,0,14,167,33,14
80,31,1,30,167,12,18
80,40,5,35,168,7,17
80,25,1,24,171,20,17
79,17,1,16,176,29,19
76,17,1,16,182,32,21
74,15,1,14,190,36,22
70,20,2,18,198,33,33
64,14,2,12,212,41,25
54,11,1,10,224,51,31
53,8,0,8,231,59,28
44,11,0,11,234,62,27
46,11,0,11,233,65,23
45,15,0,15,232,71,23
51,14,0,14,230,68,26
57,18,0,18,222,64,27
57,26,0,26,215,48,22
63,36,0,36,208,32,24
66,33,0,33,203,29,29
69,27,0,27,199,32,23
73,23,0,23,198,35,31
75,22,0,22,196,32,31
77,24,0,24,191,24,21
79,23,0,23,190,22,30
81,22,0,22,188,19,28
81,19,0,19,186,18,28
82,16,0,16,186,19,26
82,21,3,18,186,13,27
68,25,5,20,194,16,33
58,11,1,10,210,31,42
52,9,1,8,236,42,35
52,8,0,8,248,58,37
45,8,0,8,261,57,29
42,11,1,10,268,69,29
32,8,0,8,280,72,30
35,7,0,7,280,60,19
44,8,0,8,270,73,23
50,9,0,9,262,75,28
50,8,1,7,254,56,24
52,9,0,9,246,52,22
58,16,0,16,236,44,20
62,17,0,17,228,42,16
60,12,0,12,222,45,28
64,9,0,9,219,47,9
64,9,0,9,218,45,18
66,10,0,10,218,41,0
70,12,0,12,214,36,13
70,9,0,9,215,37,5
73,11,0,11,214,33,9
77,11,0,11,209,25,13
81,11,0,11,203,25,7
72,10,0,10,183,32,6
78,7,0,7,167,43,4
82,11,0,11,168,36,1
77,16,2,14,169,32,5
78,12,1,11,169,38,5
72,13,2,11,178,38,9
76,15,2,13,176,40,14
75,10,1,9,169,46,8
76,12,2,10,174,45,4
78,14,2,12,174,43,9
77,12,2,10,176,44,5
81,16,2,14,174,41,7
80,11,1,10,172,43,6
79,7,0,7,172,46,3
80,11,0,11,174,38,2
80,9,0,9,174,37,2
80,9,0,9,175,36,4
79,9,0,9,175,35,7
79,9,0,9,174,34,5
79,10,0,10,172,32,4
80,14.10367669,1.700915219,12.40276147,172,31,0
81,10,0,10,172,27,6
81,8,0,8,171,28,6
81,8,0,8,169,31,6
79,10,0,10,171,27,7
78,12,1,11,176,26,10
73,12,2,10,188,27,15
66,14.0866725,1.695939051,12.39073345,203,30,13.67677968
62,14.0866725,1.695939051,12.39073345,213,36.61465173,15
57,16,3,13,226,36,9
53,13,2,11,240,40,12
51,16,2,14,247,44,11
50,18,2,16,254,51,10
52,15,1,14,251,64,18
53,10,1,9,247,57,11
61,9,1,8,233,42,4
69,13,1,12,224,50,1
72,17,0,17,214,45,0
73,11,0,11,213,50,8
76,11,0,11,212,45,2
76,12,0,12,213,45,15
73,15,0,15,216,40,7
72,16,0,16,216,38,20
72,14,0,14,215,38,7
74,16,0,16,212,32,16
75,17,0,17,208,26,8
79,21,0,21,203,19,13
82,28,1,27,200,9,9
77,22,2,20,200,14,13
60,18,2,16,201,22,15
34,13,1,12,207,33,21
32,13,2,11,220,38,5
30,13,2,11,227,40,20
28,12,2,10,240,43,5
27,12,2,10,248,50,11
24,11,1,10,257,57,17
26,13,1,12,263,59,13
27,18,1,17,269,64,11
33,17,1,16,260,72,16
42,18,1,17,255,70,18
45,16,1,15,246,66,22
29,15,0,15,239,47,13
29,8,0,8,224,44,0
40,7,0,7,214,43,0
35,8,0,8,205,41,0
38,7,0,7,194,42,1
41,8,0,8,188,40,1
38,7,0,7,184,42,0
38,5,0,5,180,44,1
38,4,0,4,178,45,4
41,6,0,6,172,42,3
42,9,0,9,170,37,3
39,14,1,13,175,32,3
35,12,1,11,190,35,9
31,8,1,7,205,39,13
28,6,1,5,221,40,11
25,8,2,6,232,38,14
24,6,1,5,242,37,3
21,7,1,6,245,39,13
22,6,1,5,250,41,5
20,6,1,5,255,44,12
18,6,1,5,257,44,10
14,6,1,5,259,42,7
20,6,1,5,250,42,5
24,7,1,6,236,44,4
25,6,0,6,221,40,0
27,7,0,7,209,39,0
30,9,0,9,199,37,0
33,7,0,7,191,37,6
35,10,0,10,184,35,0
36,9,0,9,178,34,3
37,7,0,7,172,35,2
40,13,0,13,168,27,1
43,22,0,22,162,18,0
42,29,0,29,157,12,4
44,25,1,24,152,15,3
42,33,6,27,153,12,5
41,21,4,17,164,20,10
34,18,4,14,190,24,18
30,11,2,9,208,31,25
29,11,2,9,220,33,8
29,17,3,14,225,31,8
30,16,3,13,227,37,10
31,15,2,13,233,45,11
34,8,1,7,230,50,10
36,7,1,6,235,51,9
40,7,1,6,229,52,8
44,8,1,7,223,47,7
48,6,0,6,214,46,3
51,6,0,6,208,46,0
57,7,0,7,205,45,8
58,11,0,11,206,41,0
62,10,0,10,204,44,9
66,9,0,9,203,43,8
63,13,0,13,203,38,2
60,14,0,14,203,37,10
59,12,0,12,201,38,8
60,13,0,13,198,37,10
62,17,0,17,195,32,9
67,23,1,22,187,16,11
66,32,6,26,189,9,8
62,29,7,22,200,15,16
51,21,4,17,227,28,28
50,19,3,16,235,38,16
46,14,2,12,246,42,13
44,13,2,11,255,44,13
48,12,2,10,251,46,12
49,11,2,9,254,44,8
56,11,2,9,238,43,11
58,9,1,8,232,42,7
60,10,1,9,231,40,0
58,13,2,11,229,37,13
60,12,1,11,225,38,3
62,15,1,14,221,36,7
60,16,1,15,221,35,9
57,15,0,15,222,34,9
62,12,0,12,219,37,15
57,14,0,14,220,35,7
60,13,0,13,217,36,19
59,11,0,11,217,38,5
59,9,0,9,216,40,18
62,8,0,8,215,38,3
59,9,0,9,215,36,11
56,7,0,7,210,43,7
73,7,0,7,202,45,2
69,8,0,8,196,43,7
72,10,0,10,193,43,3
69,10,1,9,194,47,4
61,10,1,9,203,50,3
54,10,1,9,212,52,14
55,13,1,12,213,50,3
55,20,2,18,211,43,10
54,22,3,19,216,42,2
48,20,3,17,231,44,18
44,12,1,11,234,52,9
48,12,1,11,220,49,8
50,13,1,12,217,48,6
53,16,0,16,210,42,0
59,35,0,35,204,23,7
61,33,0,33,200,21,5
64,32,0,32,197,19,17
69,35,1,34,194,13,12
71,23,0,23,189,16,13
77,11,0,11,181,24,12
77,3,0,3,180,44,11
76,2,0,2,181,51,13
76,3,0,3,182,49,13
76,3,0,3,182,46,13
75,4,0,4,185,44,13
73,6,0,6,190,41,14
71,8,1,7,194,37,14
68,11,2,9,201,34,14
66,15,3,12,206,33,24
62,12,3,9,218,36,8
58,13,3,10,225,38,32
55,10,2,8,232,41,16
52,10,2,8,240,42,22
54,10,2,8,237,44,18
56,8,1,7,232,44,16
58,10,2,8,225,40,8
60,8,1,7,217,39,11
64,7,0,7,211,38,6
63,12,0,12,204,32,2
64,10,0,10,199,32,14
61,8,0,8,194,33,9
67,10,0,10,190,28,7
68,6,0,6,187,30,5
68,5,0,5,186,31,0
70,13.9401337,1.62405943,12.31607427,187,32,8
71,4,0,4,187,31,4
71,6,0,6,187,28,6
72,8,0,8,188,26,3
72,14,1,13,190,22,7
72,14,1,13,191,21,4
72,13,1,12,195,23,15
70,13.92488568,1.619885942,12.30499974,200,36.78789914,0
68,22,4,18,206,20,18
66,24,5,19,213,22,8
63,22,4,18,218,27,24
69,22,2,20,213,29,11
76,23,3,20,209,28,9
73,24,3,21,211,26,16
69,22,3,19,213,27,7
66,21,2,19,214,30,22
65,21,1,20,215,29,7
65,23,1,22,214,27,21
67,22,1,21,213,25,6
68,19,0,19,211,26,20
71,16,0,16,210,26,11
71,12,0,12,209,29,16
72,11,0,11,206,29,17
72,9,0,9,205,31,8
75,8,0,8,203,32,17
78,9,0,9,199,30,5
79,12,0,12,197,26,9
75,25,1,24,195,16,12
72,38,4,34,195,12,17
67,31,3,28,199,20,20
64,26,4,22,208,26,21
64,30,5,25,219,25,23
54,25,4,21,230,31,24
51,17,3,14,243,38,18
45,12,2,10,257,44,21
46,9,1,8,259,43,19
52,12,2,10,253,39,19
50,13,2,11,259,39,14
47,12,2,10,258,36,9
48,11,1,10,254,36,12
53,9,1,8,246,36,10
59,12,0,12,240,33,10
63,12,0,12,230,28,6
66,11,0,11,226,30,0
67,12,0,12,222,28,3
67,12,0,12,221,28,2
70,14,0,14,220,24,14
74,9,0,9,212,30,0
79,11,0,11,212,24,14
84,9,0,9,208,24,3
85,7,0,7,206,27,0
84,8,0,8,207,26,8
86,13,1,12,207,22,3
87,12,1,11,208,22,3
87,15,3,12,210,19,0
87,25,6,19,211,14,9
86,21,6,15,215,15,0
83,19,5,14,218,16,11
82,16,3,13,219,18,0
80,13,2,11,224,22,6
76,15,3,12,228,26,7
74,23,5,18,235,27,11
70,17,3,14,243,33,8
69,24,3,21,245,28,11
71,32,2,30,241,22,16
73,28,1,27,238,20,19
77,36,1,35,233,9,6
78,39,2,37,228,6,16
79,33,1,32,229,11,6
79,51,9,42,229,1,16
79,46,10,36,229,3,15
78,38,6,32,227,4,12
80,28,1,27,226,6,14
79,21,1,20,225,12,6
78,16,0,16,223,15,18
76,19,1,18,216,9,2
77,25,6,19,216,6,8
75,22,6,16,226,10,10
62,15,3,12,240,23,16
58,13,3,10,253,32,12
53,14,3,11,261,34,11
52,14,3,11,267,39,12
46,11,2,9,279,44,8
39,11,2,9,282,49,12
35,13,2,11,295,46,5
37,10,1,9,290,56,7
44,10,1,9,281,54,15
45,11,2,9,273,51,10
45,9,1,8,264,52,7
45,8,1,7,251,51,7
51,12,1,11,242,44,3
53,12,1,11,236,43,0
53,14,1,13,232,37,2
53,18,1,17,229,31,9
56,24,1,23,226,22,13
60,25,1,24,220,18,4
62,30,1,29,217,12,16
63,27,1,26,212,13,3
66,27,1,26,207,10,4
70,29,2,27,205,7,17
74,43,12,31,209,6,4
72,41,9,32,219,16,30
61,36,7,29,241,23,23
47,31,6,25,260,29,25
38,25,4,21,276,39,19
23,18,2,16,283,47,16
20,12,1,11,290,46,11
29,11,1,10,291,65,11
32,11,1,10,294,69,17
41,10,1,9,286,54,12
35,11,2,9,277,46,13
47,11,2,9,263,43,6
49,13,2,11,256,38,5
57,14,1,13,246,37,6
62,16,1,15,238,33,1
66,13,1,12,232,34,4
68,11,1,10,228,35,4
71,10,1,9,224,36,14
72,10,1,9,223,34,0
72,8,1,7,222,35,15
73,8,1,7,220,34,0
75,7,1,6,218,34,13
76,7,1,6,216,32,1
77,7,1,6,215,31,9
76,8,1,7,219,30,4
72,11,2,9,228,29,18
59,11,2,9,240,32,18
54,10,2,8,256,38,16
50,9,1,8,254,47,19
49,11,1,10,263,56,20
43,7,1,6,272,52,12
45,6,1,5,275,46,12
45,6,1,5,283,49,11
48,6,1,5,275,47,10
46,7,1,6,268,46,12
50,7,1,6,263,41,4
56,8,1,7,255,35,5
61,11,1,10,250,29,5
65,13,1,12,245,27,4
69,10,1,9,240,27,9
72,8,1,7,238,28,10
73,10,1,9,235,25,10
72,10,1,9,234,26,8
77,6,1,5,228,32,10
81,5,1,4,223,34,1
84,5,1,4,218,35,12
85,4,1,3,212,37,0
87,5,1,4,210,36,8
87,6,1,5,208,33,4
88,7,1,6,206,35,0
87,7,1,6,205,36,4
86,10,2,8,197,36,2
88,13,3,10,198,35,0
88,12,3,9,206,35,0
88,16,4,12,208,32,0
87,9,2,7,208,33,5
87,13,3,10,205,31,6
87,12,2,10,204,30,0
88,13,2,11,200,30,0
88,12,1,11,197,29,0
88,10,1,9,196,31,0
85,7,0,7,196,31,0
84,8,0,8,197,28,2
80,8,0,8,198,27,2
77,6,0,6,197,30,3
76,4,0,4,195,34,1
76,5,0,5,195,33,0
75,5,0,5,192,34,2
74,14.07458646,1.643419003,12.43116746,191,34,1
74,6,0,6,189,35,1
74,8,0,8,188,33,0
76,10,0,10,185,29,0
75,15,1,14,189,23,0
71,13,2,11,202,26,8
60,9,2,7,225,32,23
59,14.06144324,1.6406945,12.42074874,230,36.18107226,8
52,16,5,11,248,31,1
50,16,4,12,258,33,7
49,15,3,12,264,36,6
53,12,2,10,254,45,8
52,13,3,10,259,41,0
52,15,3,12,262,42,4
53,11,2,9,253,43,9
53,11,2,9,245,43,5
58,9,1,8,234,45,8
60,9,1,8,223,43,0
62,7,0,7,217,42,11
62,8,0,8,214,37,0
64,9,0,9,211,36,13
67,15,1,14,208,26,0
67,12,0,12,206,26,12
66,10,0,10,204,29,9
67,8,0,8,203,31,4
70,5,0,5,201,34,5
70,7,0,7,201,31,5
71,8,0,8,200,31,8
71,8,0,8,200,30,0
71,11,1,10,198,28,8
71,10,1,9,204,28,8
68,12,2,10,210,26,7
68,13,2,11,212,27,8
70,18,4,14,212,24,11
71,17,4,13,214,25,6
71,16,3,13,217,25,11
71,17,4,13,220,25,9
69,20,5,15,225,23,9
67,16,3,13,224,25,18
64,13,2,11,226,28,5
66,14,2,12,222,28,6
69,10,0,10,215,29,8
71,9,0,9,212,31,3
74,9,1,8,209,32,11
75,10,1,9,209,29,1
76,10,0,10,210,26,8
77,10,0,10,211,24,7
78,11,0,11,209,21,2
79,13,0,13,212,16,13
77,11,0,11,215,19,0
77,10,0,10,217,22,11
78,9,0,9,217,22,0
78,14,1,13,218,20,0
73,19,2,17,222,16,16
69,20,4,16,229,16,2
66,15,3,12,235,21,15
74,13,2,11,227,25,11
75,15,3,12,236,23,1
74,15,3,12,240,25,18
67,14,2,12,233,27,8
68,17,3,14,239,24,0
68,18,3,15,238,24,13
66,17,2,15,238,25,11
66,20,3,17,239,21,9
72,12,1,11,232,25,3
80,11,1,10,223,23,0
85,10,1,9,217,23,0
85,10,1,9,215,21,0
85,7,0,7,208,23,5
86,6,1,5,205,35,3
86,4,0,4,204,30,3
87,3,0,3,198,34,5
88,3,0,3,198,34,3
88,6,0,6,199,28,2
87,6,0,6,199,26,3
87,12,0,12,200,19,4
86,20,2,18,204,13,7
83,23,5,18,211,12,10
74,20,5,15,231,16,19
64,14,3,11,252,24,13
57,16,4,12,265,26,15
55,23,6,17,273,27,13
56,31,6,25,273,33,10
55,19,3,16,284,39,11
51,13,2,11,287,36,8
49,13,2,11,294,39,6
49,14,1,13,296,51,12
53,16,1,15,291,59,14
55,18,1,17,285,36,8
59,24,1,23,276,29,13
62,24,0,24,269,37,14
64,29,1,28,265,32,19
67,21,1,20,257,26,21
71,13,1,12,250,26,17
73,12,0,12,245,24,11
75,10,0,10,242,23,14
77,13,0,13,239,16,10
70,23,1,22,237,10,20
55,21,1,20,229,22,6
55,18,0,18,224,26,13
52,23,2,21,228,25,13
45,17,2,15,241,34,15
39,12,1,11,260,40,23
45,12,2,10,273,43,15
37,13,2,11,290,44,21
27,9,1,8,306,52,19
26,8,1,7,313,57,17
24,7,1,6,323,60,8
23,8,1,7,331,62,15
31,13,1,12,324,90,22
31,11,0,11,320,103,19
35,12,0,12,309,76,14
38,25,1,24,300,52,13
44,27,1,26,278,42,15
45,16,0,16,271,46,14
54,17,0,17,262,43,13
59,10,0,10,255,51,19
62,15,0,15,251,42,16
65,19,0,19,246,35,26
68,18,0,18,244,33,19
71,11,0,11,240,40,27
73,7,0,7,237,45,16
73,9,0,9,236,35,25
71,8,0,8,236,36,23
69,12,1,11,237,27,18
61,11,1,10,248,43,29
49,14,1,13,264,49,23
49,10,1,9,269,50,22
46,8,1,7,274,50,15
48,8,1,7,276,52,16
47,7,1,6,282,53,18
46,8,1,7,276,54,17
48,8,1,7,273,52,13
49,5,0,5,271,49,11
56,6,0,6,259,47,12
64,7,0,7,252,50,14
68,10,0,10,239,52,25
67,7,0,7,236,51,20
70,11,0,11,236,45,30
71,11,0,11,234,41,19
75,6,0,6,232,45,30
83,7,0,7,227,41,21
86,6,0,6,221,39,21
85,6,0,6,226,33,22
85,7,0,7,225,28,11
85,7,0,7,223,28,18
85,6,0,6,215,38,1
85,6,0,6,215,35,4
85,8,0,8,216,30,13
85,17,1,16,217,24,1
84,15,1,14,221,28,15
77,17,3,14,233,27,8
70,18,4,14,248,30,18
62,19,4,15,263,28,15
56,23,5,18,275,27,19
53,22,4,18,287,36,18
54,20,3,17,288,44,20
53,18,2,16,288,48,17
57,17,2,15,278,46,20
60,14,2,12,276,39,18
60,17,1,16,273,37,17
62,20,1,19,269,35,24
63,16,1,15,263,41,17
65,7,0,7,257,60,20
66,8,0,8,253,52,18
71,9,1,8,248,46,16
72,6,0,6,245,43,24
75,7,0,7,242,40,19
72,13.96744276,1.611125801,12.35631696,238,37,21
71,12,0,12,237,36,22
71,18,0,18,236,24,15
71,18,0,18,236,20,27
72,26,2,24,236,15,16
72,17,1,16,238,23,15
75,22,2,20,240,20,24
77,31,4,27,240,15,20
76,13.99111296,1.609959451,12.38115351,234,36.03697592,12.77452829
77,29,4,25,231,30,10
79,24,3,21,228,34,28
80,26,4,22,231,29,5
76,22,4,18,236,35,31
67,16,3,13,248,40,13
53,12,2,10,266,48,31
56,10,1,9,263,55,26
55,10,1,9,262,59,29
58,8,0,8,258,63,24
63,11,0,11,252,57,25
70,12,0,12,239,41,30
74,7,0,7,228,42,15
75,5,0,5,223,41,21
78,4,0,4,219,39,11
80,5,0,5,216,32,24
81,6,0,6,214,31,12
78,7,0,7,216,29,28
80,9,0,9,217,25,8
82,8,0,8,214,23,26
81,12,1,11,216,21,1
78,13,2,11,223,20,33
76,18,3,15,226,19,24
78,25,4,21,228,15,46
76,32,7,25,230,13,29
78,24,4,20,232,20,27
73,26,4,22,238,25,37
69,28,4,24,242,25,37
66,22,2,20,242,42,29
76,25,3,22,238,33,33
77,20,2,18,231,28,27
78,18,3,15,232,29,20
79,20,2,18,232,25,26
81,18,1,17,231,21,29
81,18,1,17,233,18,22
80,18,1,17,231,16,35
83,15,1,14,227,18,19
84,10,1,9,226,23,29
86,7,0,7,223,24,12
87,7,0,7,223,20,24
88,8,0,8,224,16,17
88,10,0,10,225,13,15
87,13,0,13,226,12,25
88,17,1,16,226,11,17
88,19,1,18,225,14,23
88,19,1,18,225,19,0
87,27,3,24,228,18,21
87,25,3,22,230,17,7
86,33,8,25,233,9,20
86,32,8,24,234,8,14
87,36,10,26,236,9,17
88,29,6,23,236,9,10
86,18,3,15,233,16,7
78,11,2,9,247,21,16
65,10,2,8,264,27,11
62,6,1,5,266,33,14
62,8,1,7,266,35,8
72,9,1,8,247,26,8
73,9,1,8,234,24,0
75,8,1,7,228,27,0
76,7,1,6,224,28,7
75,6,1,5,222,27,0
79,4,0,4,218,28,5
79,4,0,4,216,28,1
80,4,0,4,214,28,5
80,6,0,6,214,25,2
79,7,0,7,214,25,5
79,6,0,6,215,25,8
79,9,1,8,215,22,2
78,11,1,10,218,19,14
76,13,2,11,222,19,7
68,13,3,10,232,22,21
65,12,3,9,238,26,7
65,15,4,11,241,27,9
63,16,4,12,249,28,4
61,17,3,14,251,29,15
62,18,3,15,251,32,19
65,16,3,13,249,30,17
66,19,3,16,245,25,10
73,18,2,16,240,25,5
76,23,1,22,236,24,14
80,24,1,23,230,19,3
80,25,1,24,231,16,8
80,11,0,11,231,24,15
82,12,0,12,230,22,8
84,11,0,11,227,22,20
85,9,0,9,226,23,0
84,9,0,9,228,23,22
87,5,0,5,233,26,5
86,6,0,6,240,18,18
85,10,1,9,245,7,6
84,10,1,9,250,5,19
86,12,2,10,248,4,13
80,10,2,8,246,10,13
83,19,3,16,229,10,14
83,22,6,16,234,11,8
81,25,6,19,240,10,26
80,32,9,23,248,8,18
71,23,6,17,268,15,12
68,18,4,14,268,23,24
67,16,2,14,269,30,22
63,21,3,18,272,30,20
62,20,2,18,272,30,17
64,20,2,18,272,30,17
66,22,1,21,272,26,18
64,30,1,29,266,21,20
65,26,1,25,261,23,21
72,27,1,26,259,17,19
73,23,1,22,257,15,23
72,29,1,28,250,18,21
72,23,1,22,245,26,15
54,23,1,22,247,27,11
72,18,1,17,244,15,18
78,17,1,16,240,7,13
74,12,0,12,237,7,12
60,12,1,11,232,22,17
51,10,1,9,232,33,3
48,11,1,10,236,34,10
49,9,1,8,252,32,7
41,7,1,6,268,36,15
36,5,1,4,281,42,11
40,6,1,5,285,44,10
40,13,2,11,287,43,13
39,10,1,9,292,53,10
38,10,1,9,297,63,13
35,6,0,6,303,72,13
33,6,0,6,300,76,12
43,10,0,10,287,84,20
45,15,1,14,276,56,15
50,14,0,14,264,53,16
63,17,0,17,248,53,20
64,18,0,18,243,46,27
66,17,0,17,241,42,17
68,23,0,23,238,30,31
71,20,0,20,234,28,24
71,16,0,16,228,29,26
72,6,0,6,224,43,17
74,7,0,7,220,41,6
74,8,0,8,217,36,15
73,15,0,15,215,21,14
71,15,1,14,216,18,19
61,13,2,11,226,22,18
57,12,3,9,246,25,19
52,13,3,10,261,26,15
50,16,5,11,270,28,14
47,15,3,12,277,37,14
44,12,2,10,282,44,13
41,11,2,9,286,47,13
40,8,1,7,287,46,12
38,11,2,9,290,43,9
40,10,1,9,284,46,10
40,12,2,10,272,41,9
40,10,1,9,261,36,9
42,10,1,9,253,33,1
54,10,1,9,244,37,2
68,7,0,7,238,42,7
71,6,0,6,234,42,23
72,8,0,8,233,39,15
73,8,0,8,232,37,27
74,8,0,8,230,35,18
75,14.03816125,1.611387017,12.42677424,228,33,25
79,9,0,9,220,40,25
72,7,0,7,210,45,7
74,8,0,8,194,42,13
80,10,0,10,188,39,10
82,9,0,9,179,40,7
84,7,0,7,179,44,5
85,14.02201551,1.606826488,12.41518903,182,35.50342026,5
85,27,4,23,184,28,6
85,21,3,18,187,30,7
84,16,3,13,191,32,6
84,12,2,10,194,35,6
84,12,2,10,197,33,0
83,16,2,14,200,31,6
83,18,2,16,200,30,9
84,16,2,14,200,31,0
84,13,1,12,202,33,7
84,10,0,10,201,32,11
83,11,0,11,201,28,0
83,14,1,13,202,27,1
83,12,1,11,203,27,8
83,13,0,13,203,23,5
84,8,0,8,202,28,7
83,7,0,7,201,27,6
83,6,0,6,202,30,7
82,6,0,6,202,30,10
82,5,0,5,202,28,4
82,8,0,8,202,23,14
83,12,1,11,203,16,0
84,13,1,12,204,15,19
81,11,1,10,204,22,0
81,14,2,12,207,25,12
78,20,4,16,213,24,5
73,20,5,15,221,26,15
68,18,5,13,229,28,11
66,7,1,6,238,38,11
65,19,3,16,237,34,15
62,15,2,13,241,36,8
64,15,3,12,245,38,6
65,10,1,9,242,38,6
73,12,1,11,234,33,6
77,9,1,8,227,31,0
77,8,0,8,223,30,1
78,9,0,9,222,27,2
80,10,0,10,221,22,6
82,9,0,9,220,23,12
85,8,0,8,216,20,0
86,6,0,6,209,26,13
86,7,0,7,210,24,0
86,8,0,8,209,26,14
85,11,0,11,210,21,0
85,17,1,16,211,15,21
85,18,2,16,213,12,5
83,14,2,12,217,17,15
80,18,3,15,220,15,8
76,17,4,13,227,22,10
71,16,4,12,236,25,18
68,14,3,11,244,30,19
62,15,3,12,258,35,18
61,13,2,11,262,41,17
61,16,2,14,265,42,13
58,14,2,12,272,48,9
57,19,2,17,274,53,17
58,18,1,17,271,61,17
63,20,1,19,266,56,18
66,15,1,14,262,37,20
72,13,1,12,253,32,17
75,17,1,16,248,21,22
76,15,1,14,244,19,23
76,11,0,11,241,22,31
77,14,0,14,238,18,23
78,12,0,12,236,19,25
79,11,0,11,233,19,15
80,11,0,11,230,18,12
83,11,0,11,226,15,13
83,17,1,16,226,10,5
83,20,3,17,228,8,24
82,27,6,21,233,6,11
78,32,10,22,244,8,29
69,37,11,26,262,14,25
62,27,4,23,274,42,43
59,25,3,22,281,56,39
59,23,1,22,282,69,38
56,20,1,19,289,76,35
52,20,1,19,299,81,37
52,19,1,18,308,81,46
54,20,2,18,307,62,35
54,18,2,16,296,50,27
56,14,2,12,285,48,22
67,14,0,14,269,40,23
70,16,0,16,261,40,26
72,15,0,15,260,35,27
73,14,1,13,257,33,36
76,14,0,14,247,27,38
77,11,0,11,248,30,29
79,10,0,10,243,29,47
78,13,0,13,243,33,43
76,9,0,9,243,36,51
77,9,0,9,242,32,40
79,9,0,9,240,35,55
80,8,0,8,241,41,50
79,14,1,13,241,32,51
78,15,2,13,247,28,41
73,19,3,16,253,26,52
69,26,6,20,266,24,57
64,27,6,21,277,28,49
62,23,4,19,282,37,45
59,14,2,12,291,42,35
58,10,2,8,301,34,26
58,10,2,8,301,29,25
58,17,3,14,305,28,22
60,17,3,14,294,27,27
62,16,3,13,287,19,21
64,20,3,17,281,10,14
67,22,2,20,275,6,16
68,24,2,22,272,4,14
71,23,3,20,267,2,14
72,27,7,20,266,0,17
74,26,7,19,260,1,16
76,22,5,17,255,1,21
77,19,3,16,253,2,12
77,19,3,16,251,1,15
77,17,3,14,251,1,14
76,18,4,14,252,2,19
76,15,5,10,256,3,12
70,15,6,9,270,5,22
61,14,6,8,287,7,15
57,10,4,6,297,9,21
48,8,3,5,320,12,14
47,7,2,5,327,13,18
47,8,2,6,332,17,16
48,8,1,7,330,24,16
45,10,2,8,345,23,16
45,12,2,10,345,28,23
50,15,3,12,329,25,24
50,16,3,13,325,22,13
53,19,3,16,315,18,15
58,25,3,22,298,10,15
61,27,3,24,289,4,18
66,23,2,21,281,6,23
65,18,1,17,283,9,20
65,18,1,17,286,9,22
70,16,1,15,281,18,25
74,6,0,6,268,42,38
75,6,0,6,265,34,30
75,7,0,7,263,32,31
75,7,0,7,260,32,30
74,9,0,9,258,28,27
72,10,0,10,262,24,22
70,16,2,14,267,17,23
60,12,2,10,281,23,22
52,15,4,11,303,27,23
51,19,5,14,308,30,15
51,11,2,9,317,40,21
46,12,2,10,328,45,21
43,11,2,9,335,47,18
43,15,2,13,344,46,22
43,15,2,13,347,51,15
44,11,1,10,339,54,10
48,11,1,10,316,42,10
70,12,1,11,277,36,9
66,13,1,12,271,36,8
65,14,1,13,270,31,5
66,14,1,13,269,27,13
68,14,1,13,262,25,16
71,10,1,9,254,28,15
71,6,0,6,254,34,7
70,7,0,7,255,35,16
75,14.07044932,1.62651424,12.44393508,252,34,14
73,3,0,3,232,34,7
74,1,0,1,226,36,0
73,2,0,2,222,32,0
70,3,0,3,219,28,11
71,4,1,3,219,28,0
70,5,1,4,220,26,12
66,14.04141843,1.623123031,12.41829539,229,34.94569684,13.39179558
66,15,5,10,228,22,0
69,20,7,13,221,19,21
70,20,7,13,217,19,0
71,12,4,8,217,20,14
70,27,10,17,216,16,0
68,25,9,16,218,16,13
68,19,7,12,218,17,0
68,14,5,9,216,19,11
67,9,2,7,217,23,0
60,7,1,6,216,23,9
68,6,1,5,215,23,0
68,4,1,3,214,23,6
70,3,0,3,213,23,0
71,5,1,4,211,21,7
72,3,0,3,210,22,0
73,3,0,3,209,21,7
73,3,0,3,210,19,0
73,4,0,4,208,18,6
74,5,0,5,208,17,0
74,9,0,9,209,13,5
74,13,2,11,211,10,7
72,21,6,15,217,7,4
67,20,5,15,224,9,11
70,11,2,9,221,18,1
69,20,6,14,230,12,11
69,24,8,16,236,11,10
70,16,4,12,240,16,16
70,13,3,10,244,19,11
68,12,3,9,252,24,18
66,12,3,9,261,25,16
65,9,2,7,270,31,15
68,11,2,9,259,32,19
69,13,2,11,258,31,17
74,18,1,17,250,23,15
77,22,1,21,247,14,16
78,24,1,23,246,9,9
80,31,2,29,242,2,28
81,27,2,25,240,3,17
81,31,5,26,240,1,23
82,39,12,27,239,1,16
82,49,22,27,239,1,22
82,59,31,28,239,1,22
82,69,39,30,239,1,21
83,69,39,30,239,1,28
81,66,34,32,242,2,17
77,77,40,37,254,3,37
60,49,17,32,286,13,34
47,28,6,22,318,21,32
40,18,5,13,337,22,30
37,14,3,11,350,30,22
34,10,2,8,358,36,22
42,11,1,10,360,58,22
45,15,2,13,339,58,22
48,13,2,11,324,45,3
51,12,2,10,308,47,8
56,10,2,8,283,37,17
58,9,2,7,267,29,16
63,7,1,6,248,28,4
66,7,1,6,239,27,0
68,4,1,3,236,30,4
69,2,0,2,234,29,2
69,3,1,2,232,29,14
69,1,0,1,232,30,0
69,1,0,1,231,29,15
71,2,0,2,227,25,1
71,3,0,3,224,24,0
71,3,0,3,224,23,11
71,4,0,4,225,22,4
70,8,1,7,228,19,9
69,8,1,7,231,19,10
68,11,3,8,236,19,9
65,16,5,11,247,17,10
61,18,6,12,261,18,14
59,16,5,11,274,22,13
54,15,4,11,293,30,16
52,14,2,12,299,41,18
49,13,1,12,303,58,17
50,12,1,11,302,62,18
52,20,2,18,296,49,21
54,25,2,23,291,36,24
59,34,2,32,285,26,22
63,39,2,37,274,19,22
64,40,1,39,271,17,24
68,35,1,34,265,17,28
70,20,0,20,262,25,29
72,19,0,19,256,29,37
73,31,1,30,256,17,38
72,28,1,27,256,16,34
77,18,0,18,249,22,40
78,13,0,13,245,24,27
80,22,1,21,245,13,37
84,21,1,20,243,13,29
79,18,1,17,242,16,32
82,14,2,12,235,14,8
83,16,4,12,236,9,5
79,28,10,18,236,7,13
78,23,7,16,229,12,3
81,16,4,12,215,16,12
81,13,3,10,217,16,0
83,10,3,7,216,15,12
85,16,4,12,220,9,0
85,19,5,14,226,5,5
84,22,7,15,231,4,19
82,23,10,13,239,4,4
80,21,8,13,241,4,9
79,29,11,18,242,2,17
80,22,5,17,240,2,5
82,23,5,18,231,1,2
81,17,2,15,227,4,7
80,10,1,9,226,8,5
81,11,1,10,225,7,2
81,13,1,12,224,5,12
82,18,3,15,223,3,0
83,20,4,16,223,1,16
83,28,10,18,222,1,0
84,27,12,15,218,1,13
85,21,9,12,221,3,1
82,29,13,16,232,5,19
75,29,12,17,254,7,21
67,25,8,17,269,13,22
55,15,4,11,283,19,15
52,11,1,10,296,48,8
48,11,1,10,306,61,15
45,9,1,8,313,53,12
44,8,1,7,315,55,18
45,6,1,5,318,42,10
45,5,1,4,310,30,3
49,10,2,8,295,26,0
51,12,2,10,290,24,5
54,13,1,12,280,19,9
60,17,1,16,268,17,5
67,13,1,12,261,22,8
70,13,0,13,255,21,8
71,9,0,9,253,26,10
72,9,0,9,251,27,10
73,11,0,11,251,26,12
75,11,0,11,249,22,13
77,15,0,15,247,16,16
77,20,1,19,246,11,16
77,23,3,20,244,6,19
77,36,15,21,245,3,17
74,35,13,22,255,6,18
61,27,9,18,277,11,21
52,25,7,18,297,16,21
44,21,7,14,313,23,16
40,15,3,12,328,32,12
37,14,2,12,333,46,15
35,15,2,13,345,50,17
35,13,1,12,344,77,13
44,14,0,14,326,99,20
46,13,0,13,325,94,11
47,11,0,11,313,72,17
49,11,0,11,304,57,14
54,18,0,18,289,46,17
57,23,0,23,283,35,18
60,26,0,26,278,29,20
56,15,0,15,272,29,23
64,11,1,10,263,27,14
72,8,0,8,257,25,17
77,4,0,4,255,28,16
78,14.29514364,1.79229425,12.50284939,252,31,18
78,4,0,4,250,32,24
76,3,0,3,250,33,18
76,4,0,4,249,33,17
74,5,0,5,249,31,17
73,7,1,6,254,30,18
68,10,3,7,265,27,24
62,15,4,11,277,29,29
59,14.27395275,1.790444002,12.48350875,279,34.11790805,26
55,10,3,7,292,40,22
48,10,2,8,312,46,19
47,10,1,9,317,56,31
46,11,1,10,318,70,35
52,13,2,11,311,47,33
54,12,2,10,304,37,8
56,11,1,10,296,42,13
59,10,1,9,288,35,19
62,10,0,10,281,32,22
67,10,0,10,275,29,15
70,12,0,12,272,24,19
72,17,1,16,268,17,19
72,18,1,17,267,15,24
72,15,0,15,264,17,23
76,11,0,11,261,14,19
79,9,0,9,249,23,23
81,10,0,10,248,20,11
79,9,0,9,244,23,17
83,16,0,16,243,16,14
77,16,1,15,245,14,23
73,18,2,16,248,16,18
75,22,5,17,258,16,20
69,30,7,23,267,18,22
65,26,4,22,271,28,30
64,21,2,19,275,31,24
64,27,5,22,280,32,26
69,24,2,22,280,40,34
74,21,1,20,275,53,37
77,25,2,23,274,45,42
77,24,3,21,274,35,46
77,18,1,17,273,36,39
78,16,1,15,272,33,44
79,12,0,12,270,30,40
81,14,0,14,268,21,37
80,37,1,36,266,10,47
81,39,2,37,265,7,60
79,29,1,28,262,12,60
80,15,0,15,261,22,49
82,10,0,10,258,25,48
83,11,0,11,258,20,51
82,17,0,17,258,13,58
83,24,1,23,258,5,62
83,23,2,21,258,4,59
84,30,7,23,259,3,53
82,28,7,21,262,6,63
79,22,5,17,266,10,60
75,21,5,16,275,16,53
68,16,3,13,287,24,55
60,21,4,17,299,33,48
56,13,2,11,313,44,46
51,12,2,10,325,47,39
53,12,1,11,324,57,47
54,12,1,11,320,61,32
80,8,0,8,233,53,35
75,9,1,8,252,53,0
83,12,1,11,235,43,0
84,4,0,4,229,48,15
85,6,0,6,225,48,1
85,5,0,5,222,53,9
84,8,0,8,223,47,4
85,7,0,7,223,44,17
85,8,0,8,222,39,0
86,6,0,6,222,37,12
85,6,0,6,220,38,1
85,8,0,8,220,34,8
85,20,0,20,221,20,9
85,13,0,13,221,21,7
85,23,1,22,224,13,19
85,27,4,23,229,13,10
85,19,3,16,233,17,19
84,33,10,23,239,12,12
85,28,8,20,238,11,20
85,18,6,12,235,18,5
83,18,6,12,234,19,4
84,9,3,6,228,23,0
85,11,3,8,225,22,7
82,10,4,6,234,21,0
79,10,3,7,230,22,19
78,7,2,5,226,23,0
80,5,1,4,222,24,15
80,5,1,4,221,22,0
79,5,1,4,222,20,13
78,4,1,3,221,21,0
78,4,1,3,220,21,8
78,5,1,4,220,20,11
78,2,0,2,219,20,6
77,2,0,2,218,19,13
77,2,0,2,214,18,1
76,1,0,1,212,19,17
76,2,0,2,210,18,0
77,5,0,5,209,16,15
75,7,1,6,211,14,0
73,8,2,6,216,16,17
72,6,2,4,223,17,9
68,6,2,4,238,18,18
63,12,6,6,250,19,16
59,11,4,7,257,23,17
57,10,4,6,269,26,20
54,6,1,5,265,39,16
55,9,1,8,274,45,18
58,11,1,10,273,47,20
59,14,1,13,270,54,23
63,14,1,13,267,53,21
63,12,0,12,265,39,17
64,12,0,12,263,30,14
66,12,0,12,259,26,14
70,9,0,9,251,23,14
72,8,0,8,247,18,11
76,10,0,10,245,14,8
77,9,0,9,246,16,15
78,8,0,8,246,19,13
81,5,0,5,244,21,13
80,8,0,8,245,18,15
80,6,0,6,245,20,23
79,4,0,4,244,24,12
79,4,0,4,246,25,22
78,9,1,8,248,18,13
78,10,1,9,249,18,28
77,12,1,11,254,20,23
78,11,1,10,253,22,24
77,8,1,7,259,28,21
73,7,1,6,266,30,19
72,9,1,8,268,32,23
69,10,1,9,276,35,25
72,15,2,13,275,34,27
70,9,1,8,281,38,23
70,9,1,8,282,28,18
70,9,1,8,280,27,21
72,9,0,9,277,24,21
74,18,1,17,275,13,19
75,20,1,19,273,10,25
77,11,0,11,272,14,27
80,8,0,8,268,12,29
81,9,0,9,265,10,26
82,12,1,11,263,7,26
83,9,1,8,262,9,24
83,10,0,10,261,7,27
83,9,0,9,258,8,33
83,7,0,7,257,12,35
81,13,2,11,258,10,41
77,11,1,10,262,13,42
72,9,2,7,274,16,33
62,7,1,6,290,28,32
56,6,1,5,307,33,29
53,5,1,4,312,39,23
54,4,1,3,312,38,16
49,4,1,3,323,34,12
44,4,1,3,331,31,11
45,3,1,2,334,32,12
44,3,1,2,334,32,12
52,3,0,3,320,34,13
60,6,1,5,305,29,21
63,4,0,4,290,23,23
68,4,0,4,283,22,22
71,5,0,5,276,20,17
73,2,0,2,271,21,15
80,2,0,2,264,21,14
79,2,0,2,262,21,17
76,2,0,2,259,22,12
69,14.11936411,1.763053633,12.35631048,257,27,13
67,6,0,6,256,28,11
68,11,0,11,253,19,9
74,18,1,17,253,11,8
75,24,5,19,255,5,15
71,16,4,12,260,11,11
60,19,6,13,276,14,16
53,14.12290215,1.765119821,12.35778233,293,33.58072331,14
49,28,8,20,301,24,10
48,23,6,17,306,32,11
47,23,5,18,315,37,8
44,19,4,15,316,38,10
41,14,3,11,326,37,7
41,12,2,10,333,44,16
44,13,1,12,332,54,17
48,13,1,12,312,53,13
47,10,0,10,306,37,7
52,12,0,12,297,29,6
61,13,0,13,289,26,11
61,17,0,17,286,24,13
68,21,1,20,279,14,15
70,19,1,18,276,10,15
73,19,1,18,273,8,16
75,12,0,12,270,12,17
78,7,0,7,266,15,14
82,8,0,8,262,13,15
86,9,0,9,257,11,13
84,7,0,7,246,17,5
84,6,0,6,239,26,8
80,8,1,7,240,23,8
74,9,2,7,250,26,9
64,12,3,9,265,28,12
59,13,3,10,272,32,15
55,20,5,15,285,31,11
52,15,4,11,290,35,13
50,14,3,11,297,40,12
50,13,2,11,298,46,16
47,12,2,10,304,51,21
50,14,2,12,297,47,17
52,13,2,11,290,38,11
52,10,1,9,283,34,8
58,9,1,8,273,31,6
59,10,1,9,258,25,3
60,6,0,6,254,25,0
65,9,1,8,251,19,0
69,10,1,9,248,16,11
70,3,0,3,246,22,0
71,1,0,1,240,25,3
71,1,0,1,235,25,2
73,1,0,1,230,27,0
79,2,0,2,230,25,7
82,3,0,3,228,20,0
85,8,1,7,226,14,9
85,9,1,8,225,13,0
85,7,1,6,222,15,11
85,19,7,12,220,12,0
86,23,9,14,221,11,12
86,24,10,14,224,11,3
85,23,8,15,224,12,17
85,17,6,11,225,16,0
85,19,6,13,224,16,17
85,19,6,13,224,17,2
86,23,7,16,223,14,0
86,12,4,8,222,17,14
86,11,2,9,222,16,0
86,9,1,8,221,15,9
86,10,1,9,222,13,5
86,9,1,8,222,12,0
86,9,1,8,221,11,14
86,11,2,9,221,11,0
86,11,1,10,222,9,13
86,5,0,5,221,12,3
85,4,0,4,219,14,3
84,4,0,4,218,15,7
84,5,0,5,219,12,0
85,9,1,8,219,8,15
84,12,2,10,217,6,0
85,11,2,9,218,8,11
82,9,2,7,215,12,0
84,19,7,12,217,11,6
84,15,5,10,215,12,1
83,19,7,12,216,9,8
77,15,6,9,222,13,3
69,13,5,8,227,16,17
65,17,7,10,233,15,0
60,12,4,8,233,17,8
62,12,5,7,231,17,5
60,8,3,5,231,20,1
62,7,2,5,225,22,5
64,5,1,4,222,21,3
65,5,1,4,219,20,0
67,5,1,4,218,18,13
67,6,1,5,217,17,0
65,6,1,5,216,17,12
64,3,0,3,213,19,0
66,2,0,2,211,18,13
67,4,0,4,206,16,0
64,7,0,7,203,13,0
63,6,0,6,203,15,12
63,6,0,6,202,16,0
61,8,1,7,204,15,11
61,9,2,7,207,15,2
59,10,4,6,217,15,15
57,13,5,8,223,15,10
53,15,6,9,238,15,8
51,23,10,13,246,14,13
52,12,4,8,250,22,12
51,5,1,4,252,26,12
50,11,3,8,254,25,3
51,11,3,8,253,26,6
47,5,1,4,262,27,4
52,5,1,4,252,26,8
54,4,1,3,247,25,0
57,3,0,3,239,24,0
63,4,0,4,231,22,0
68,4,0,4,225,22,7
71,4,0,4,222,22,4
72,6,1,5,217,19,4
74,4,0,4,213,18,11
74,3,0,3,211,18,1
74,5,0,5,209,15,13
74,6,0,6,206,12,0
74,8,0,8,204,9,12
75,13,1,12,203,6,6
76,11,2,9,204,7,4
73,11,3,8,213,9,18
62,8,3,5,232,12,16
57,6,2,4,249,14,6
52,6,2,4,261,16,12
51,5,1,4,265,22,9
48,4,1,3,273,27,9
47,4,1,3,280,28,10
47,4,1,3,284,23,4
50,3,1,2,280,21,6
46,3,1,2,291,20,3
51,3,1,2,278,19,1
56,2,0,2,266,20,4
64,2,0,2,252,21,3
67,2,0,2,242,19,0
70,3,1,2,237,18,0
72,2,0,2,234,18,5
74,3,0,3,231,17,0
75,3,0,3,228,15,4
65,3,0,3,225,14,3
65,4,0,4,226,14,2
65,4,0,4,224,13,16
76,4,0,4,221,14,0
76,5,0,5,218,12,11
75,10,2,8,219,8,0
72,12,4,8,228,8,6
68,10,4,6,240,9,22
64,15,7,8,251,10,7
59,20,10,10,260,9,10
55,14,6,8,275,13,9
50,15,6,9,279,21,10
50,13,4,9,283,27,11
49,13,4,9,286,28,15
49,14,4,10,287,29,11
49,15,4,11,290,26,7
50,10,3,7,287,26,6
53,9,2,7,281,25,9
57,8,1,7,271,21,5
62,9,1,8,262,16,2
66,10,1,9,256,12,6
69,13,1,12,252,8,6
71,15,2,13,249,6,7
74,11,1,10,245,7,8
75,13,1,12,243,5,9
76,13.87957563,1.784717964,12.09485767,242,3,6
78,11,1,10,239,6,14
79,10,1,9,237,6,0
80,12,2,10,234,4,12
79,17,5,12,234,4,1
77,23,9,14,238,3,14
75,27,12,15,241,3,18
74,13.88556508,1.791627596,12.09393749,243,32.69856687,11
71,41,21,20,251,4,21
65,32,11,21,257,10,23
64,23,6,17,260,13,22
65,27,8,19,263,13,15
71,31,9,22,258,10,20
74,25,5,20,256,18,20
68,21,3,18,251,21,21
72,19,3,16,252,12,8
70,17,2,15,248,12,1
71,21,2,19,244,8,8
72,33,4,29,243,3,8
73,38,7,31,236,2,14
75,19,1,18,234,9,4
81,17,1,16,234,9,7
83,21,2,19,236,3,10
83,15,1,14,237,3,4
83,14,1,13,238,4,16
83,11,1,10,239,7,5
83,12,1,11,239,6,8
84,13,1,12,235,7,8
83,11,1,10,236,11,2
79,15,2,13,239,12,11
78,24,6,18,240,9,1
74,26,7,19,241,10,14
74,26,6,20,244,12,6
66,22,5,17,254,18,14
57,12,3,9,270,24,10
54,8,2,6,279,25,13
57,9,2,7,273,28,13
58,9,2,7,277,25,11
60,14,2,12,268,25,9
60,18,3,15,266,21,7
66,10,1,9,262,22,3
70,15,1,14,254,15,8
70,15,1,14,250,14,10
71,18,1,17,250,10,2
72,25,2,23,248,5,15
72,18,1,17,247,10,8
72,12,0,12,247,13,8
73,11,0,11,246,11,3
74,10,0,10,246,13,6
76,17,1,16,244,7,6
78,16,1,15,244,7,4
79,15,1,14,245,8,10
78,15,2,13,246,7,5
75,17,5,12,252,10,14
66,17,6,11,266,11,12
62,16,5,11,277,14,16
55,23,9,14,290,12,14
53,22,7,15,300,17,17
51,13,4,9,302,21,8
51,14,3,11,306,26,9
50,12,2,10,311,31,8
48,9,2,7,304,26,11
48,7,2,5,303,19,3
50,12,3,9,298,18,2
52,15,2,13,294,15,6
58,22,2,20,283,8,5
65,13,1,12,272,10,2
68,21,3,18,268,4,3
70,21,3,18,265,3,5
71,11,1,10,262,6,5
74,11,1,10,258,5,4
75,11,1,10,255,5,3
75,14,2,12,254,3,3
76,13,2,11,251,3,5
79,12,1,11,247,3,5
80,18,5,13,246,1,7
80,26,13,13,248,2,3
74,22,10,12,258,6,13
67,18,7,11,273,8,15
56,18,7,11,288,12,12
51,17,5,12,301,17,11
48,16,5,11,306,16,6
40,10,3,7,313,18,4
35,10,2,8,324,25,8
31,8,1,7,328,27,9
35,11,2,9,333,34,12
42,13,2,11,326,47,13
48,16,1,15,310,56,10
50,12,2,10,300,22,4
52,14,1,13,291,13,2
55,17,1,16,282,8,3
59,12,1,11,275,7,1
62,16,2,14,270,3,2
65,24,7,17,266,1,4
64,25,8,17,262,1,6
65,19,4,15,258,1,3
67,12,2,10,255,4,6
73,11,1,10,254,4,4
75,13,2,11,253,2,9
75,13,2,11,251,3,3
76,21,9,12,252,2,4
71,16,7,9,258,5,8
60,21,8,13,274,9,17
52,15,5,10,294,15,12
46,15,4,11,308,22,13
44,13,1,12,313,41,13
42,13,2,11,322,45,8
39,8,1,7,330,41,11
42,8,1,7,330,36,13
42,7,1,6,332,40,10
44,9,1,8,324,39,8
47,7,1,6,312,25,0
51,6,1,5,302,21,0
55,6,1,5,291,17,3
63,6,1,5,281,11,3
65,6,1,5,275,8,1
69,5,1,4,270,7,2
69,6,1,5,269,5,4
73,6,1,5,265,4,6
73,5,1,4,265,6,6
75,6,1,5,263,4,6
76,12,2,10,259,1,6
76,11,2,9,256,1,1
76,12,3,9,253,1,4
76,10,3,7,251,3,0
70,7,3,4,262,5,5
62,5,2,3,276,8,13
57,5,2,3,291,9,17
54,4,1,3,302,11,7
54,4,1,3,302,14,8
57,3,1,2,302,15,3
66,3,1,2,297,11,6
70,3,1,2,299,11,3
64,3,1,2,296,11,6
60,3,1,2,301,10,0
62,3,1,2,297,11,3
63,3,1,2,290,12,6
69,2,0,2,278,12,3
70,2,0,2,271,11,0
74,2,0,2,266,11,2
74,3,0,3,267,9,6
74,2,0,2,266,9,7
75,3,0,3,266,9,7
75,4,0,4,262,8,6
76,5,1,4,260,7,3
76,7,1,6,261,4,1
77,5,0,5,256,4,3
77,6,1,5,255,3,2
77,13,6,7,256,1,6
74,16,9,7,262,1,8
68,14,8,6,275,3,9
65,16,9,7,285,5,12
60,19,10,9,295,6,12
55,14,7,7,308,10,10
53,16,7,9,315,14,9
54,16,7,9,313,17,6
49,14,6,8,327,14,1
48,12,6,6,331,11,6
50,12,6,6,325,12,0
54,11,5,6,311,12,0
59,7,2,5,297,13,4
64,5,1,4,286,12,2
70,5,1,4,278,11,0
72,4,1,3,273,9,4
72,4,1,3,270,10,5
73,4,1,3,269,9,4
73,3,0,3,266,8,5
74,3,0,3,264,9,7
75,13.84537192,1.856422579,11.98894934,262,8,5
76,4,0,4,261,8,5
77,4,0,4,258,7,6
82,6,1,5,256,6,8
85,9,2,7,251,4,1
86,9,2,7,251,4,8
84,13,6,7,260,6,5
73,15,8,7,276,7,14
68,20,10,10,288,8,20
80,19,7,12,269,10,21
79,19,6,13,272,11,12
79,14,4,10,263,15,5
60,14,5,9,284,19,5
66,27,8,19,282,16,12
64,17,4,13,282,15,12
67,23,5,18,283,13,4
68,13,2,11,282,10,9
70,19,2,17,279,6,6
74,14,1,13,278,5,4
75,13,2,11,273,4,7
76,14,2,12,271,3,5
75,14,2,12,270,2,4
76,11,1,10,268,4,7
78,14,3,11,266,2,5
79,19,6,13,264,1,9
80,19,5,14,263,1,10
84,15,3,12,252,3,8
86,17,1,16,248,3,1
86,17,3,14,247,5,0
86,31,14,17,246,2,13
84,25,10,15,251,5,5
76,13.86301228,1.879648893,11.98336339,267,31.33213715,13
67,24,9,15,287,13,16
61,19,5,14,299,21,17
57,18,4,14,303,28,14
52,17,3,14,316,32,12
48,13,2,11,324,33,18
54,14,3,11,316,33,15
58,16,3,13,305,28,13
61,16,4,12,298,18,2
61,9,1,8,294,15,1
60,11,1,10,292,10,2
61,13,1,12,290,7,2
61,18,2,16,287,3,4
67,13,1,12,281,3,1
69,12,2,10,279,3,0
72,19,6,13,275,1,4
73,16,4,12,272,1,6
74,19,6,13,270,0,3
74,14,3,11,269,1,4
77,17,5,12,268,1,5
78,22,9,13,267,0,6
77,30,17,13,264,1,3
77,28,15,13,266,2,6
72,21,9,12,279,6,12
62,22,8,14,295,9,20
61,18,4,14,303,19,19
55,16,3,13,312,28,10
53,19,3,16,327,34,16
44,15,2,13,331,37,16
40,19,3,16,338,37,17
48,13,2,11,328,36,18
51,16,3,13,324,28,10
53,14,3,11,318,22,3
56,10,1,9,307,18,4
57,13,1,12,298,13,0
62,18,1,17,292,6,1
67,19,2,17,286,5,5
72,13,1,12,282,6,5
74,11,1,10,280,6,7
75,15,1,14,277,3,6
72,17,1,16,275,5,7
74,18,1,17,273,5,10
76,19,1,18,271,4,14
77,22,2,20,269,1,13
78,30,7,23,267,1,13
79,29,8,21,268,3,11
75,30,12,18,274,5,10
68,36,13,23,284,7,25
63,36,12,24,292,9,25
58,31,8,23,310,18,17
56,32,7,25,319,24,21
50,26,4,22,327,38,21
48,16,2,14,331,49,22
45,11,1,10,333,48,16
45,12,2,10,333,41,14
43,13,3,10,335,32,11
50,13,3,10,321,20,3
59,11,3,8,301,9,0
67,16,3,13,290,5,1
70,16,2,14,286,4,2
73,21,3,18,280,3,5
74,16,1,15,277,4,7
77,14,1,13,274,5,5
78,19,2,17,272,2,5
79,16,1,15,270,3,6
81,15,1,14,269,3,5
81,15,2,13,268,3,6
81,21,5,16,268,0,9
81,20,5,15,267,1,13
81,21,8,13,270,1,8
77,20,9,11,277,4,8
70,18,7,11,288,7,14
62,19,7,12,302,10,14
60,25,9,16,311,10,17
52,20,6,14,320,16,19
48,13,2,11,329,37,19
44,9,1,8,338,51,18
42,9,0,9,345,58,21
44,8,0,8,344,61,22
47,12,1,11,344,62,21
47,11,0,11,332,67,18
53,11,0,11,320,47,12
58,13,0,13,307,25,5
57,15,1,14,298,9,5
65,11,1,10,293,5,5
69,13,2,11,286,3,8
69,13,2,11,281,2,11
68,10,1,9,278,3,8
66,9,1,8,276,3,8
68,9,1,8,274,3,10
71,9,1,8,270,2,9
74,5,0,5,266,4,5
76,7,1,6,262,3,5
78,5,1,4,262,4,5
75,5,2,3,271,5,4
66,7,3,4,283,5,17
54,3,1,2,301,8,9
50,4,1,3,315,12,6
46,5,1,4,323,16,12
45,4,1,3,330,18,11
43,4,1,3,335,14,8
42,4,1,3,337,13,3
43,3,1,2,335,13,2
44,4,1,3,331,13,2
49,4,1,3,312,13,0
53,3,1,2,302,14,1
59,2,0,2,291,14,5
64,2,0,2,284,14,4
68,2,0,2,279,14,5
69,3,0,3,277,11,6
70,3,0,3,273,9,8
70,5,0,5,270,7,6
71,5,0,5,265,6,7
70,5,0,5,263,6,6
69,5,0,5,263,5,5
70,7,1,6,258,4,10
71,10,1,9,254,2,5
71,13,4,9,256,2,11
67,15,7,8,264,2,5
63,12,5,7,268,4,12
59,11,5,6,284,6,12
56,15,7,8,296,8,12
57,17,7,10,300,10,18
56,13,5,8,305,13,9
53,11,5,6,316,12,6
49,9,4,5,324,13,6
49,10,3,7,323,18,8
48,9,3,6,323,19,8
50,10,3,7,315,20,3
51,7,1,6,307,21,2
53,8,1,7,300,20,5
53,4,0,4,295,19,3
51,5,0,5,291,19,3
52,3,0,3,287,22,2
52,4,0,4,286,21,2
53,7,0,7,284,17,4
54,11,0,11,283,12,6
53,13.85135907,1.928789474,11.9225696,284,8,5
54,22,2,20,286,4,7
50,25,3,22,293,5,6
47,17,1,16,296,20,14
46,24,2,22,297,13,16
42,25,3,22,311,15,14
40,25,4,21,320,18,16
36,17,3,14,339,25,15
32,8,2,6,357,30.54152426,12.98428254
31,8,2,6,361,32,12.98428254
30,9,2,7,367,37,12.98428254
27,8,2,6,372,41,12.98428254
27,8,1,7,376,38,12.98428254
27,7,1,6,375,37,12.98428254
26,8,1,7,369,38,12.98428254
28,9,1,8,362,39,12.98428254
30,11,1,10,354,36,12.98428254
34,11,0,11,343,33,12.98428254
37,16,0,16,334,25,12.98428254
42,15,0,15,325,24,12.98428254
41,12,0,12,316,26,12.98428254
44,12,0,12,309,23,12.98428254
52,15,0,15,300,22,12.98428254
50,12,0,12,295,23,12.98428254
52,13,0,13,286,17,12.98428254
55,15,0,15,280,12,12.98428254
57,15,0,15,275,11,12.98428254
60,18,1,17,270,9,12.98428254
65,22,2,20,272,7,12.98428254
58,17,3,14,281,17,12.98428254
54,11,3,8,292,25,12.98428254
53,15,4,11,310,26,12.98428254
49,13.85789503,1.92378076,11.93411427,320,28,12.98428254
44,13.85789503,1.92378076,11.93411427,330,31,10
50,13.85789503,1.92378076,11.93411427,328,36,22
46,15,3,12,336,42,24
45,17,3,14,333,39,31
43,15,3,12,329,37,93
46,14,3,11,325,34,16
51,17,3,14,309,28,14
57,12,2,10,298,29,16
60,11,1,10,287,28,17
64,9,1,8,277,28,12
63,5,0,5,274,30,10
63,4,0,4,270,32,8
61,4,0,4,265,31,8
62,2,0,2,264,31,8
61,2,0,2,265,32,5
61,4,0,4,263,29,8
58,4,0,4,263,29,7
55,4,0,4,263,29,7
56,7,0,7,263,25,10
54,7,0,7,264,23,7
52,10,1,9,265,22,8
50,10,1,9,268,25,7
47,17,3,14,278,23,12
49,15,3,12,286,26,16
43,14,3,11,299,27,18
42,5,1,4,312,29,10
44,5,1,4,308,34,11
43,5,1,4,308,29,7
43,7,2,5,308,29,11
44,4,1,3,306,30,9
48,3,0,3,298,31,7
56,3,0,3,288,31,7
64,3,0,3,271,29,12
67,3,0,3,264,25,10
70,3,0,3,261,24,6
72,3,0,3,258,23,4
73,2,0,2,257,25,16
73,1,0,1,257,28,5
73,1,0,1,254,26,12
74,2,0,2,252,23,7
75,3,0,3,250,21,7
74,2,0,2,247,20,8
75,3,0,3,244,19,9
75,5,0,5,245,17,8
73,7,1,6,249,15,8
69,13,4,9,256,14,11
63,19,7,12,263,15,13
58,26,9,17,275,16,17
47,22,8,14,291,21,13
42,18,5,13,304,27,13
41,15,4,11,308,31,12
41,12,3,9,307,36,10
42,11,2,9,311,41,16
48,11,1,10,301,48,17
51,10,2,8,292,36,18
54,7,1,6,280,30,15
53,7,0,7,270,25,10
55,5,0,5,260,24,4
57,5,0,5,256,24,6
63,4,0,4,252,25,5
66,5,0,5,251,23,9
66,5,0,5,250,21,9
66,6,0,6,248,21,8
68,5,0,5,245,21,3
68,5,0,5,246,19,5
69,3,0,3,244,23,9
70,3,0,3,243,23,9
71,3,0,3,243,21,4
70,2,0,2,247,23,14
59,5,1,4,259,20,10
56,9,2,7,275,19,18
53,7,1,6,285,26,20
52,6,1,5,288,35,15
50,7,1,6,297,42,20
47,6,1,5,306,48,24
46,5,0,5,308,54,29
45,5,0,5,311,53,27
50,5,0,5,302,49,17
53,6,0,6,290,49,18
51,6,0,6,278,38,22
52,4,0,4,266,26,5
54,7,0,7,260,21,1
56,9,0,9,257,18,4
61,6,0,6,252,19,7
66,5,0,5,247,18,2
67,3,0,3,246,19,9
66,2,0,2,245,21,4
66,2,0,2,243,19,10
64,3,0,3,243,18,0
65,2,0,2,241,19,10
64,2,0,2,240,18,0
65,2,0,2,239,21,12
65,3,0,3,242,20,1
62,2,0,2,245,22,11
55,2,0,2,256,23,6
53,3,1,2,265,24,13
48,4,1,3,279,24,9
45,4,1,3,290,31,14
44,3,0,3,299,40,9
43,3,0,3,306,42,14
42,3,0,3,308,46,13
46,2,0,2,306,39,9
50,2,0,2,287,35,8
53,2,0,2,271,36,8
53,2,0,2,262,35,3
59,4,0,4,257,29,3
63,9,0,9,254,21,6
60,10,0,10,254,18,12
61,5,0,5,253,24,10
64,5,0,5,250,23,11
64,5,0,5,250,22,4
65,5,0,5,251,21,10
64,7,0,7,254,20,7
64,9,0,9,253,18,10
65,8,0,8,250,17,8
67,11,1,10,253,14,8
65,16,2,14,261,16,12
62,16,2,14,269,19,11
57,11,2,9,281,27,12
55,9,2,7,287,31,15
54,8,2,6,292,33,17
54,9,1,8,297,37,15
50,10,2,8,306,37,12
49,8,2,6,308,37,17
52,7,1,6,302,37,16
56,7,1,6,296,34,16
58,9,1,8,290,31,15
57,6,0,6,288,29,9
60,8,0,8,286,26,7
62,7,0,7,280,22,9
62,7,0,7,278,19,5
65,7,0,7,276,14,8
65,7,0,7,276,12,6
66,11,0,11,275,9,5
67,12,1,11,273,8,6
70,13.57510389,1.880344202,11.69475969,269,7,8
71,12,1,11,267,6,6
72,12,1,11,263,5,2
73,10,1,9,258,5,3
75,10,2,8,255,5,7
70,10,4,6,266,6,4
65,7,2,5,280,11,18
60,13.56889921,1.880258623,11.68864059,291,30.31552516,11
60,13,5,8,296,12,8
52,9,4,5,311,15,4
46,9,4,5,329,14,9
46,9,4,5,323,15,11
54,7,4,3,313,13,7
70,6,3,3,295,10,8
72,6,3,3,287,10,12
73,6,3,3,284,9,5
73,3,1,2,283,9,6
78,5,2,3,276,7,9
84,5,1,4,264,7,9
82,6,2,4,258,9,1
85,3,1,2,257,15,0
87,2,0,2,254,12,7
88,2,0,2,248,10,0
88,2,0,2,242,11,0
86,2,0,2,242,16,0
84,3,0,3,242,17,2
80,3,0,3,247,15,5
85,3,0,3,242,15,0
85,8,1,7,243,13,9
82,20,6,14,255,6,0
75,24,9,15,279,9,15
59,32,12,20,304,12,15
49,27,9,18,327,16,20
49,24,5,19,337,32,23
50,17,3,14,336,38,25
56,10,1,9,326,42,25
55,9,2,7,326,35,19
56,8,2,6,319,32,25
59,7,2,5,312,29,21
64,7,1,6,303,29,23
67,7,1,6,295,30,35
72,8,0,8,292,24,40
76,6,0,6,289,22,39
77,7,0,7,288,16,40
77,8,1,7,287,14,38
78,11,1,10,287,11,37
80,17,1,16,283,6,38
79,16,1,15,284,6,39
80,18,1,17,281,5,42
75,17,1,16,280,5,39
77,12,0,12,277,12,24
77,15,1,14,274,8,15
77,22,3,19,272,5,14
80,24,4,20,272,4,14
77,31,9,22,272,3,31
70,32,14,18,292,7,24
65,23,8,15,296,10,28
65,17,5,12,302,13,18
62,13,4,9,308,15,20
64,14,3,11,306,22,22
70,17,3,14,293,19,27
77,26,5,21,279,10,24
83,23,3,20,271,10,27
85,19,3,16,268,10,22
81,13,2,11,261,11,13
83,17,2,15,260,8,22
85,24,4,20,261,3,30
86,21,4,17,264,2,25
86,14,3,11,265,3,15
86,13,4,9,266,1,10
87,12,4,8,266,1,9
86,10,3,7,264,1,7
86,10,3,7,261,1,7
87,9,3,6,255,1,5
87,5,1,4,254,2,0
87,8,2,6,255,1,3
88,12,5,7,255,1,6
85,13,8,5,261,2,10
76,13,8,5,275,3,17
72,10,6,4,279,5,17
61,12,7,5,297,5,9
52,10,5,5,303,9,5
51,11,5,6,312,10,5
50,10,5,5,319,9,8
52,8,4,4,314,10,5
55,9,5,4,312,8,5
60,9,5,4,301,7,0
69,7,4,3,288,7,2
68,8,3,5,284,6,4
71,6,2,4,279,6,3
74,3,1,2,273,6,2
75,4,1,3,271,5,5
76,6,2,4,269,4,7
79,7,2,5,266,3,8
78,5,1,4,267,3,7
80,7,2,5,262,2,8
80,7,2,5,261,1,7
79,7,2,5,259,2,4
80,4,1,3,257,2,3
83,5,1,4,254,2,2
87,8,3,5,249,1,0
88,11,6,5,249,1,0
88,12,7,5,254,2,5
88,11,6,5,259,3,1
85,13,6,7,247,3,11
89,14,5,9,246,5,0
87,15,8,7,275,6,2
72,9,3,6,291,11,12
84,6,2,4,275,8,10
75,7,3,4,289,9,5
83,5,2,3,265,9,9
85,7,2,5,270,7,0
85,8,2,6,261,5,7
86,8,2,6,261,3,1
85,8,2,6,263,2,6
84,10,3,7,262,2,6
85,9,2,7,261,1,11
85,10,3,7,259,1,10
86,13,5,8,257,1,13
86,14,4,10,255,0,10
85,15,4,11,254,1,8
85,16,4,12,254,0,6
85,17,5,12,253,0,6
86,19,8,11,254,1,6
85,23,12,11,254,1,7
84,28,17,11,261,2,9
76,27,15,12,274,3,15
64,18,10,8,290,5,22
60,14,8,6,296,5,14
58,9,4,5,298,7,10
57,9,3,6,312,13,9
52,5,1,4,324,16,15
50,5,1,4,328,19,15
56,6,1,5,320,17,8
61,7,2,5,305,11,5
63,7,2,5,302,6,0
64,8,2,6,298,5,2
68,8,2,6,292,3,8
71,6,1,5,288,3,6
75,5,1,4,286,4,6
76,5,1,4,286,5,7
78,5,1,4,284,4,5
80,5,1,4,283,4,8
85,5,1,4,277,4,9
85,3,0,3,274,6,5
84,3,0,3,274,6,7
86,4,0,4,272,5,13
87,7,1,6,270,4,12
87,7,2,5,269,4,10
86,9,3,6,269,4,13
87,12,6,6,267,5,12
86,10,4,6,264,6,8
88,10,4,6,264,7,7
89,9,4,5,262,8,8
90,8,4,4,262,9,4
86,5,2,3,264,14,0
85,5,2,3,253,20,13
88,5,1,4,251,21,0
86,7,1,6,238,21,10
88,7,1,6,238,25,0
83,8,1,7,249,21,9
84,12,1,11,257,19,0
80,14,1,13,271,16,25
76,14,1,13,274,14,16
78,15,1,14,274,13,17
80,14,1,13,273,14,17
83,7,0,7,271,15,17
85,7,0,7,268,14,15
86,13.43872164,1.940183015,11.49853863,268,12,14
87,9,0,9,268,10,14
87,10,0,10,269,9,16
87,12,1,11,268,6,15
87,21,5,16,266,2,17
85,59,36,23,261,1,17
76,48,25,23,260,2,17
79,43,18,25,271,4,15
78,13.46986997,1.960794478,11.50907549,278,29.28723996,25
75,45,23,22,283,4,19
75,17,5,12,279,13,15
68,14,4,10,297,17,9
63,23,6,17,297,19,10
65,13,3,10,294,24,9
64,16,3,13,294,24,10
67,25,5,20,286,19,10
68,20,2,18,282,20,7
64,16,1,15,278,21,4
65,20,1,19,270,19,2
76,10,0,10,263,26,6
77,7,0,7,253,26,7
76,7,0,7,249,33,1
76,7,0,7,248,29,1
79,8,0,8,245,25,3
80,9,0,9,242,23,4
79,13,0,13,243,20,2
79,9,0,9,240,26,9
79,15,0,15,239,20,3
81,14,1,13,239,18,10
79,16,2,14,246,15,4
78,17,3,14,254,20,16
73,17,4,13,268,23,10
64,19,4,15,287,26,17
60,11,2,9,299,33,13
58,16,4,12,304,35,11
64,14,3,11,286,32,13
71,13,4,9,276,17,6
71,14,5,9,277,14,0
67,18,5,13,285,16,0
71,20,4,16,284,16,12
67,19,3,16,285,16,9
68,27,3,24,282,6,8
72,23,2,21,279,7,5
74,19,2,17,275,5,8
78,15,1,14,271,6,7
80,21,2,19,267,2,5
77,13,1,12,265,6,9
78,13,1,12,263,6,6
79,18,2,16,261,3,6
80,20,3,17,259,2,8
71,23,7,16,255,1,6
71,25,9,16,252,1,4
71,36,18,18,253,1,7
77,23,9,14,264,5,10
69,18,7,11,276,7,15
60,19,7,12,291,10,14
48,17,7,10,308,10,9
48,14,5,9,315,13,13
47,11,3,8,319,22,11
44,11,2,9,321,29,11
44,10,2,8,331,31,15
49,11,2,9,325,32,17
52,12,2,10,317,31,5
54,16,4,12,307,18,6
55,14,2,12,303,13,4
58,16,2,14,294,10,5
59,17,2,15,290,5,9
63,11,1,10,283,6,5
68,8,1,7,278,6,2
71,11,1,10,274,4,7
72,16,3,13,271,2,7
73,9,1,8,268,5,6
73,10,1,9,265,3,6
75,12,2,10,264,2,7
77,24,11,13,259,1,7
77,38,24,14,257,1,10
78,42,27,15,257,1,8
73,33,19,14,268,2,16
67,25,12,13,276,5,19
61,23,11,12,296,7,14
53,23,8,15,306,12,16
47,20,6,14,319,19,16
44,20,4,16,325,28,17
42,13,3,10,328,23,14
39,11,3,8,333,21,8
42,11,4,7,333,14,5
40,10,4,6,331,11,4
43,11,4,7,317,14,0
50,15,4,11,308,11,0
55,12,2,10,298,8,0
62,13,2,11,289,6,5
66,12,2,10,286,6,5
70,11,1,10,282,5,4
72,12,2,10,278,4,7
71,11,1,10,278,4,6
74,10,1,9,276,6,6
75,11,1,10,274,4,6
76,14,2,12,273,2,4
76,17,4,13,268,1,8
79,16,5,11,261,1,6
80,11,3,8,260,3,3
75,9,3,6,261,7,4
69,5,1,4,266,28,11
69,6,1,5,263,32,8
67,8,2,6,264,31,6
66,6,1,5,259,32,6
66,7,1,6,258,30,5
66,5,1,4,254,31,9
68,8,1,7,250,29,6
75,9,2,7,243,27,5
75,7,1,6,238,26,8
76,6,1,5,233,25,8
79,4,0,4,230,25,2
76,4,0,4,226,26,5
74,4,0,4,227,27,12
72,3,0,3,226,27,4
73,5,1,4,222,28,16
72,5,1,4,221,27,0
71,4,0,4,221,26,13
70,5,0,5,219,26,0
72,5,0,5,216,24,9
71,6,0,6,217,22,0
72,7,0,7,217,20,0
81,6,0,6,216,15,14
81,6,0,6,216,14,0
75,7,1,6,218,16,0
75,7,1,6,219,19,12
75,6,1,5,224,21,2
72,6,1,5,230,22,11
73,7,1,6,234,20,6
71,6,1,5,242,21,8
70,6,1,5,246,26,13
72,6,1,5,247,31,12
73,4,1,3,248,33,11
71,3,0,3,248,28,4
71,3,0,3,250,29,0
71,2,0,2,246,27,6
76,2,0,2,236,27,0
82,4,0,4,231,23,3
81,5,0,5,228,21,0
83,4,0,4,227,21,7
85,5,0,5,227,18,0
86,3,0,3,228,18,6
86,3,0,3,229,18,3
87,4,0,4,231,16,1
87,5,0,5,234,14,8
88,6,0,6,236,11,0
89,10,1,9,239,8,9
89,6,1,5,243,11,0
88,6,1,5,249,10,8
87,7,2,5,250,10,0
85,12,6,6,255,8,6
78,14,7,7,270,8,3
74,13,6,7,279,9,10
74,15,7,8,280,11,12
83,13,6,7,276,12,2
77,14,7,7,286,11,0
65,15,7,8,300,12,4
62,14,7,7,302,11,4
65,11,5,6,290,10,6
71,6,2,4,280,9,8
77,6,2,4,273,9,3
82,5,2,3,268,9,2
82,4,1,3,267,9,1
83,4,1,3,266,9,4
84,3,1,2,266,9,5
82,2,0,2,268,9,7
87,2,0,2,260,10,9
86,13.41312257,2.007755492,11.40536707,260,12,4
84,1,0,1,263,12,9
83,2,0,2,264,11,12
87,3,0,3,257,11,16
87,6,1,5,257,12,3
87,6,1,5,253,13,12
88,9,2,7,250,10,0
87,8,2,6,253,13,9
80,8,2,6,256,25,7
86,13.39542719,2.005536988,11.38989021,264,28.65618429,17
70,10,2,8,271,22,9
62,8,2,6,282,26,5
56,9,2,7,292,26,11
65,14,3,11,284,21,10
68,11,2,9,279,24,1
80,16,2,14,248,24,2
80,8,1,7,231,33,0
79,10,0,10,234,31,0
79,16,0,16,234,21,14
65,22,1,21,240,20,0
59,12,0,12,244,39,17
55,11,0,11,245,41,5
53,9,0,9,247,44,12
52,8,0,8,245,45,8
48,9,0,9,246,44,6
47,7,0,7,245,45,11
55,11,0,11,244,41,5
56,14,0,14,245,37,16
57,20,1,19,246,32,8
56,22,2,20,257,30,11
56,24,4,20,270,30,23
53,22,4,18,284,34,19
40,14,2,12,302,40,20
43,14,2,12,310,42,11
46,12,2,10,303,45,13
47,8,1,7,306,46,13
47,9,1,8,307,44,11
46,9,1,8,307,45,17
45,9,1,8,301,51,15
53,10,1,9,289,45,14
52,11,1,10,279,42,18
56,13,0,13,273,36,14
50,22,1,21,273,27,15
50,14,0,14,271,32,11
52,13,0,13,268,32,13
56,17,0,17,264,27,12
60,16,0,16,259,27,12
57,15,0,15,255,28,11
59,13,0,13,254,30,14
62,15,0,15,250,28,9
63,15,0,15,245,25,13
62,22,1,21,240,17,12
63,32,3,29,240,8,15
60,50,18,32,240,7,12
58,42,14,28,250,9,23
55,34,10,24,267,16,20
50,28,7,21,285,25,25
44,23,4,19,295,39,19
37,19,2,17,305,52,20
36,13,1,12,315,67,20
41,15,1,14,316,70,24
41,19,2,17,319,59,21
44,13,1,12,305,63,9
47,13,0,13,303,59,14
48,24,1,23,295,43,11
54,36,0,36,289,23,18
58,34,1,33,280,13,16
60,30,1,29,275,12,17
62,35,1,34,274,7,17
62,51,8,43,270,1,19
63,39,3,36,265,3,22
69,30,1,29,260,6,20
72,20,1,19,250,15,25
70,12,0,12,245,28,23
69,18,0,18,240,20,19
69,25,0,25,235,13,27
71,32,2,30,235,8,20
68,29,5,24,240,12,26
68,27,5,22,250,19,25
64,22,5,17,270,26,28
61,22,5,17,279,30,31
58,18,3,15,290,40,28
54,19,3,16,295,48,26
50,11,1,10,300,51,27
47,16,2,14,310,49,32
50,19,3,16,310,47,35
52,13,2,11,305,46,26
57,13,2,11,294,39,22
64,9,1,8,279,29,25
70,9,1,8,270,23,19
75,8,1,7,260,20,19
76,9,1,8,259,17,22
77,6,1,5,258,19,21
67,6,1,5,255,20,17
78,4,0,4,255,20,17
78,3,0,3,253,20,22
77,3,0,3,250,20,13
78,5,0,5,249,18,18
79,9,0,9,246,11,15
78,14,1,13,245,5,18
78,19,3,16,240,3,17
75,16,4,12,245,8,17
70,9,2,7,259,14,27
61,11,4,7,270,15,17
59,11,3,8,275,18,19
49,9,2,7,295,22,13
41,13,4,9,300,24,12
43,7,1,6,313,26,14
45,8,2,6,315,22,6
44,9,2,7,314,22,8
48,6,1,5,300,21,9
57,8,2,6,286,19,11
67,5,1,4,275,18,13
70,4,0,4,269,16,9
73,3,0,3,265,15,7
74,4,1,3,262,14,8
81,4,1,3,255,12,8
85,4,1,3,250,11,0
82,3,0,3,250,11,10
82,3,0,3,250,11,4
82,2,0,2,249,11,10
81,2,0,2,245,11,2
82,3,0,3,245,10,8
83,5,0,5,245,8,7
84,8,1,7,245,6,8
84,6,1,5,247,7,13
82,6,2,4,255,7,10
77,5,2,3,264,8,16
77,7,2,5,265,10,21
70,9,3,6,282,11,15
63,6,1,5,291,19,13
62,5,1,4,295,25,15
68,4,0,4,283,27,7
58,6,1,5,298,23,9
51,5,0,5,305,33,7
54,6,0,6,300,36,17
55,9,0,9,295,38,5
58,12,0,12,290,40,15
61,22,1,21,285,14,17
66,21,1,20,279,13,13
70,19,1,18,274,9,11
72,20,1,19,270,6,13
75,22,2,20,269,4,14
77,23,2,21,265,2,17
78,16,1,15,263,4,17
79,14,1,13,260,4,14
79,18,3,15,260,2,13
81,18,3,15,268,2,12
81,28,11,17,257,1,11
77,31,15,16,265,3,11
66,19,7,12,279,9,21
55,17,6,11,295,13,15
51,17,6,11,308,15,11
48,14,4,10,315,16,10
48,15,4,11,315,21,10
43,11,3,8,320,21,5
35,10,2,8,325,21,6
43,9,3,6,325,16,12
48,8,3,5,315,14,3
52,8,2,6,305,12,0
60,10,2,8,290,9,0
67,10,1,9,285,9,5
72,19,3,16,280,3,5
72,15,2,13,277,4,9
74,10,1,9,274,6,8
75,10,1,9,270,6,6
78,8,0,8,270,10,7
78,10,0,10,270,8,4
75,13.4382752,2.002406262,11.43586894,270,8,8
73,11,1,10,269,10,6
73,10,1,9,265,10,7
77,11,1,10,265,9,8
78,14,2,12,266,7,9
75,24,9,15,275,5,11
71,23,9,14,280,7,18
64,13.44153056,2.005297199,11.43623336,295,28.38532365,14
58,18,6,12,305,14,10
52,19,6,13,310,20,11
52,15,4,11,310,22,13
53,13,3,10,310,27,11
54,14,3,11,308,25,10
56,13,3,10,305,23,6
60,12,3,9,305,20,9
65,16,4,12,295,16,6
69,15,3,12,286,12,9
70,18,1,17,285,7,12
61,21,2,19,290,4,10
63,15,1,14,290,7,7
69,24,4,20,280,1,10
71,20,3,17,277,1,9
71,21,3,18,275,1,9
73,20,2,18,272,2,6
76,14,1,13,270,8,6
75,15,1,14,269,8,7
76,16,1,15,269,9,8
77,6,0,6,261,16,5
85,10,1,9,255,12,6
85,10,1,9,255,11,3
84,15,3,12,258,9,5
81,12,4,8,265,10,10
79,13,4,9,266,10,8
80,13,4,9,268,13,10
81,20,8,12,269,10,8
76,18,7,11,265,11,0
73,11,3,8,274,19,4
68,16,4,12,285,25,7
64,18,4,14,295,27,10
67,20,2,18,290,29,6
68,16,1,15,284,22,7
69,17,1,16,280,14,8
76,18,1,17,269,9,7
78,14,1,13,270,6,9
78,12,1,11,269,8,9
78,8,0,8,265,11,8
79,8,1,7,265,11,6
76,13,1,12,268,6,12
82,5,1,4,260,14,10
83,11,0,11,256,7,6
83,14,1,13,252,5,8
83,9,0,9,250,10,6
82,17,4,13,258,2,5
76,17,7,10,265,3,15
70,14,8,6,285,3,11
69,12,6,6,278,5,16
65,10,5,5,290,6,11
62,9,4,5,290,9,6
67,10,4,6,290,9,6
67,8,3,5,292,8,8
56,9,4,5,302,7,8
58,9,4,5,295,7,3
67,10,3,7,283,17,7
69,13,3,10,280,15,4
76,9,1,8,274,16,12
75,11,1,10,270,14,8
79,12,1,11,267,13,7
84,12,1,11,260,11,5
84,14,1,13,260,9,7
85,14,1,13,259,8,6
85,15,1,14,260,7,8
85,15,1,14,260,5,9
83,19,1,18,259,3,8
79,10,0,10,247,14,6
80,11,0,11,245,14,0
75,6,0,6,240,24,1
78,14,1,13,240,19,0
77,24,5,19,249,11,10
58,12,3,9,261,21,3
51,13,3,10,280,26,16
47,14,4,10,295,29,8
44,12,3,9,307,36,8
42,8,1,7,307,47,6
45,12,2,10,314,51,2
46,19,3,16,312,50,5
52,17,2,15,306,49,8
53,15,2,13,300,44,2
56,13,2,11,292,39,7
60,13,1,12,286,33,8
65,10,0,10,279,32,5
66,10,0,10,270,31,5
70,8,0,8,265,30,4
69,9,0,9,265,25,5
72,13,1,12,260,22,6
75,7,0,7,256,24,6
74,6,0,6,245,23,7
73,7,0,7,240,18,6
73,6,0,6,236,17,5
75,9,0,9,235,12,9
74,11,0,11,235,10,11
72,15,1,14,235,8,5
70,16,3,13,239,8,12
60,16,4,12,240,12,15
54,11,2,9,261,19,13
47,12,3,9,284,24,15
50,11,2,9,286,30,12
50,9,1,8,295,39,4
47,7,1,6,300,45,4
46,10,1,9,300,50,15
48,9,1,8,301,55,11
53,7,0,7,295,55,12
56,7,1,6,286,44,16
60,6,0,6,276,43,13
63,8,0,8,270,36,9
67,8,0,8,264,34,10
69,10,0,10,258,29,10
70,9,0,9,251,28,10
71,6,0,6,249,30,8
73,5,0,5,246,29,11
74,4,0,4,246,30,13
74,4,0,4,245,28,9
73,4,0,4,245,27,12
65,4,0,4,241,28,7
82,4,0,4,233,25,9
83,4,0,4,227,27,5
85,5,0,5,227,25,9
85,5,0,5,230,24,7
85,5,1,4,236,23,2
76,6,1,5,241,29,23
74,7,1,6,235,38,10
71,7,1,6,240,42,10
69,7,1,6,241,45,12
68,6,1,5,237,46,11
71,5,0,5,230,47,6
69,5,0,5,230,48,6
71,6,0,6,225,46,0
73,5,0,5,225,47,0
72,10,0,10,225,38,5
73,7,0,7,224,42,7
73,7,0,7,224,38,4
74,4,0,4,224,42,12
76,3,0,3,222,43,0
76,4,0,4,225,40,12
76,6,0,6,225,32,5
75,7,0,7,225,30,8
74,7,0,7,225,27,18
74,8,0,8,226,24,10
75,11,0,11,226,20,22
76,13,0,13,226,17,8
75,17,3,14,231,12,16
73,17,4,13,239,10,17
70,15,4,11,245,12,20
67,23,8,15,250,13,13
60,16,5,11,265,20,17
58,16,4,12,270,25,17
59,12,3,9,270,30,14
58,15,3,12,271,31,12
60,17,4,13,275,32,10
64,11,2,9,266,35,11
66,9,2,7,256,32,3
68,6,1,5,259,27,1
71,5,0,5,245,25,0
74,3,0,3,240,26,8
82,3,0,3,231,28,0
80,3,0,3,232,30,7
82,4,0,4,232,27,2
82,4,0,4,230,20,12
82,3,0,3,230,21,2
81,13.34669469,1.993469996,11.35322469,226,19,7
82,4,0,4,225,19,7
80,7,0,7,225,15,2
81,11,1,10,224,9,16
84,19,3,16,220,2,2
85,26,8,18,219,2,10
86,25,8,17,220,3,2
87,13.34969868,1.995495999,11.35420268,220,28.10826996,12.44819232
88,39,19,20,221,2,0
88,55,28,27,230,3,0
87,51,21,30,235,8,16
83,18,4,14,234,19,3
81,13,3,10,236,25,10
79,21,5,16,240,24,0
77,23,8,15,241,19,8
78,26,6,20,241,16,10
79,18,1,17,240,18,7
83,11,1,10,235,21,5
83,11,2,9,225,19,0
83,9,1,8,224,17,0
82,10,0,10,221,14,3
84,11,1,10,220,14,6
84,10,1,9,220,10,0
82,8,0,8,216,9,9
81,8,0,8,211,12,0
81,8,0,8,210,16,5
80,8,0,8,210,17,5
79,12,0,12,210,15,4
79,13,0,13,210,14,9
78,19,1,18,210,11,3
75,20,3,17,215,12,14
75,19,3,16,220,14,1
75,21,4,17,225,13,13
71,29,9,20,237,13,4
69,22,5,17,236,19,17
67,17,4,13,249,24,8
65,16,3,13,252,29,6
65,13,2,11,255,33,10
65,15,2,13,260,34,8
64,13,1,12,257,37,12
66,15,1,14,255,33,7
70,17,0,17,250,26,10
73,16,0,16,248,20,5
73,23,1,22,246,11,11
73,31,1,30,245,8,16
76,31,1,30,245,7,22
77,23,1,22,245,8,24
83,14,0,14,236,13,23
81,14,0,14,230,13,17
82,10,0,10,231,18,8
83,13,0,13,231,14,13
84,14,0,14,229,13,10
85,13,0,13,225,15,12
86,14,1,13,225,18,0
87,20,3,17,229,15,12
86,24,5,19,234,14,9
85,21,5,16,237,16,21
79,20,5,15,245,20,13
71,15,3,12,254,28,12
66,16,4,12,257,29,13
63,16,3,13,260,30,8
61,14,3,11,261,32,7
59,13,2,11,257,32,8
62,11,1,10,254,33,7
67,11,1,10,249,32,7
73,16,1,15,245,25,11
74,17,1,16,244,21,12
76,16,1,15,240,19,12
75,15,1,14,236,20,4
77,15,1,14,235,18,12
77,11,0,11,232,19,4
79,8,0,8,227,21,14
81,8,0,8,226,19,4
82,7,0,7,224,19,5
83,8,0,8,220,17,10
83,14,1,13,219,10,4
83,16,1,15,220,9,3
82,21,3,18,220,7,20
82,20,4,16,223,8,4
83,27,9,18,225,7,20
83,29,11,18,230,9,9
80,28,10,18,235,10,11
77,22,6,16,236,15,13
80,18,4,14,235,17,10
80,25,5,20,231,18,7
80,28,7,21,236,17,11
76,21,4,17,240,22,11
75,19,3,16,240,22,11
76,17,2,15,235,20,9
78,19,1,18,234,15,5
77,23,2,21,230,10,8
78,16,1,15,231,13,11
78,18,1,17,231,13,8
80,16,1,15,229,12,12
81,22,1,21,226,5,4
82,21,1,20,226,4,11
82,23,2,21,225,3,7
83,20,1,19,224,5,9
83,17,1,16,220,6,12
83,22,4,18,220,5,0
84,34,13,21,219,1,14
84,40,18,22,222,3,6
79,51,23,28,232,5,33
69,29,8,21,251,20,22
66,22,3,19,256,29,25
61,23,3,20,271,33,15
56,26,3,23,275,38,20
55,24,2,22,279,47,20
54,20,1,19,285,64,25
52,18,1,17,286,75,24
57,17,1,16,280,75,24
61,19,1,18,272,58,30
69,25,1,24,265,36,24
73,28,0,28,260,21,18
73,27,1,26,257,17,16
74,21,0,21,256,17,18
76,24,1,23,255,12,15
78,19,1,18,254,13,18
79,12,0,12,254,17,16
79,11,0,11,252,17,20
81,13,1,12,251,13,18
81,14,0,14,251,10,17
82,17,1,16,251,5,23
82,17,1,16,251,3,21
82,14,2,12,246,2,18
82,13,4,9,244,3,15
83,9,2,7,244,7,18
83,7,1,6,243,14,22
81,13,3,10,249,11,21
80,22,5,17,251,8,26
80,18,7,11,252,7,17
76,9,3,6,261,8,6
77,7,2,5,256,10,9
76,9,2,7,255,9,7
75,11,3,8,259,8,4
75,11,3,8,260,7,8
75,16,3,13,256,3,7
80,18,1,17,242,5,10
82,17,1,16,235,6,6
83,10,0,10,229,13,9
84,9,0,9,227,13,5
84,9,0,9,226,14,9
84,7,0,7,225,13,6
86,7,0,7,225,11,0
86,6,0,6,225,13,21
86,3,0,3,220,25,0
85,2,0,2,218,28,1
86,2,0,2,218,29,8
85,3,0,3,217,27,0
85,3,0,3,220,25,2
85,5,1,4,221,24,6
84,5,1,4,224,23,6
82,10,2,8,224,22,13
80,11,3,8,221,22,1
75,5,1,4,220,26,12
74,3,0,3,220,30,0
74,4,1,3,220,32,9
79,3,0,3,219,31,2
83,5,0,5,211,27,3
85,8,1,7,201,25,7
86,7,0,7,204,26,0
86,5,0,5,200,28,6
86,7,0,7,199,25,1
87,8,0,8,196,21,1
88,6,0,6,195,24,4
88,4,0,4,195,26,1
80,7,0,7,195,24,3
88,7,0,7,195,22,5
88,13.4560315,2.016498818,11.43953268,191,25,5
88,4,0,4,191,23,2
88,4,0,4,191,21,3
88,6,0,6,190,19,4
88,11,0,11,190,14,0
88,15,1,14,190,12,4
88,16,2,14,192,10,2
88,19,3,16,194,11,3
88,21,4,17,195,12,4
88,19,4,15,195,12,3
88,19,5,14,195,13,3
88,19,5,14,198,17,2
88,18,4,14,200,17,5
88,16,4,12,200,23,0
88,13.45894523,2.017895274,11.44104995,200,27.69146113,6
88,13,2,11,192,23,1
88,10,1,9,195,28,0
88,4,0,4,195,37,4
88,13,1,12,181,17,2
88,12,1,11,175,18,0
88,10,0,10,175,22,0
88,8,0,8,175,27,0
88,18,1,17,175,16,2
88,10,0,10,175,20,2
87,17,1,16,176,12,3
85,9,0,9,176,15,3
84,9,0,9,176,13,4
85,11,0,11,176,10,1
84,18,1,17,176,5,2
83,22,4,18,179,5,4
80,20,5,15,184,8,5
75,22,7,15,191,9,7
70,21,7,14,201,15,14
67,18,6,12,210,20,8
63,17,5,12,221,22,9
62,9,2,7,229,30,13
62,11,3,8,226,29,6
65,14,4,10,221,28,0
66,10,2,8,219,29,6
68,11,2,9,212,29,3
70,8,1,7,209,31,4
71,6,0,6,207,31,7
72,8,1,7,205,29,7
74,7,1,6,204,28,4
73,8,1,7,202,27,6
78,10,2,8,197,23,1
76,12,0,12,195,16,5
77,12,0,12,194,14,9
79,8,0,8,191,12,9
81,8,0,8,186,11,11
81,6,0,6,184,15,7
84,6,0,6,181,15,0
86,8,1,7,182,15,5
87,10,1,9,182,13,4
87,12,1,11,185,13,6
88,11,1,10,186,13,6
89,16,2,14,186,10,5
89,18,4,14,192,10,3
89,14,2,12,195,14,6
89,16,3,13,196,13,6
89,18,3,15,196,14,5
88,10,1,9,200,19,0
88,7,1,6,199,21,4
88,10,1,9,196,18,4
88,9,0,9,195,20,3
88,9,0,9,194,20,3
88,9,1,8,192,21,2
88,7,0,7,190,23,2
88,6,0,6,192,24,1
88,8,0,8,192,21,0
88,7,0,7,197,21,4
88,9,0,9,192,18,0
88,12,0,12,194,15,7
89,16,0,16,195,9,5
89,13,0,13,195,12,0
89,18,1,17,196,8,3
89,34,7,27,196,1,0
89,26,3,23,196,7,4
89,27,5,22,200,7,7
89,33,11,22,204,6,6
88,29,9,20,210,9,8
87,33,12,21,212,9,10
87,36,10,26,212,7,5
87,31,8,23,214,8,8
88,38,12,26,214,7,8
88,33,10,23,215,9,2
88,28,7,21,215,10,9
88,28,4,24,215,7,9
88,29,3,26,214,5,3
88,33,3,30,210,3,12
89,29,1,28,210,5,1
88,31,3,28,212,4,19
89,23,1,22,211,6,4
89,23,3,20,211,5,10
89,18,1,17,210,5,12
89,20,2,18,211,3,6
89,17,1,16,210,3,19
89,17,1,16,210,4,0
89,16,1,15,210,4,19
89,18,2,16,210,2,16
89,16,2,14,211,1,10
89,31,12,19,212,1,25
89,32,15,17,212,2,0
87,20,8,12,217,5,0
87,17,6,11,220,5,23
86,17,6,11,224,6,19
85,15,4,11,225,8,31
85,12,2,10,226,12,26
85,11,1,10,225,13,15
88,17,1,16,225,11,8
88,19,2,17,226,11,15
88,37,6,31,225,3,19
88,22,2,20,222,8,15
88,17,1,16,217,10,18
89,14,1,13,217,12,0
89,20,1,19,216,6,5
88,17,1,16,211,8,16
89,19,2,17,210,7,10
89,22,2,20,210,3,12
89,17,1,16,207,4,20
89,17,1,16,206,3,4
89,22,2,20,205,1,19
89,18,1,17,204,3,6
89,12,0,12,200,6,15
89,9,0,9,199,7,10
89,11,2,9,202,6,12
88,11,3,8,206,7,21
88,10,3,7,221,11,19
78,8,2,6,235,20,27
73,10,2,8,243,26,19
68,9,1,8,260,32,19
66,7,1,6,265,41,17
64,6,1,5,270,40,11
61,6,0,6,275,44,12
61,8,1,7,277,37,9
64,12,1,11,270,44,13
67,15,0,15,265,47,18
68,19,0,19,260,41,20
72,27,0,27,255,17,14
72,36,1,35,250,15,22
77,28,1,27,249,16,22
76,31,1,30,247,12,23
77,31,1,30,245,10,24
79,28,1,27,244,11,25
82,25,1,24,240,9,22
83,24,1,23,240,6,26
83,37,9,28,236,2,18
84,45,16,29,235,1,30
82,50,21,29,234,1,22
82,84,50,34,238,2,30
80,31,6,25,243,11,29
70,25,4,21,244,20,29
67,30,6,24,264,25,22
64,18,3,15,268,34,24
62,15,2,13,275,41,22
60,18,2,16,285,43,22
57,18,2,16,244,53,25
56,21,2,19,290,58,25
56,18,1,17,290,58,17
70,18,2,16,268,44,26
76,13,1,12,255,36,31
78,10,0,10,256,32,28
80,11,0,11,249,29,25
81,8,0,8,245,29,35
82,7,0,7,240,26,24
82,8,0,8,240,21,32
82,7,0,7,237,20,23
84,10,0,10,236,15,22
85,13.60643915,2.047279035,11.55916011,236,11,24
86,12,0,12,235,8,20
86,11,1,10,235,7,32
86,14,2,12,235,3,25
87,18,4,14,232,2,36
87,23,9,14,234,2,22
87,19,7,12,235,3,31
82,13.61000824,2.049768888,11.56023935,244,27.25334919,23
78,22,9,13,252,7,31
75,19,7,12,256,10,29
72,21,7,14,264,12,25
73,21,6,15,271,16,27
64,13,3,10,286,23,19
61,12,2,10,294,34,19
65,18,4,14,286,19,16
68,20,3,17,283,19,23
73,16,2,14,270,14,24
75,16,1,15,267,9,17
77,17,2,15,261,6,11
79,17,2,15,260,5,10
80,20,2,18,261,2,12
81,26,5,21,260,1,14
82,25,6,19,257,1,15
83,35,18,17,255,1,13
84,36,20,16,252,1,15
85,31,16,15,251,0,15
85,30,15,15,250,1,16
84,36,21,15,250,1,14
84,36,22,14,250,1,16
83,41,28,13,250,1,15
79,46,31,15,256,2,14
70,44,27,17,273,3,17
65,32,18,14,281,4,16
62,27,12,15,289,6,11
60,24,7,17,297,12,11
64,18,5,13,290,13,7
67,21,5,16,286,11,12
65,22,2,20,280,36,16
69,22,1,21,275,39,33
71,22,1,21,274,38,34
74,21,1,20,270,34,35
75,25,0,25,269,24,43
77,18,0,18,262,24,50
78,18,0,18,259,15,51
78,17,1,16,255,11,42
78,13,1,12,250,11,35
76,14,1,13,249,7,27
77,8,0,8,248,11,18
78,11,0,11,246,6,16
75,15,1,14,245,3,20
75,19,3,16,245,1,21
75,24,7,17,245,1,23
81,21,5,16,242,2,21
82,17,4,13,245,4,17
84,20,8,12,250,3,31
83,25,10,15,251,3,31
80,37,22,15,256,3,31
79,24,11,13,252,5,33
75,22,8,14,261,12,28
74,20,5,15,260,14,30
76,20,7,13,252,9,28
73,22,9,13,256,12,20
72,13,4,9,250,18,21
71,13,3,10,240,16,4
74,10,1,9,233,22,0
73,9,1,8,230,29,0
73,8,0,8,230,32,1
74,6,1,5,229,36,13
74,6,0,6,226,36,0
73,5,0,5,220,35,8
66,3,0,3,215,34,0
59,3,0,3,214,33,2
55,3,0,3,206,30,12
51,4,0,4,202,28,0
51,3,0,3,200,27,11
51,5,0,5,195,25,0
50,6,0,6,193,24,6
52,8,1,7,195,22,1
51,10,2,8,200,20,5
48,12,3,9,211,22,16
43,12,4,8,230,24,1
42,12,4,8,236,27,15
41,13,4,9,236,30,8
42,9,2,7,244,36,7
44,12,2,10,236,37,13
45,17,3,14,233,34,5
46,15,2,13,230,34,5
47,15,1,14,225,32,0
49,17,1,16,224,27,10
51,14,0,14,220,26,4
50,14,0,14,219,24,12
50,15,0,15,219,23,0
52,18,0,18,218,17,17
54,21,1,20,217,13,5
56,18,0,18,217,14,10
61,18,0,18,215,14,12
64,15,0,15,212,17,1
64,18,0,18,210,14,15
67,16,0,16,200,15,1
80,11,0,11,192,18,0
82,12,0,12,183,12,9
84,13,1,12,182,11,9
83,13,1,12,181,16,11
80,15,2,13,185,15,9
80,14,2,12,190,18,15
79,14,2,12,195,18,14
78,12,1,11,197,20,23
84,12,1,11,195,19,10
82,14,2,12,200,24,11
76,10,1,9,205,28,11
75,10,1,9,205,29,14
76,13,1,12,205,25,7
73,7,0,7,202,30,15
70,8,1,7,205,30,0
67,6,0,6,205,32,15
67,9,0,9,205,26,0
68,11,0,11,202,22,21
69,13,1,12,202,23,10
67,6,0,6,202,32,17
68,7,0,7,202,25,8
71,7,0,7,200,20,9
74,9,0,9,195,15,17
75,11,0,11,197,12,8
75,11,0,11,200,11,22
76,17,1,16,200,6,13
71,15,2,13,205,7,24
31,10,2,8,210,15,10
61,10,2,8,230,23,31
54,6,1,5,250,32,18
53,6,1,5,260,36,19
56,6,1,5,265,43,14
50,5,0,5,273,47,16
49,7,0,7,278,58,11
48,7,0,7,275,64,18
50,10,0,10,276,77,16
55,11,0,11,265,67,17
59,13,0,13,255,54,20
63,15,0,15,248,55,17
66,11,0,11,240,45,24
70,7,0,7,234,40,14
74,7,0,7,230,36,9
75,10,0,10,230,30,12
77,9,0,9,230,28,19
78,7,0,7,225,28,4
79,8,0,8,225,23,18
80,13,0,13,223,14,6
81,14,0,14,222,9,14
81,17,1,16,222,8,18
82,18,2,16,220,5,9
81,25,6,19,222,4,20
80,25,5,20,225,7,8
80,33,9,24,230,6,22
80,39,12,27,240,8,17
81,37,8,29,245,13,34
79,48,16,32,250,8,41
77,50,16,34,255,10,42
80,90,41,49,248,2,41
81,77,31,46,245,3,50
82,66,23,43,245,2,46
81,17,3,14,220,13,16
84,16,1,15,215,15,0
85,19,1,18,211,12,3
85,18,1,17,211,12,2
85,16,0,16,212,10,8
84,30,3,27,212,2,2
84,34,5,29,212,1,8
84,42,11,31,211,1,21
85,43,16,27,210,1,9
84,13.77291948,2.131300126,11.64161935,210,1,16
84,34,7,27,210,1,0
84,40,13,27,210,1,17
85,57,29,28,210,1,1
85,66,39,27,212,0,17
82,60,36,24,215,1,2
78,52,29,23,225,3,20
63,13.82353721,2.16265348,11.66088373,255,26.91294013,13
51,26,11,15,260,7,19
50,24,8,16,282,12,15
48,24,7,17,290,20,14
47,18,3,15,304,36,15
44,17,2,15,305,49,21
40,18,2,16,300,42,11
46,21,3,18,295,37,2
52,21,2,19,286,34,9
57,26,2,24,275,31,17
65,21,1,20,270,31,16
66,18,1,17,260,33,21
69,11,0,11,250,34,18
67,15,0,15,244,28,11
68,14,0,14,238,28,17
68,10,0,10,228,28,11
70,9,0,9,225,27,17
69,7,0,7,221,27,10
72,9,0,9,219,24,18
74,12,0,12,215,18,10
73,16,0,16,214,16,12
72,17,1,16,210,15,18
70,16,2,14,215,17,3
70,13,2,11,222,20,23
62,15,4,11,237,25,11
59,13,3,10,252,29,17
59,12,2,10,250,32,15
61,13,2,11,250,33,11
65,14,2,12,245,31,10
68,18,3,15,242,27,12
69,18,3,15,237,25,10
63,15,3,12,235,26,10
63,14,2,12,230,24,10
66,13,1,12,225,22,2
70,15,1,14,222,18,9
81,18,1,17,235,14,6
81,9,0,9,245,30,14
74,9,0,9,242,34,21
78,4,0,4,255,24,11
79,4,0,4,260,15,17
74,5,1,4,266,7,8
71,5,1,4,265,7,17
66,7,1,6,250,7,9
73,19,2,17,225,4,7
67,22,2,20,230,3,7
63,31,5,26,227,2,12
56,39,12,27,235,4,8
48,22,5,17,255,15,6
41,17,4,13,275,23,14
34,12,3,9,294,28,9
32,8,2,6,305,30,6
32,9,2,7,310,32,8
32,9,2,7,310,34,5
33,7,2,5,307,37,3
30,10,2,8,305,35,0
46,12,2,10,290,33,2
44,16,2,14,265,33,6
51,12,1,11,250,32,0
56,13,1,12,240,31,0
58,10,0,10,235,32,0
59,12,1,11,230,31,13
58,8,0,8,231,35,6
58,7,0,7,231,36,11
43,14,0,14,225,24,7
42,10,0,10,220,26,1
41,7,0,7,215,30,8
43,6,0,6,206,30,0
42,8,0,8,200,28,9
44,10,0,10,194,25,2
45,13,0,13,190,21,5
41,26,4,22,194,13,7
38,12,2,10,201,22,16
34,13,3,10,216,23,10
36,17,4,13,227,23,16
34,21,6,15,221,25,14
32,19,5,14,235,29,8
33,10,2,8,245,36,11
35,17,4,13,307,38,16
33,15,4,11,305,39,16
34,15,2,13,290,38,10
42,11,1,10,265,39,13
46,12,1,11,250,32,0
46,13,0,13,240,28,8
48,13,0,13,235,27,10
52,12,0,12,230,27,20
53,14,1,13,231,24,11
55,14,1,13,231,22,22
56,12,0,12,225,22,4
57,13,0,13,199,19,18
57,13,1,12,200,20,5
58,13,1,12,200,18,18
58,15,0,15,200,15,4
59,23,1,22,196,7,14
61,17,1,16,192,11,9
60,18,1,17,190,10,20
62,20,2,18,190,10,15
63,21,3,18,194,10,19
63,26,5,21,192,9,17
73,29,6,23,190,10,18
78,35,9,26,190,10,19
83,28,4,24,185,13,25
84,33,9,24,195,13,16
81,36,7,29,205,10,32
82,31,4,27,207,10,13
81,39,7,32,206,5,27
83,45,10,35,208,1,17
82,55,20,35,208,1,20
87,35,10,25,233,5,30
82,38,11,27,210,2,21
83,38,10,28,215,2,24
77,17,2,15,242,9,22
72,12,1,11,245,10,6
76,12,1,11,247,8,16
74,12,1,11,250,5,7
76,11,1,10,245,5,13
72,8,1,7,250,7,0
76,8,1,7,250,7,12
74,10,1,9,254,4,3
79,7,1,6,254,6,13
83,11,3,8,250,5,5
83,13,2,11,205,8,10
86,14,2,12,205,9,8
86,16,3,13,205,12,13
82,14,3,11,215,16,21
79,7,1,6,224,21,3
53,8,1,7,230,28,18
48,7,1,6,230,31,0
43,6,0,6,230,31,8
45,5,0,5,225,32,8
42,7,0,7,225,30,1
44,6,0,6,219,29,6
44,7,0,7,209,26,0
46,8,0,8,200,23,9
56,7,0,7,195,23,0
52,3,0,3,192,28,10
49,3,0,3,189,29,0
50,3,0,3,186,27,8
49,4,0,4,182,26,0
49,6,0,6,182,26,5
50,5,0,5,176,24,0
52,4,0,4,176,24,1
51,6,0,6,175,22,2
53,8,0,8,172,19,0
53,9,1,8,175,17,4
52,6,1,5,180,25,8
52,6,1,5,184,26,10
51,6,1,5,185,26,0
51,6,1,5,190,27,13
48,5,1,4,191,30,1
51,3,0,3,190,34,10
49,4,1,3,190,33,0
51,3,0,3,186,35,6
51,3,0,3,185,35,2
51,5,0,5,185,34,2
52,6,0,6,180,32,4
55,7,0,7,180,30,6
55,5,0,5,180,31,6
56,5,0,5,176,31,0
56,6,0,6,175,30,7
59,6,0,6,174,28,5
60,5,0,5,170,28,3
60,13.82639368,2.157467951,11.66892573,168,26,3
61,7,0,7,165,23,4
62,7,0,7,161,21,5
62,8,0,8,163,20,5
63,10,0,10,162,18,5
64,23,4,19,162,6,7
54,18,4,14,167,14,3
50,13.82424748,2.15640226,11.66784522,180,26.74732354,6
47,15,5,10,191,21,12
44,10,3,7,200,25,20
49,12,3,9,195,27,0
49,9,2,7,191,31,4
49,11,3,8,190,30,0
51,10,2,8,189,30,10
54,10,2,8,185,30,0
55,11,2,9,181,29,6
56,10,1,9,176,29,6
56,13,1,12,175,26,0
55,13,1,12,175,25,5
57,14,1,13,172,23,4
58,12,0,12,170,23,5
59,17,1,16,168,18,7
61,22,0,22,165,10,5
63,25,1,24,160,6,7
67,22,1,21,155,3,12
70,27,5,22,146,1,15
71,27,6,21,144,1,15
71,42,22,20,140,0,14
70,35,15,20,139,0,12
71,40,20,20,140,1,12
65,43,23,20,152,3,14
55,33,15,18,170,7,21
46,21,8,13,189,13,17
43,19,6,13,200,18,26
41,17,4,13,210,27,18
40,13,2,11,215,38,14
36,11,1,10,225,46,13
35,14,1,13,225,50,20
35,23,1,22,220,45,13
41,28,1,27,212,45,8
45,25,1,24,200,35,2
43,18,0,18,195,29,5
46,22,0,22,190,23,6
49,22,0,22,185,22,12
51,23,0,23,180,22,10
53,27,1,26,180,18,8
56,14,0,14,175,24,12
60,8,0,8,170,26,11
60,9,0,9,170,24,9
60,9,0,9,165,23,6
58,10,0,10,160,22,5
58,10,0,10,160,23,5
58,10,0,10,157,24,5
56,11,1,10,158,25,6
56,12,1,11,160,24,7
54,20,5,15,161,19,7
51,14,3,11,166,25,10
54,14,3,11,166,27,10
47,15,3,12,169,26,8
51,12,2,10,170,29,9
47,10,2,8,176,30,8
49,9,2,7,171,33,9
51,12,2,10,169,31,5
54,12,1,11,165,31,5
56,13,1,12,165,29,5
58,12,0,12,160,28,6
54,14,1,13,160,24,9
55,16,0,16,160,18,13
55,21,1,20,158,13,14
55,18,0,18,158,13,15
57,19,0,19,155,11,16
60,17,0,17,150,10,20
60,19,1,18,149,8,17
59,18,0,18,148,8,17
59,17,0,17,145,10,17
60,18,0,18,142,11,13
63,24,1,23,138,5,11
66,27,6,21,138,4,12
60,32,13,19,150,6,14
50,27,9,18,164,12,20
42,22,7,15,179,18,18
38,18,5,13,185,24,24
32,13,3,10,190,32,1
30,10,2,8,190,37,4
31,10,2,8,194,38,2
31,11,2,9,195,39,12
32,11,2,9,190,38,0
36,13,2,11,180,35,10
40,18,2,16,170,31,0
43,31,1,30,160,16,0
46,34,1,33,159,11,10
47,38,2,36,155,9,11
49,26,0,26,150,17,8
54,33,2,31,145,11,11
56,52,11,41,141,1,11
59,93,49,44,136,1,12
64,103,60,43,130,1,12
65,90,51,39,124,1,20
68,70,36,34,120,1,20
69,36,9,27,110,1,24
70,34,9,25,111,1,26
71,51,27,24,114,2,20
68,46,23,23,128,4,23
53,32,13,19,155,11,30
45,25,8,17,185,19,31
40,17,3,14,202,32,33
39,17,3,14,212,39,22
31,13,2,11,222,45,19
30,7,0,7,226,51,18
28,6,0,6,229,54,12
29,6,0,6,225,53,13
35,8,0,8,210,50,8
42,15,0,15,200,42,4
43,17,0,17,190,32,0
47,20,0,20,180,26,17
50,27,1,26,175,18,5
54,27,1,26,179,19,28
56,22,0,22,162,18,23
59,31,1,30,156,9,15
60,33,1,32,149,6,11
65,21,0,21,140,11,14
66,21,1,20,135,9,21
66,17,0,17,130,10,23
66,16,0,16,128,10,24
65,14,0,14,125,11,20
65,14,1,13,127,12,21
63,16,3,13,137,15,26
52,15,3,12,170,20,32
46,11,2,9,185,33,35
44,9,1,8,200,39,33
40,8,1,7,210,44,20
42,6,0,6,219,46,19
43,4,0,4,234,52,17
45,4,0,4,235,49,21
41,4,0,4,236,43,11
43,5,0,5,225,40,9
41,13,0,13,212,33,2
49,20,1,19,205,23,0
51,23,0,23,200,17,10
54,29,1,28,195,12,1
57,42,6,36,190,3,20
58,43,6,37,187,2,7
55,47,10,37,185,1,9
59,44,4,40,185,2,25
59,38,3,35,184,2,9
62,34,2,32,185,5,25
64,34,4,30,180,3,23
74,37,6,31,167,2,31
75,24,2,22,170,5,34
81,34,9,25,160,3,32
83,24,3,21,160,7,17
85,31,6,25,160,6,16
86,35,7,28,162,7,17
86,50,16,34,165,5,16
86,52,16,36,170,5,16
87,65,24,41,187,4,17
84,33,5,28,190,15,9
83,50,13,37,185,5,11
83,35,7,28,185,10,12
83,36,6,30,185,8,15
84,31,2,29,180,7,1
84,30,2,28,180,5,9
85,31,3,28,180,2,13
86,33,4,29,178,1,16
86,34,6,28,180,0,18
86,40,12,28,180,0,18
86,36,8,28,180,0,15
87,34,6,28,178,1,14
86,14.15545357,2.24533699,11.91011658,179,2,11
86,27,2,25,177,3,15
87,17,1,16,175,8,12
87,19,1,18,175,5,10
87,32,9,23,176,2,10
86,59,34,25,176,1,12
84,61,36,25,185,2,16
75,41,21,20,202,5,30
73,14.18808235,2.263694786,11.92438757,210,26.45172147,12.38529327
70,29,10,19,225,14,0
63,24,8,16,250,18,18
58,12,3,9,255,28,16
55,16,3,13,255,25,11
54,11,3,8,256,29,3
59,13,3,10,250,29,8
62,13,2,11,240,28,11
64,13,1,12,230,25,0
68,19,1,18,225,18,0
67,14,1,13,220,23,0
71,9,0,9,216,27,5
71,10,1,9,210,27,8
71,9,0,9,209,24,0
72,12,0,12,206,20,15
72,13,0,13,206,18,0
71,12,1,11,205,22,12
71,11,0,11,201,20,1
74,18,1,17,200,12,0
65,22,2,20,198,5,14
77,32,7,25,195,1,2
74,19,3,16,194,12,16
68,11,2,9,201,22,5
63,11,2,9,210,26,24
59,12,3,9,220,29,11
61,11,2,9,230,31,9
61,10,2,8,225,35,18
54,9,2,7,225,37,5
54,9,2,7,235,37,11
56,9,2,7,235,38,16
59,11,2,9,225,38,13
58,10,1,9,215,37,1
61,10,0,10,210,35,10
62,15,0,15,205,29,9
64,19,1,18,200,27,17
65,18,0,18,200,24,9
65,19,0,19,195,22,19
68,25,2,23,195,17,8
68,19,1,18,195,20,22
67,14,0,14,195,25,8
69,16,0,16,194,20,19
68,17,0,17,194,18,7
72,36,5,31,189,5,22
74,48,15,33,185,0,13
75,47,15,32,185,0,12
75,74,39,35,185,1,17
72,79,42,37,195,3,24
65,47,16,31,211,12,32
52,28,7,21,245,23,24
44,22,5,17,255,28,21
34,15,3,12,265,33,16
29,10,1,9,275,40,13
31,8,1,7,277,42,13
31,11,2,9,276,41,11
28,11,2,9,270,40,11
25,14,1,13,255,39,9
25,13,0,13,240,41,6
30,13,0,13,232,42,3
36,13,0,13,220,38,12
35,10,1,9,215,41,10
36,6,0,6,205,44,12
36,6,0,6,200,43,18
38,6,0,6,195,42,14
38,5,0,5,186,42,12
39,6,0,6,182,39,13
41,8,0,8,175,36,13
42,9,0,9,169,33,14
41,9,0,9,160,32,13
40,11,0,11,162,31,12
39,14,1,13,162,28,12
38,12,1,11,168,28,13
37,12,2,10,175,27,17
37,15,4,11,190,29,18
40,15,4,11,200,31,27
43,17,4,13,200,29,15
40,16,3,13,207,33,12
41,16,2,14,215,38,28
40,18,2,16,210,39,19
40,17,1,16,206,40,12
46,19,1,18,200,36,0
51,21,1,20,186,27,8
52,18,0,18,176,25,3
51,19,1,18,170,23,10
56,18,0,18,166,20,10
57,22,1,21,164,19,9
60,21,1,20,159,17,7
62,21,1,20,152,17,7
64,16,0,16,152,18,7
65,20,1,19,150,12,7
66,16,0,16,145,11,14
64,11,0,11,140,13,11
64,16,1,15,140,10,9
61,14,1,13,140,12,7
60,16,1,15,140,11,9
59,17,2,15,145,11,12
58,19,4,15,155,11,14
57,23,6,17,166,14,21
56,21,4,17,170,18,25
55,19,3,16,174,21,23
54,16,2,14,180,23,19
56,18,3,15,180,24,22
57,19,2,17,180,22,23
58,16,1,15,180,24,21
60,18,1,17,175,22,20
62,19,0,19,175,17,17
63,22,1,21,172,13,23
63,28,1,27,174,10,26
63,20,1,19,175,17,24
63,20,1,19,173,15,27
52,21,1,20,170,12,38
64,15,0,15,166,18,32
65,15,0,15,165,19,21
68,17,0,17,165,13,20
71,18,1,17,160,9,23
74,17,1,16,155,7,23
75,14,1,13,150,8,23
76,20,2,18,160,3,23
73,14,2,12,150,7,23
68,11,2,9,160,11,22
56,8,2,6,178,19,22
46,6,1,5,200,29,26
43,5,1,4,205,32,29
39,3,0,3,210,37,18
39,5,1,4,210,39,16
38,4,1,3,210,41,14
47,3,0,3,205,40,7
55,3,0,3,190,39,0
56,4,0,4,186,38,5
57,4,0,4,180,37,3
59,4,0,4,180,36,4
59,4,0,4,176,35,7
59,4,0,4,172,34,6
60,6,0,6,170,30,3
53,5,0,5,170,30,4
43,6,0,6,160,26,2
50,8,0,8,152,24,0
48,6,0,6,146,27,1
53,6,0,6,137,24,0
50,6,0,6,130,26,2
46,8,0,8,126,27,2
46,8,0,8,120,28,4
45,10,1,9,120,27,1
45,10,2,8,130,25,5
37,21,7,14,150,21,10
31,22,7,15,166,25,16
29,17,5,12,180,27,17
31,9,2,7,180,31,18
29,7,2,5,179,34,5
25,9,1,8,190,37,10
23,9,1,8,194,41,10
30,14,2,12,190,37,9
32,19,2,17,180,33,8
42,22,1,21,165,26,0
42,18,1,17,155,24,3
46,22,0,22,150,17,5
48,22,0,22,150,17,6
47,34,3,31,149,9,9
49,39,3,36,142,5,10
42,31,1,30,134,6,11
44,22,1,21,126,13,5
45,14.2414321,2.262300648,11.97913145,120,18,2
49,15,0,15,114,15,5
54,20,0,20,105,7,5
57,22,1,21,106,4,12
60,32,7,25,98,1,9
60,44,19,25,97,2,16
57,56,30,26,108,3,16
50,14.26224227,2.271027777,11.99121449,130,26.36671629,26
45,38,14,24,150,11,30
46,29,8,21,155,16,22
46,35,9,26,161,15,15
45,35,6,29,166,17,20
44,38,6,32,171,17,21
47,45,6,39,170,12,17
49,38,4,34,160,13,18
56,44,3,41,155,8,21
60,48,3,45,145,4,43
68,46,3,43,137,4,49
75,53,8,45,140,1,45
74,53,10,43,135,1,47
74,46,6,40,132,1,41
77,47,9,38,135,1,44
75,45,8,37,132,1,43
71,31,2,29,131,4,30
71,24,1,23,135,6,22
71,22,1,21,135,6,21
70,18,1,17,136,6,17
70,20,1,19,138,3,13
70,32,8,24,140,0,17
72,37,15,22,140,1,16
69,32,14,18,145,4,12
60,24,10,14,165,8,15
50,30,13,17,198,10,29
45,38,15,23,225,12,34
45,35,11,24,238,18,22
49,33,8,25,245,24,15
50,35,6,29,250,31,12
54,31,4,27,247,34,14
58,25,3,22,240,32,13
65,20,1,19,232,35,9
69,31,2,29,225,23,7
73,67,19,48,215,2,4
76,36,3,33,208,11,25
76,24,1,23,201,21,19
74,16,1,15,199,31,22
72,14,1,13,196,32,29
71,11,0,11,197,31,10
69,18,0,18,192,16,22
65,15,1,14,187,16,6
65,13,0,13,186,21,9
55,11,0,11,186,25,6
55,10,0,10,176,26,3
48,12,0,12,175,22,0
49,13,1,12,174,23,0
44,13,2,11,189,24,8
38,13,2,11,205,25,22
37,9,2,7,215,31,19
34,11,2,9,218,31,4
28,8,1,7,225,36,17
22,8,1,7,230,38,13
21,9,1,8,235,38,10
22,9,1,8,230,39,10
22,10,1,9,222,39,10
21,13,1,12,207,34,7
23,14,0,14,194,30,0
49,18,0,18,186,27,9
51,14,0,14,170,32,17
53,15,0,15,164,30,17
52,15,0,15,162,30,15
53,13,0,13,160,31,14
41,27,1,26,150,13,17
40,31,1,30,140,9,10
41,16,0,16,132,18,5
45,13,0,13,124,19,7
47,18,0,18,125,12,10
49,23,1,22,120,7,10
52,30,5,25,116,4,11
52,37,10,27,116,1,15
51,39,14,25,118,2,20
52,47,20,27,124,2,23
52,51,23,28,126,2,27
52,46,18,28,128,3,22
56,43,13,30,124,3,28
70,40,11,29,115,3,34
81,34,8,26,112,5,20
83,38,10,28,112,4,19
84,42,10,32,114,2,21
85,57,22,35,110,1,21
85,53,19,34,109,0,23
86,42,9,33,110,1,18
86,36,5,31,105,2,15
87,35,4,31,106,2,14
88,29,3,26,110,4,12
88,19,1,18,112,9,9
87,16,1,15,115,12,7
86,15,1,14,120,12,11
86,14,1,13,124,13,13
84,13,1,12,125,12,13
84,13,0,13,124,11,12
84,17,1,16,124,7,9
84,24,4,20,124,3,9
85,28,8,20,130,2,13
84,30,11,19,145,5,9
64.15453814,14.5128509,2.32628258,12.18656832,224.3280757,26.14415359,12.47481479
64.15453814,14.5128509,2.32628258,12.18656832,224.3280757,26.14415359,12.47481479
64.15453814,14.5128509,2.32628258,12.18656832,224.3280757,26.14415359,12.47481479
64.15453814,14.5128509,2.32628258,12.18656832,224.3280757,26.14415359,12.47481479
64.15453814,14.5128509,2.32628258,12.18656832,224.3280757,26.14415359,12.47481479
64.15453814,14.5128509,2.32628258,12.18656832,224.3280757,26.14415359,12.47481479
64.15453814,14.5128509,2.32628258,12.18656832,224.3280757,26.14415359,12.47481479
58,14.5128509,2.32628258,12.18656832,180,26.14415359,10
40,8,2,6,170,33,24
61,7,1,6,165,34,12
59,7,1,6,156,33,7
50,7,1,6,150,29,8
51,6,1,5,141,28,8
49,6,1,5,135,29,9
53,6,1,5,130,29,7
51,5,1,4,126,29,11
50,5,1,4,124,29,10
62,5,1,4,114,29,12
63,5,1,4,113,29,10
62,5,1,4,111,27,10
59,5,1,4,110,26,11
58,5,1,4,110,26,11
58,6,1,5,110,25,12
55,8,1,7,115,24,10
51,11,2,9,116,21,14
51,9,2,7,126,24,13
52,8,2,6,126,27,10
50,7,1,6,126,29,10
52,7,1,6,124,28,12
50,8,2,6,130,30,10
49,5,1,4,130,32,10
54,5,1,4,128,32,9
58,7,1,6,120,31,10
59,8,1,7,120,29,8
60,7,0,7,116,29,11
62,13,1,12,115,23,10
64,18,1,17,114,17,12
65,31,2,29,114,7,10
65,34,3,31,115,4,11
64,30,3,27,110,6,14
63,16,1,15,106,11,22
65,15,1,14,105,9,26
66,18,1,17,105,6,23
64,25,3,22,105,3,21
66,23,2,21,102,3,21
69,24,4,20,95,2,21
70,33,13,20,95,2,17
61,42,23,19,110,3,24
54,25,10,15,130,9,29
49,26,10,16,145,14,31
49,24,8,16,159,18,27
46,28,8,20,165,20,26
46,31,8,23,170,20,24
46,34,7,27,175,21,14
48,34,5,29,175,18,13
50,33,4,29,167,17,9
53,27,2,25,156,19,11
55,30,2,28,156,16,16
54,31,1,30,154,14,18
53,32,2,30,151,12,22
54,34,1,33,150,8,26
53,39,3,36,148,4,27
54,31,2,29,145,8,25
54,34,2,32,142,4,29
57,40,5,35,144,1,30
59,14.55290687,2.333368797,12.21953807,140,1,28
64,58,24,34,140,1,30
70,53,23,30,138,1,24
73,51,25,26,134,0,23
78,51,28,23,130,0,20
80,45,22,23,127,0,15
81,52,28,24,125,0,15
82,14.59619664,2.359807324,12.23638931,125,26.03135696,20
84,49,22,27,125,2,15
82,40,15,25,126,3,10
78,43,16,27,129,4,15
75,51,24,27,130,4,17
64.0883471,46,22,24,223.0678377,7,17
64.0883471,41,14,27,223.0678377,12,31
64.0883471,38,9,29,223.0678377,13,35
64.0883471,33,4,29,223.0678377,10,9
68,44,7,37,147,2,0
66,37,5,32,149,3,11
62,19,2,17,140,13,12
65,8,1,7,130,23,3
62,7,1,6,126,23,0
57,9,1,8,124,23,0
53,6,0,6,120,24,0
53,8,0,8,116,22,2
53,5,0,5,113,26,2
52,7,0,7,119,24,2
52,8,0,8,108,24,2
52,10,0,10,106,23,5
56,11,0,11,105,21,4
51,17,1,16,105,17,3
50,17,3,14,109,21,3
49,18,4,14,112,21,7
49,26,7,19,115,18,7
47,26,7,19,115,19,8
44,25,6,19,115,20,6
45,21,5,16,113,21,5
50,21,5,16,113,22,5
51,22,5,17,112,20,8
54,24,6,18,111,19,5
55,25,5,20,111,17,8
59,21,2,19,110,18,8
57,23,1,22,109,13,10
64,28,1,27,105,7,10
68,26,1,25,103,7,10
71,25,1,24,98,7,13
78,22,1,21,94,9,13
79,23,1,22,94,7,14
82,17,0,17,91,9,14
83,17,1,16,90,10,12
83,12,0,12,90,13,11
82,9,0,9,91,18,9
81,8,0,8,94,19,10
78,10,0,10,95,16,11
74,15,1,14,98,11,8
78,20,5,15,104,10,14
61,20,6,14,117,13,17
54,14,4,10,140,21,21
46,12,3,9,155,25,19
48,9,2,7,166,33,18
40,7,1,6,177,38,22
38,6,1,5,185,39,7
35,6,1,5,185,41,10
30,6,0,6,179,40,13
30,6,0,6,167,36,0
31,13,0,13,155,29,0
32,14,0,14,145,28,0
36,20,0,20,135,22,0
38,25,0,25,127,17,6
40,25,1,24,124,17,6
43,21,1,20,119,20,7
45,18,0,18,116,21,7
47,17,0,17,114,20,10
49,19,0,19,108,18,8
50,17,0,17,103,19,8
52,16,0,16,99,18,5
52,25,1,24,96,12,5
51,23,0,23,95,13,6
51,33,5,28,96,9,5
47,49,16,33,109,7,6
37,27,8,19,141,18,17
30,10,2,8,159,30,16
24,9,2,7,170,32,9
23,7,2,5,174,34,10
22,8,2,6,182,35,11
23,9,2,7,179,36,13
24,10,2,8,183,37,21
26,8,1,7,175,37,7
32,19,1,18,160,28,9
38,41,5,36,157,11,0
48,24,0,24,149,20,12
44,27,1,26,142,18,13
49,25,0,25,148,18,10
51,25,1,24,135,18,12
52,30,1,29,128,11,11
55,32,1,31,125,9,13
55,33,2,31,124,6,13
57,33,2,31,123,4,14
57,33,3,30,120,2,15
54,26,2,24,113,4,16
53,27,2,25,108,4,17
53,23,1,22,106,7,19
52,20,1,19,105,9,19
48,24,3,21,108,9,16
53,22,4,18,110,9,20
48,26,7,19,126,10,22
42,26,8,18,159,16,28
40,20,5,15,174,23,35
43,23,5,18,180,28,36
42,29,5,24,193,31,24
46,41,6,35,189,33,19
59,28,2,26,189,34,13
65,21,1,20,179,37,1
60,22,0,22,180,32,4
49,21,0,21,176,31,13
52,29,1,28,169,23,13
66,42,2,40,157,9,16
72,53,10,43,145,1,19
70,42,5,37,136,4,29
66,32,1,31,130,8,35
66,29,1,28,132,7,38
63,25,1,24,124,9,36
63,21,1,20,120,11,27
62,20,0,20,116,10,21
59,15,0,15,119,13,17
58,15,0,15,119,17,17
57,10,0,10,127,24,19
51,6,0,6,149,30,17
43,7,1,6,173,31,23
37,6,1,5,190,35,30
34,4,0,4,196,38,29
39,4,0,4,202,42,12
32,3,0,3,197,44,15
28,3,0,3,200,40,15
28,3,0,3,194,39,14
28,3,0,3,186,38,10
46,4,0,4,166,39,10
47,5,0,5,155,36,10
41,5,0,5,142,32,9
43,5,0,5,131,30,5
43,6,0,6,124,28,3
45,8,0,8,118,25,7
46,9,0,9,111,24,8
48,8,0,8,105,26,10
39,7,0,7,103,27,12
50,7,0,7,97,26,13
51,5,0,5,94,29,12
51,6,0,6,94,28,12
53,10,0,10,88,23,12
54,9,0,9,81,25,15
53,10,0,10,80,24,14
50,10,1,9,89,24,11
47,14,4,10,110,24,17
41,11,3,8,126,27,22
41,10,3,7,133,28,19
38,10,3,7,136,29,17
38,9,3,6,136,32,16
36,8,2,6,140,34,18
41,9,2,7,138,33,5
46,8,1,7,127,34,6
50,10,1,9,116,33,5
52,12,1,11,110,30,0
53,14,0,14,106,25,4
55,22,0,22,101,16,8
57,28,0,28,97,11,9
57,28,1,27,97,12,11
62,21,0,21,92,16,9
63,31,1,30,85,5,11
61,32,1,31,81,4,14
64,14.72731983,2.36309306,12.36422677,76,4,17
65,43,10,33,73,1,15
68,57,25,32,68,1,17
69,50,22,28,64,0,24
70,51,24,27,62,0,22
69,78,48,30,65,1,21
61,51,25,26,82,3,23
56,41,17,24,94,6,29
53,14.77774497,2.392164837,12.38558013,107,25.82934906,32
50,40,14,26,116,25.82934906,30
50,43,14,29,118,11,25
51,42,11,31,119,10,27
51,38,7,31,118,11,22
52,43,9,34,114,9,24
54,49,9,40,114,4,27
54,48,6,42,114,2,31
55,51,8,43,113,0,34
57,54,11,43,111,0,37
63,46,6,40,107,0,37
69,42,5,37,103,1,39
70,41,4,37,100,1,37
74,42,4,38,100,1,38
75,40,4,36,100,1,34
77,45,8,37,98,0,32
79,40,6,34,96,1,28
66,24,1,23,103,9,20
50,12,0,12,108,22,8
40,7,0,7,111,29,2
40,10,1,9,106,27,0
41,12,1,11,104,25,1
41,11,1,10,103,26,0
36,11,1,10,105,27,1
34,10,2,8,110,29,1
29,9,2,7,130,30,3
24,9,2,7,133,32,8
24,6,1,5,131,34,8
25,5,1,4,129,36,4
25,6,1,5,126,35,1
28,6,1,5,111,34,4
30,10,2,8,99,32,1
32,7,1,6,92,33,0
31,10,1,9,90,30,0
32,8,0,8,86,31,2
34,7,0,7,83,31,5
34,7,0,7,84,31,6
35,6,0,6,83,31,6
34,5,0,5,83,33,5
34,4,0,4,80,34,4
34,5,0,5,80,33,3
35,4,0,4,78,33,3
36,5,0,5,78,32,4
37,8,0,8,78,30,3
40,10,0,10,75,28,4
42,12,0,12,72,25,3
41,13,1,12,79,24,5
40,16,2,14,84,22,6
39,23,5,18,91,19,8
36,18,5,13,101,23,10
36,21,6,15,108,23,9
35,14,3,11,107,29,14
36,15,3,12,113,29,6
43,16,3,13,113,28,4
44,23,4,19,111,22,6
44,20,3,17,107,23,6
44,18,2,16,105,23,4
43,15,1,14,103,24,7
44,17,1,16,103,21,8
49,24,1,23,101,14,11
58,25,1,24,94,13,11
58,20,1,19,91,15,10
58,16,0,16,86,16,15
68,17,0,17,78,12,20
75,15,0,15,72,13,18
81,14,0,14,68,13,11
83,17,1,16,65,9,10
85,17,1,16,63,10,11
86,15,1,14,63,14,9
87,16,1,15,64,13,7
88,20,2,18,66,11,5
89,25,5,20,74,10,8
89,30,9,21,90,11,10
86,39,14,25,88,6,10
86,38,12,26,90,6,11
87,22,5,17,96,14,6
87,29,7,22,98,9,7
87,31,6,25,101,9,8
87,23,3,20,104,14,3
87,26,3,23,107,11,4
87,23,2,21,108,11,6
86,20,1,19,109,12,6
86,24,2,22,110,9,6
85,29,3,26,112,6,8
85,25,2,23,115,9,5
85,16,1,15,115,12,4
85,21,1,20,115,5,4
85,26,3,23,115,3,6
84,20,1,19,116,5,6
83,23,2,21,118,4,8
83,25,3,22,117,3,7
83,31,7,24,117,1,8
82,23,4,19,116,1,5
80,31,11,20,116,0,8
82,30,13,17,117,2,8
77,26,11,15,125,4,11
75,19,6,13,133,8,10
70,23,8,15,145,9,10
61,17,6,11,156,15,13
58,10,2,8,167,23,12
48,10,2,8,181,29,27
45,9,1,8,183,32,12
51,10,1,9,170,33,5
58,10,0,10,157,31,0
64,16,0,16,146,25,3
67,16,0,16,143,25,5
70,25,1,24,136,17,7
71,38,3,35,134,6,13
74,50,11,39,128,1,16
75,59,20,39,124,0,18
77,62,21,41,120,0,14
78,48,12,36,116,0,16
73,55,20,35,114,0,14
71,37,9,28,107,1,15
70,23,2,21,101,3,15
71,19,1,18,96,4,15
70,16,1,15,95,5,14
72,19,3,16,88,3,13
70,27,10,17,91,3,15
66,24,9,15,105,7,23
59,28,11,17,135,9,32
54,20,6,14,161,16,29
48,17,4,13,175,24,28
50,17,3,14,181,32,25
50,17,2,15,186,39,18
54,24,2,22,184,39,18
60,28,2,26,180,32,12
63,25,1,24,176,29,19
63,35,2,33,165,17,0
71,59,11,48,159,1,18
72,42,2,40,154,6,18
68,36,1,35,150,9,20
70,28,1,27,148,16,23
72,30,1,29,140,8,28
73,24,1,23,137,10,29
74,21,1,20,133,12,29
75,23,1,22,128,6,26
74,19,1,18,124,8,22
67,24,2,22,124,3,24
72,33,7,26,121,0,21
72,33,8,25,119,0,20
75,43,18,25,115,0,20
75,64,38,26,120,0,21
68,52,28,24,129,1,24
66,42,19,23,136,4,24
66,44,18,26,143,3,28
63,48,18,30,150,3,27
65,45,15,30,153,6,25
64,34,8,26,160,9,26
64,39,8,31,160,7,26
66,42,7,35,158,4,20
68,52,13,39,155,2,22
68,64,21,43,153,0,23
74,74,31,43,150,0,26
78,74,31,43,145,0,27
82,41,4,37,138,1,23
75,34,2,32,135,4,23
75,31,1,30,130,5,23
86,25,1,24,129,7,28
86,24,1,23,130,7,26
86,15.10632866,2.473408358,12.6329203,131,7,28
87,22,1,21,131,7,25
86,19,1,18,132,7,22
86,23,1,22,133,3,23
86,25,3,22,134,4,22
86,43,15,28,136,1,21
85,51,22,29,140,2,19
83,15.12318305,2.478546962,12.64463608,146,25.46112961,21
80,42,14,28,150,5,20
76,52,18,34,157,4,18
71,49,16,33,168,10,16
65,37,10,27,176,16,23
62,29,6,23,185,19,28
61,31,5,26,185,18,4
63,38,5,33,183,12,12
66,39,4,35,177,8,2
68,60,14,46,173,1,15
70,109,57,52,170,0,12
47,32,7,25,169,14,11
46,9,0,9,158,25,0
44,8,0,8,150,27,0
40,5,0,5,141,32,3
38,5,0,5,134,34,0
39,3,0,3,126,34,0
39,3,0,3,120,35,3
37,3,0,3,116,35,5
36,4,0,4,115,35,5
36,6,0,6,112,32,2
38,8,0,8,109,29,3
42,13,0,13,104,24,6
43,15,1,14,105,21,4
40,14,2,12,112,22,7
34,13,3,10,130,25,8
30,10,2,8,139,28,10
39,8,1,7,141,31,1
29,8,1,7,146,31,3
30,11,2,9,150,29,6
29,15,3,12,151,28,5
32,15,2,13,146,27,5
33,25,4,21,142,19,5
35,30,1,29,143,13,5
44,37,2,35,140,5,14
47,38,3,35,136,4,14
45,37,2,35,135,4,16
38,27,1,26,130,10,12
41,23,1,22,126,12,5
50,28,1,27,116,5,8
54,22,1,21,111,7,11
55,15,0,15,108,9,9
52,24,1,23,104,3,10
50,22,1,21,100,6,10
50,21,1,20,94,8,5
50,30,4,26,86,3,7
53,36,9,27,83,1,5
49,32,10,22,90,5,8
47,24,8,16,104,10,15
44,36,15,21,125,8,20
34,36,14,22,154,11,23
34,37,13,24,167,15,28
33,28,8,20,162,22,26
28,21,4,17,176,27,13
32,19,3,16,174,27,18
39,24,4,20,161,24,0
60,21,3,18,145,25,9
64,12,1,11,135,31,5
66,13,0,13,127,26,3
66,12,0,12,125,25,3
67,25,4,21,124,16,5
50,34,2,32,119,7,8
46,17,0,17,107,18,5
45,14,0,14,102,21,2
49,11,0,11,94,22,1
53,15,0,15,86,16,4
60,18,1,17,80,11,5
58,26,3,23,79,8,7
54,13,0,13,74,18,8
55,17,0,17,69,13,8
54,45,14,31,66,2,11
69,74,40,34,70,2,12
56,56,28,28,83,5,20
48,40,17,23,106,10,25
42,33,13,20,129,13,24
41,29,10,19,143,18,25
36,22,6,16,148,25,30
35,17,3,14,162,33,18
40,22,3,19,157,29,8
43,25,3,22,160,27,10
43,22,1,21,154,29,19
45,42,2,40,144,8,3
49,35,1,34,133,9,20
51,35,1,34,123,7,26
51,36,1,35,116,7,27
54,44,4,40,112,3,25
56,51,9,42,107,0,37
58,59,16,43,100,0,41
59,59,19,40,97,0,28
58,48,12,36,93,0,25
58,25,1,24,91,5,18
59,24,1,23,89,4,14
61,33,6,27,91,0,17
73,42,14,28,86,0,19
83,42,15,27,84,0,18
83,40,14,26,80,0,18
85,39,14,25,81,1,17
86,37,12,25,88,4,18
86,35,10,25,91,4,19
84,41,14,27,96,3,21
84,45,16,29,98,2,22
84,45,15,30,99,2,20
85,38,10,28,98,2,22
84,31,6,25,101,3,19
81,32,5,27,105,3,18
80,33,4,29,108,2,16
79,38,7,31,110,1,16
77,28,2,26,114,5,17
77,29,2,27,111,3,17
78,34,6,28,110,1,19
79,39,10,29,110,0,19
81,48,19,29,106,0,21
81,57,30,27,103,0,19
82,63,36,27,103,0,19
84,53,27,26,102,0,17
83,52,28,24,96,0,19
84,51,28,23,93,0,20
83,48,28,20,89,0,16
84,59,40,19,86,0,19
85,62,41,21,93,1,16
82,79,54,25,104,1,28
76,47,26,21,125,4,28
70,36,16,20,145,8,36
65,32,12,20,162,11,35
61,36,9,27,174,16,34
57,35,6,29,185,21,27
55,30,3,27,190,27,15
56,31,2,29,183,26,14
72,28,1,27,162,11,14
75,20,1,19,150,11,12
76,24,1,23,144,10,19
77,28,2,26,141,5,17
79,32,3,29,139,2,21
81,41,9,32,136,0,22
82,32,4,28,133,0,22
82,30,4,26,130,0,23
82,30,3,27,128,1,26
83,33,7,26,125,0,31
83,25,4,21,126,1,27
83,25,5,20,123,0,24
83,30,9,21,121,0,24
82,50,25,25,119,0,20
81,87,56,31,117,0,18
81,91,58,33,120,0,19
80,107,75,32,124,1,22
74,64,38,26,135,5,21
67,25,7,18,143,14,16
62,14,3,11,143,25,13
60,10,2,8,140,30,9
59,12,2,10,140,28,10
59,13,2,11,137,28,10
59,16,3,13,135,26,10
63,16,2,14,132,23,11
71,20,2,18,123,17,11
77,17,0,17,115,17,7
77,17,0,17,111,16,9
79,9,0,9,104,26,10
77,8,0,8,105,27,7
77,8,0,8,107,25,8
81,8,0,8,105,25,9
81,10,0,10,107,20,8
82,15.57297753,2.659619907,12.91335763,107,19,12
82,12,0,12,108,16,10
82,16,0,16,110,10,12
83,30,6,24,111,0,11
85,35,10,25,109,0,16
85,41,16,25,109,0,18
85,66,39,27,111,0,14
84,15.59184477,2.669365354,12.92247941,116,25.06806859,12.65059921
79,40,19,21,127,4,19
61,43,21,22,156,7,24
59,43,19,24,175,10,28
59,32,11,21,173,15,34
58,29,8,21,183,18,14
58,27,6,21,184,20,17
57,27,4,23,183,20,18
64,65,16,49,170,4,13
68,117,57,60,160,0,4
71,151,85,66,155,0,26
71,130,67,63,150,0,28
74,94,40,54,146,0,26
75,75,28,47,149,0,22
78,42,7,35,145,2,16
67,24,1,23,140,7,16
78,24,2,22,135,7,10
80,36,7,29,131,1,16
82,30,4,26,127,2,14
81,37,9,28,129,0,13
71,27,4,23,126,2,17
64,12,0,12,120,13,10
70,9,0,9,110,17,4
55,8,0,8,108,20,0
55,6,0,6,109,22,1
54,8,1,7,109,22,3
50,7,1,6,110,22,5
47,9,1,8,107,23,4
44,8,1,7,110,23,3
44,8,1,7,108,26,2
47,9,1,8,106,25,1
49,12,1,11,105,22,3
50,13,0,13,104,20,4
50,16,1,15,104,17,6
52,14,0,14,104,19,10
56,14,0,14,103,20,7
42,10,0,10,96,24,4
36,8,0,8,93,26,2
35,8,0,8,88,26,0
34,6,0,6,83,28,1
39,5,0,5,80,29,1
38,4,0,4,74,30,2
63,3,0,3,62,31,0
73,3,0,3,44,27,3
79,4,0,4,27,29,0
81,9,0,9,25,25,0
82,11,1,10,16,26,0
84,21,3,18,15,19,1
84,32,6,26,10,10,4
86,37,9,28,9,6,4
86,29,6,23,8,11,3
87,37,11,26,10,8,4
87,36,10,26,10,8,4
86,31,7,24,11,11,5
86,27,5,22,10,11,7
87,28,6,22,14,11,5
86,24,3,21,17,12,5
84,28,2,26,22,7,6
83,48,13,35,24,1,8
82,54,18,36,21,0,11
81,46,12,34,21,0,10
82,45,11,34,21,0,9
82,38,6,32,16,0,9
83,40,8,32,15,0,8
84,38,9,29,13,0,9
85,39,11,28,11,0,10
84,42,15,27,9,0,14
84,50,24,26,7,0,15
84,48,23,25,6,0,19
85,84,56,28,5,0,22
84,108,77,31,8,0,19
81,104,73,31,13,0,16
76,66,40,26,25,2,14
65,58,33,25,41,5,18
60,47,25,22,61,7,19
52,45,22,23,79,9,17
52,47,20,27,73,11,14
47,38,13,25,98,15,17
50,38,11,27,96,14,19
51,48,12,36,90,8,16
55,46,8,38,80,3,7
57,48,9,39,69,0,0
59,50,10,40,64,1,0
61,71,30,41,59,0,7
60,59,18,41,57,0,8
58,71,30,41,54,0,11
66,98,55,43,49,0,13
70,90,52,38,42,0,15
74,63,31,32,35,0,13
77,64,35,29,34,0,13
77,63,36,27,30,0,13
77,52,27,25,28,0,13
77,50,26,24,27,0,9
77,46,23,23,24,0,8
77,59,35,24,25,0,8
76,51,29,22,31,1,10
67,50,28,22,51,3,15
59,28,12,16,81,8,19
51,30,12,18,105,11,18
49,21,7,14,123,16,20
47,12,3,9,124,24,16
46,11,2,9,128,28,7
48,9,1,8,121,30,7
50,11,1,10,115,29,0
52,13,1,12,108,26,0
53,16,1,15,105,22,2
55,19,0,19,103,18,4
57,26,1,25,101,12,5
59,24,1,23,96,14,5
60,25,1,24,94,11,4
60,23,1,22,94,11,7
62,24,1,23,91,7,9
63,27,2,25,87,3,9
68,18,1,17,83,7,10
72,13,0,13,80,10,6
72,12,0,12,79,8,7
74,14,0,14,79,6,10
72,13,0,13,79,6,10
71,15,1,14,81,5,11
70,16,2,14,81,5,13
68,14,2,12,85,9,9
66,15,4,11,96,11,11
62,15,4,11,109,14,14
60,13,2,11,113,19,20
59,9,1,8,123,23,15
60,9,1,8,124,26,12
68,9,0,9,124,25,10
73,12,1,11,121,21,3
77,11,0,11,114,15,10
81,15,1,14,110,13,13
84,18,1,17,110,9,12
85,22,1,21,110,6,15
86,24,2,22,109,5,14
87,17,1,16,106,9,10
87,15,1,14,104,9,7
87,13,1,12,103,9,9
88,11,1,10,103,11,6
88,10,1,9,100,12,5
88,7,0,7,99,16,6
86,8,0,8,96,14,8
87,14,0,14,95,8,8
87,21,2,19,93,3,5
87,32,9,23,91,1,9
85,38,15,23,96,2,10
66,32,10,22,109,7,9
45,20,5,15,128,20,10
40,15,3,12,134,25,2
36,11,2,9,136,28,3
32,11,2,9,139,30,0
30,8,2,6,137,33,3
29,9,2,7,136,32,2
28,8,1,7,124,33,6
32,9,1,8,114,32,3
33,14,1,13,107,27,0
34,14,1,13,104,27,3
39,12,0,12,99,27,4
39,10,0,10,96,29,4
40,10,0,10,96,29,7
41,13,0,13,94,24,8
42,11,0,11,94,26,8
42,9,0,9,94,27,6
42,15.99850768,2.877818021,13.12068966,94,29,6
43,9,0,9,93,28,5
41,10,0,10,90,25,4
31,12,0,12,90,25,4
45,15,0,15,85,22,7
45,17,1,16,85,22,5
42,18,2,16,84,22,6
41,15.99593012,2.875364976,13.12056515,92,24.71982797,6
32,17,4,13,117,24,8
29,11,2,9,129,28,13
26,10,2,8,135,30,13
30,7,1,6,134,32,11
28,8,1,7,136,32,6
28,10,2,8,134,32,6
27,8,1,7,121,32,6
29,12,1,11,112,29,0
31,14,1,13,106,26,0
34,11,1,10,103,28,0
36,12,0,12,99,26,0
39,11,1,10,94,26,0
39,11,1,10,91,25,0
38,9,0,9,87,27,0
37,6,0,6,84,30,0
38,6,0,6,80,30,3
40,7,0,7,73,28,0
48,12,1,11,60,22,4
51,11,0,11,49,20,4
53,18,0,18,49,14,5
52,27,2,25,45,8,7
57,32,5,27,39,5,8
57,58,26,32,41,2,12
51,55,25,30,55,5,21
40,51,24,27,88,8,27
36,23,7,16,98,18,26
34,20,6,14,107,22,19
39,21,6,15,111,25,13
44,18,4,14,113,26,10
44,20,5,15,111,27,9
47,23,4,19,106,23,7
50,26,5,21,103,21,11
52,20,2,18,100,22,10
51,18,1,17,100,21,11
57,22,1,21,96,17,11
53,22,1,21,93,15,18
49,25,1,24,89,10,22
50,26,1,25,88,9,27
46,24,1,23,85,11,23
53,27,1,26,87,8,18
53,34,2,32,84,2,19
54,25,1,24,79,7,21
64,22,1,21,75,8,18
72,24,1,23,69,5,17
79,27,3,24,65,4,17
84,26,3,23,62,5,15
85,27,4,23,64,4,14
86,33,9,24,66,4,11
87,42,16,26,74,4,17
86,35,13,22,86,8,13
77,26,8,18,106,15,14
76,23,7,16,121,18,17
70,25,6,19,130,18,17
67,42,10,32,131,11,21
76,65,21,44,127,4,16
76,77,23,54,124,0,18
82,83,31,52,134,0,21
79,95,48,47,128,0,21
82,86,40,46,120,0,22
82,100,53,47,115,0,19
82,100,55,45,112,0,22
81,107,62,45,109,0,24
81,100,55,45,107,0,24
83,108,65,43,103,0,23
73,78,39,39,104,0,19
44,30,6,24,113,11,10
39,6,0,6,112,31,1
38,6,0,6,108,32,0
38,8,0,8,104,30,0
42,11,0,11,94,28,2
36,16,1,15,100,23,4
32,17,3,14,113,25,9
27,14,3,11,132,27,13
25,13,3,10,145,28,11
24,13,3,10,151,28,11
24,13,3,10,150,30,9
26,13,3,10,158,31,10
26,14,2,12,156,32,11
25,19,3,16,142,29,19
32,31,2,29,131,16,0
34,67,18,49,126,0,4
34,77,27,50,121,0,9
37,81,32,49,112,0,8
39,43,5,38,105,2,10
42,36,3,33,97,5,6
45,31,1,30,88,5,7
45,32,2,30,85,5,9
47,21,0,21,80,13,7
48,15,1,14,80,19,6
46,10,0,10,82,23,5
48,11,0,11,77,21,7
50,14,0,14,70,16,8
53,23,1,22,65,9,8
53,25,1,24,66,7,10
52,27,5,22,69,8,11
47,26,7,19,90,11,16
40,22,6,16,120,15,24
32,20,5,15,143,20,24
30,14,3,11,161,24,25
31,13,2,11,156,27,22
31,14,2,12,160,29,18
31,12,1,11,158,32,0
35,13,1,12,151,30,3
41,23,0,23,138,19,8
40,34,2,32,133,11,6
47,39,2,37,126,7,14
52,60,16,44,129,1,16
54,43,5,38,130,3,19
55,67,23,44,121,1,15
54,94,47,47,118,0,21
53,94,47,47,112,0,22
57,66,27,39,104,0,17
56,42,10,32,97,0,25
57,27,2,25,91,2,16
57,19,1,18,88,7,13
58,19,1,18,86,7,13
60,20,1,19,82,5,12
61,19,1,18,78,4,11
58,26,7,19,84,5,14
53,21,5,16,96,9,20
48,21,6,15,116,12,20
45,29,9,20,130,11,26
43,22,5,17,146,19,27
44,22,3,19,150,24,31
50,28,4,24,161,27,32
52,28,3,25,161,31,26
57,24,1,23,155,30,17
61,30,1,29,151,21,13
50,37,1,36,141,12,18
52,29,1,28,133,17,29
52,23,0,23,129,19,40
59,26,1,25,125,17,41
62,31,1,30,120,10,42
61,23,0,23,117,17,38
69,21,0,21,112,15,35
75,25,1,24,105,8,37
79,20,0,20,100,12,31
81,15,0,15,98,14,28
83,17,0,17,98,9,34
80,19,1,18,101,8,36
79,29,6,23,102,2,30
80,47,21,26,97,0,31
80,66,38,28,97,0,33
73,59,30,29,108,3,36
61,35,12,23,134,10,37
54,31,11,20,150,14,28
51,37,12,25,161,13,26
47,32,10,22,168,16,16
39,19,4,15,179,25,11
40,20,4,16,178,26,8
45,24,3,21,166,22,2
53,57,15,42,159,5,0
55,100,47,53,152,0,13
57,113,60,53,147,0,15
60,156,98,58,140,0,19
60,120,65,55,138,0,14
65,156,103,53,132,1,21
66,162,107,55,130,0,24
72,104,59,45,122,0,20
75,76,38,38,116,0,24
76,16.520717,3.108917193,13.41179981,110,0,26
74,62,32,30,108,0,25
68,51,21,30,108,0,19
72,62,31,31,106,0,19
72,119,85,34,103,0,17
66,109,74,35,98,0,20
70,91,60,31,98,0,12
60,80,51,29,115,1,19
42,40,17,23,153,8,20
35,16.60121053,3.166740224,13.43447031,169,24.39663202,24
29,10,2,8,159,30,10
27,7,2,5,152,29,0
26,7,2,5,150,30,0
26,8,2,6,141,30,0
28,8,2,6,118,29,0
29,7,1,6,104,28,0
29,7,0,7,94,27,0
32,7,0,7,85,28,0
33,5,0,5,81,29,0
36,5,0,5,76,29,0
37,5,0,5,75,28,3
38,6,0,6,73,27,2
39,5,0,5,74,27,2
41,4,0,4,73,27,2
42,5,0,5,71,26,3
44,6,0,6,67,25,3
46,6,0,6,62,25,2
47,9,0,9,59,22,1
46,14,0,14,60,17,0
47,16,0,16,59,15,3
46,19,1,18,61,14,2
45,23,3,20,65,13,5
44,21,4,17,72,15,8
41,21,6,15,80,17,6
38,22,7,15,91,18,14
35,18,5,13,97,22,18
35,17,4,13,101,23,17
35,21,5,16,103,21,10
42,20,3,17,101,21,9
46,26,3,23,90,15,9
51,30,3,27,83,9,9
53,33,3,30,81,5,15
54,36,4,32,76,3,19
56,38,4,34,71,1,18
57,43,7,36,66,1,17
57,47,12,35,61,0,18
57,49,15,34,54,0,20
56,48,15,33,48,0,20
57,47,14,33,44,0,18
59,39,9,30,40,0,17
60,37,9,28,38,0,18
61,54,25,29,38,0,20
63,96,63,33,36,0,21
63,96,63,33,34,0,20
59,108,75,33,42,0,15
53,47,23,24,58,4,22
46,51,25,26,90,6,25
39,41,18,23,111,10,30
36,27,9,18,129,16,19
32,21,6,15,127,22,14
28,17,4,13,135,26,11
25,19,5,14,132,26,0
25,16,2,14,124,26,4
34,36,7,29,110,13,0
36,43,5,38,105,5,3
38,39,3,36,103,6,10
41,41,3,38,97,4,11
44,48,6,42,90,1,11
44,56,12,44,92,1,9
46,42,5,37,95,7,14
50,29,1,28,87,10,12
55,40,5,35,73,1,12
58,43,11,32,61,0,16
59,33,6,27,57,0,14
58,35,7,28,55,0,12
59,36,8,28,50,0,11
59,42,14,28,48,0,11
56,79,46,33,46,0,12
54,91,57,34,50,0,12
50,79,46,33,66,2,16
43,81,46,35,103,3,32
38,92,50,42,131,4,33
37,75,36,39,151,7,35
39,68,27,41,155,10,21
35,19,4,15,172,32,22
36,15,2,13,169,34,8
37,15,1,14,161,34,12
39,19,1,18,152,32,9
36,22,1,21,148,29,8
40,31,1,30,134,19,13
42,52,4,48,124,4,19
42,68,14,54,121,1,21
44,86,30,56,111,0,25
44,53,8,45,106,4,22
43,31,1,30,102,14,12
43,23,0,23,95,19,6
43,22,0,22,93,18,8
44,19,0,19,89,19,8
45,22,1,21,82,17,5
43,20,0,20,85,18,5
45,11,0,11,84,27,3
44,19,1,18,82,19,0
39,14,1,13,86,22,0
34,14,4,10,93,23,3
28,18,8,10,107,23,7
26,12,6,6,113,26,7
24,5,1,4,119,29,4
23,5,1,4,112,29,2
22,5,1,4,115,31,2
22,5,1,4,107,31,4
23,6,1,5,95,30,5
26,6,1,5,83,31,1
29,6,0,6,73,28,0
32,7,0,7,66,27,2
35,9,0,9,61,25,2
35,11,0,11,58,23,5
37,10,0,10,58,24,4
37,8,0,8,58,25,5
37,7,0,7,56,27,4
35,4,0,4,57,30,4
35,3,0,3,56,30,4
35,4,0,4,54,29,3
36,4,0,4,49,28,6
37,5,0,5,45,26,5
40,11,0,11,38,21,6
42,20,1,19,34,14,5
44,12,1,11,45,22,3
44,9,2,7,45,22,6
37,8,2,6,74,24,17
28,6,1,5,92,28,15
26,3,1,2,101,31,10
25,2,0,2,99,32,2
24,2,0,2,107,31,4
23,3,0,3,106,31,5
26,3,0,3,93,30,1
25,3,0,3,80,29,0
31,5,0,5,66,28,0
34,7,0,7,63,26,0
37,6,0,6,58,27,0
39,7,0,7,55,25,0
39,6,0,6,53,28,0
40,7,0,7,50,28,1
39,7,0,7,49,26,2
31,6,0,6,58,28,1
29,3,0,3,63,32,5
28,5,0,5,64,30,3
31,6,0,6,57,29,3
35,13,0,13,46,22,7
39,24,1,23,38,11,3
44,25,1,24,29,9,3
47,39,11,28,28,6,5
44,40,15,25,44,9,12
38,29,10,19,68,14,19
33,22,8,14,82,19,20
31,29,10,19,89,18,19
28,25,9,16,96,21,21
28,23,7,16,103,23,21
28,20,5,15,107,25,12
30,21,4,17,97,23,12
33,42,8,34,89,9,7
35,45,7,38,88,6,9
38,42,6,36,89,5,22
41,46,7,39,84,1,29
45,44,6,38,80,2,26
48,39,3,36,78,4,24
49,40,4,36,76,3,20
47,44,8,36,65,1,24
47,40,8,32,58,0,33
47,16.83782709,3.26530085,13.57252624,56,0,16
47,34,4,30,56,1,16
49,43,11,32,51,0,20
49,50,18,32,50,0,20
49,53,21,32,48,0,22
51,68,34,34,43,0,22
50,83,47,36,45,0,25
49,122,82,40,56,1,28
43,124,78,46,76,1,34
41,16.90969862,3.308992367,13.60070625,96,24.17803639,42
47,115,64,51,130,2,38
52,71,29,42,142,6,30
54,51,13,38,142,7,25
57,59,15,44,139,3,16
61,88,37,51,135,0,15
50,91,38,53,124,0,27
52,87,33,54,121,0,56
54,67,18,49,117,0,42
54,73,24,49,115,0,39
60,75,27,48,111,0,43
72,61,19,42,96,0,60
78,30,3,27,88,2,48
82,27,2,25,79,2,35
85,25,1,24,77,2,30
87,21,1,20,78,5,21
88,17,1,16,81,9,15
88,10,0,10,85,18,8
87,9,0,9,86,20,7
85,11,0,11,82,19,4
80,10,0,10,76,20,0
76,13,1,12,72,21,1
77,13,1,12,71,23,0
79,16,2,14,71,23,0
78,28,6,22,75,17,1
77,37,10,27,82,14,6
72,33,8,25,92,15,4
65,37,10,27,99,14,6
63,30,8,22,104,17,7
64,30,7,23,97,15,9
69,30,5,25,85,11,5
58,44,10,34,82,3,2
45,17,1,16,80,19,0
46,16,1,15,75,19,0
48,19,1,18,69,17,0
47,15,1,14,65,22,0
45,14,0,14,58,22,1
40,12,0,12,52,25,0
38,12,0,12,48,26,3
35,9,0,9,55,28,3
36,8,0,8,53,29,2
38,9,0,9,48,28,3
40,13,0,13,43,23,4
37,21,1,20,40,17,3
39,33,3,30,38,10,3
37,26,3,23,44,15,4
32,18,3,15,59,21,5
29,14,3,11,76,25,8
26,11,3,8,84,27,7
25,12,3,9,86,26,5
25,7,1,6,91,30,2
24,9,2,7,100,29,0
24,9,2,7,98,30,8
26,9,1,8,85,28,5
28,16,2,14,78,23,0
31,19,1,18,71,18,0
30,29,2,27,63,10,0
33,22,1,21,58,17,3
37,41,6,35,47,4,0
40,42,5,37,42,2,5
43,48,9,39,35,0,7
47,55,16,39,29,0,9
51,60,22,38,24,0,7
54,87,48,39,20,0,11
56,63,26,37,16,0,8
55,43,12,31,13,1,8
54,35,5,30,18,1,6
54,32,4,28,15,2,7
56,36,8,28,13,1,9
56,78,45,33,13,1,10
46,41,17,24,31,6,12
42,27,9,18,52,13,19
37,27,10,17,72,15,13
27,17,6,11,89,21,14
27,10,3,7,92,26,6
24,10,3,7,95,28,3
22,8,2,6,88,29,2
25,8,1,7,74,29,0
26,8,1,7,57,30,0
30,9,1,8,46,28,0
31,12,1,11,41,25,0
32,13,0,13,38,22,0
32,18,1,17,35,18,1
32,19,1,18,35,17,4
33,17,1,16,33,19,4
37,22,1,21,26,14,4
38,24,1,23,21,11,3
39,30,1,29,20,6,7
41,46,10,36,17,1,6
38,45,10,35,24,1,7
40,53,16,37,21,0,10
40,57,19,38,25,0,10
40,87,44,43,32,0,11
47,120,76,44,26,0,11
48,182,131,51,43,1,19
39,226,165,61,78,1,34
34,141,86,55,112,4,38
26,45,18,27,128,13,25
25,30,9,21,120,17,13
20,23,5,18,134,21,18
27,25,5,20,137,21,2
32,43,8,35,121,11,11
35,46,5,41,108,6,0
39,49,8,41,101,5,0
36,50,7,43,96,3,0
37,40,4,36,90,6,2
41,45,7,38,78,3,2
44,36,4,32,74,7,4
46,30,1,29,67,8,3
48,31,1,30,62,6,1
48,29,1,28,59,7,5
45,27,1,26,65,9,4
46,18,0,18,63,16,6
47,23,1,22,56,11,6
49,20,0,20,51,13,7
51,21,0,21,45,11,7
54,40,8,32,39,1,9
53,44,15,29,44,3,7
49,28,7,21,60,11,15
40,30,9,21,89,12,23
36,29,8,21,105,15,26
32,28,7,21,123,17,21
34,20,4,16,122,24,20
34,18,2,16,128,27,28
34,16,2,14,132,29,14
36,22,2,20,124,26,16
41,28,1,27,113,18,18
48,52,10,42,99,4,16
51,58,12,46,92,2,30
52,69,23,46,87,1,36
54,52,9,43,94,4,40
56,72,21,51,91,0,34
54,99,42,57,93,0,34
58,92,39,53,83,0,29
52,79,30,49,90,0,26
58,95,44,51,86,0,22
61,128,78,50,66,0,26
62,96,53,43,58,0,21
61,77,38,39,54,0,17
59,61,27,34,54,0,18
60,99,63,36,51,0,16
62,164,119,45,53,0,20
58,140,95,45,66,1,25
52,133,84,49,87,1,40
45,105,59,46,105,3,35
39,103,56,47,131,4,34
37,80,36,44,133,7,36
32,47,13,34,150,15,36
28,33,7,26,156,22,31
31,35,5,30,143,19,14
42,51,9,42,118,6,0
45,50,6,44,111,4,13
45,47,4,43,110,4,17
48,52,7,45,108,2,28
50,46,4,42,100,3,29
52,69,20,49,97,0,26
54,61,15,46,94,0,29
60,65,22,43,83,0,30
61,54,15,39,77,0,34
62,17.59578568,3.616798355,13.97898732,71,0,28
64,44,13,31,64,0,23
62,45,14,31,62,0,22
62,39,10,29,55,0,19
63,51,21,30,53,0,20
62,58,28,30,51,0,19
60,67,36,31,58,0,19
54,17.62718208,3.632668483,13.9945136,76,23.82022373,25
50,56,26,30,87,3,27
46,69,35,34,103,3,31
47,73,35,38,108,4,42
43,71,29,42,119,5,38
40,76,29,47,140,7,41
38,58,16,42,153,12,42
42,67,18,49,139,8,42
42,95,33,62,121,0,24
46,107,45,62,110,0,30
51,157,92,65,100,0,28
56,152,89,63,93,0,35
59,145,85,60,90,0,35
62,198,130,68,88,0,40
66,219,153,66,83,1,43
66,240,169,71,79,0,47
68,172,112,60,75,0,46
69,129,81,48,73,0,45
68,127,80,47,70,0,42
68,101,61,40,68,0,36
69,92,55,37,64,0,28
62.2742868,114,76,38,58,0,26
62.2742868,88,54,34,57,0,26
62.2742868,102,68,34,55,0,24
62.2742868,137,98,39,70,0,29
62.2742868,111,70,41,105,2,43
62.2742868,70,34,36,135,5,40
62.2742868,52,19,33,154,10,33
62.2742868,48,14,34,153,16,35
62.2742868,37,8,29,170,24,40
62.2742868,35,5,30,169,26,20
62.2742868,32,2,30,156,24,3
62.2742868,50,6,44,142,12,5
62.2742868,100,41,59,130,0,13
62.2742868,122,60,62,120,0,18
62.2742868,107,46,61,112,0,27
62.2742868,118,55,63,107,0,32
62.2742868,124,59,65,110,0,37
62.2742868,144,75,69,114,0,35
62.2742868,187,121,66,97,0,36
62.2742868,197,132,65,86,1,35
62.2742868,116,68,48,81,0,33
62.2742868,97,56,41,82,0,35
62.2742868,85,47,38,80,0,34
62.2742868,85,49,36,80,0,32
62.2742868,97,61,36,79,0,28
62.2742868,105,70,35,75,0,28
62.2742868,119,81,38,75,0,26
62.2742868,119,79,40,86,0,34
62.2742868,130,81,49,112,1,48
62.2742868,133,77,56,134,1,56
62.2742868,130,72,58,130,1,41
62.2742868,137,79,58,147,1,38
62.2742868,30,11,19,187,22,11
62.2742868,13,1,12,188,28,13
62.2742868,16,1,15,183,27,13
62.2742868,14,1,13,182,27,8
62.2742868,14,1,13,189,26,9
62.2742868,11,1,10,190,28,10
62.2742868,12,1,11,191,25,8
62.2742868,10,1,9,188,25,9
62.2742868,7,0,7,190,25,10
62.2742868,5,0,5,191,25,8
62.2742868,4,0,4,181,28,9
62.2742868,5,0,5,188,27,3
62.2742868,3,0,3,192,27,2
62.2742868,10,0,10,148,19,10
62.2742868,14,1,13,142,12,13
62.2742868,15,1,14,140,10,8
62.2742868,21,2,19,136,4,11
62.2742868,36,11,25,139,1,10
62.2742868,38,13,25,140,2,11
62.2742868,51,24,27,151,3,15
62.2742868,35,12,23,164,8,19
62.2742868,15,3,12,174,19,9
62.2742868,8,1,7,177,26,4
62.2742868,7,1,6,167,29,1
62.2742868,7,1,6,171,29,0
62.2742868,7,0,7,156,30,2
62.2742868,7,0,7,145,29,0
62.2742868,7,0,7,135,29,0
62.2742868,7,0,7,126,29,0
62.2742868,6,0,6,115,30,0
62.2742868,6,0,6,104,30,0
62.2742868,7,0,7,100,29,0
62.2742868,7,0,7,95,28,1
62.2742868,6,0,6,92,30,1
62.2742868,6,0,6,88,30,0
62.2742868,7,0,7,84,28,0
62.2742868,7,0,7,82,27,0
62.2742868,9,0,9,76,24,1
62.2742868,8,0,8,73,25,0
62.2742868,10,0,10,68,24,0
62.2742868,18,1,17,64,17,0
62.2742868,26,2,24,62,12,1
62.2742868,23,2,21,71,15,1
62.2742868,17,3,14,84,20,4
62.2742868,10,2,8,100,26,6
62.2742868,8,2,6,111,27,7
62.2742868,6,1,5,112,28,4
62.2742868,7,2,5,112,28,2
62.2742868,5,1,4,114,30,2
62.2742868,5,1,4,114,31,0
62.2742868,6,1,5,104,31,3
62.2742868,9,1,8,94,28,0
62.2742868,15,1,14,88,23,0
62.2742868,24,1,23,78,14,0
62.2742868,27,1,26,68,10,2
62.2742868,25,1,24,62,11,4
62.2742868,23,1,22,60,12,5
62.2742868,27,1,26,59,8,8
62.2742868,24,1,23,58,9,9
62.2742868,20,0,20,54,12,6
62.2742868,22,1,21,51,10,6
62.2742868,23,0,23,50,8,8
62.2742868,16,0,16,49,13,7
62.2742868,18,0,18,48,12,12
62.2742868,13,0,13,46,15,12
62.2742868,15,0,15,44,11,4
62.2742868,17,1,16,44,11,5
62.2742868,20,3,17,50,10,11
62.2742868,18,4,14,57,13,22
62.2742868,16,4,12,70,16,15
62.2742868,19,5,14,76,17,18
62.2742868,15,4,11,83,20,15
62.2742868,13,3,10,103,24,19
62.2742868,13,2,11,116,26,23
62.2742868,11,1,10,102,28,17
62.2742868,19,1,18,92,20,7
62.2742868,39,5,34,81,7,0
62.2742868,28,1,27,71,10,5
62.2742868,27,1,26,68,10,11
62.2742868,40,5,35,66,4,14
62.2742868,39,4,35,59,3,19
62.2742868,44,8,36,59,2,23
62.2742868,36,4,32,54,6,18
62.2742868,64,27,37,44,0,18
62.2742868,81,44,37,36,0,22
62.2742868,76,42,34,27,0,26
62.2742868,54,26,28,24,0,34
62.2742868,66,38,28,26,0,31
62.2742868,61,34,27,31,0,22
62.2742868,65,35,30,36,0,15
62.2742868,58,28,30,36,0,13
62.2742868,49,22,27,46,2,8
62.2742868,54,26,28,63,3,12
62.2742868,36,14,22,70,9,17
62.2742868,43,18,25,82,7,17
62.2742868,43,16,27,88,8,19
62.2742868,53,19,34,89,6,18
62.2742868,47,15,32,90,5,20
62.2742868,52,15,37,86,2,19
62.2742868,66,24,42,84,0,24
62.2742868,65,23,42,83,0,23
62.2742868,76,33,43,80,0,21
62.2742868,94,50,44,75,0,21
62.2742868,109,63,46,75,0,23
62.2742868,103,58,45,76,0,24
62.2742868,109,64,45,77,0,24
62.2742868,92,49,43,77,0,24
62.2742868,78,38,40,74,0,24
62.2742868,18.54673938,4.195355267,14.35138412,70,0,23
62.2742868,81,43,38,69,0,27
62.2742868,66,31,35,101,2,25
62.2742868,20,4,16,142,20,10
62.2742868,17,1,16,148,21,14
62.2742868,18,1,17,151,19,14
62.2742868,21,2,19,161,17,9
62.2742868,18.5639588,4.204114186,14.35984461,173,23.49994362,12.754506
51,71,40,31,124,9,13
72,97,59,38,84,0,34
80,58,27,31,81,1,8
79,53,23,30,88,3,11
79,63,30,33,91,1,21
78,60,27,33,96,2,21
76,61,26,35,101,1,23
76,56,21,35,105,0,19
72,45,14,31,104,2,22
69,15,2,13,93,18,12
70,10,1,9,85,23,0
73,7,1,6,69,28,0
79,7,1,6,60,29,0
80,8,1,7,57,28,0
77,5,0,5,56,29,0
72,5,0,5,57,29,0
57,6,0,6,60,28,1
36,4,0,4,66,34,5
36,4,0,4,59,33,0
39,7,0,7,53,30,1
40,10,0,10,50,28,3
43,14,1,13,46,24,3
36,16,2,14,50,22,4
35,16,3,13,59,23,2
33,12,3,9,73,26,6
31,10,3,7,81,28,6
27,8,2,6,86,29,6
26,8,2,6,81,31,6
22,7,2,5,88,32,1
23,8,2,6,89,33,2
23,7,1,6,79,32,3
29,13,1,12,69,27,4
25,20,1,19,62,20,0
33,22,0,22,54,17,0
35,23,1,22,48,16,2
40,28,1,27,40,10,5
43,37,4,33,34,7,4
45,29,5,24,29,13,4
47,58,17,41,25,0,8
49,67,24,43,23,0,7
49,44,7,37,23,3,7
52,32,2,30,20,6,6
53,31,2,29,13,4,8
53,32,4,28,8,2,8
58,44,13,31,4,0,8
59,54,23,31,4,0,7
58,57,27,30,7,1,9
53,46,19,27,14,4,13
50,39,14,25,25,6,13
47,33,12,21,35,11,21
43,31,10,21,47,12,20
42,31,10,21,58,14,19
43,34,11,23,69,14,22
42,32,8,24,75,16,22
43,23,3,20,72,19,17
46,33,3,30,68,10,16
47,47,7,40,59,2,13
50,38,3,35,52,5,14
50,52,10,42,49,1,17
52,72,27,45,46,0,21
49,66,25,41,55,2,24
49,28,1,27,45,8,16
53,23,1,22,38,10,23
48,16,0,16,41,16,23
41,10,1,9,50,23,8
41,6,0,6,48,28,2
38,5,0,5,48,28,0
41,4,0,4,42,30,0
38,6,0,6,43,29,0
43,9,0,9,36,26,2
42,13,1,12,41,23,1
38,11,2,9,53,25,6
28,7,1,6,72,28,9
26,6,1,5,85,30,9
24,5,1,4,92,31,6
25,5,1,4,87,32,7
23,4,1,3,93,33,5
25,5,1,4,89,34,5
26,4,0,4,80,33,2
27,6,0,6,70,31,4
29,8,0,8,63,29,0
31,11,0,11,57,26,0
32,13,0,13,50,23,0
36,15,0,15,43,22,1
39,17,1,16,38,20,4
31,15,0,15,34,21,2
45,17,0,17,29,18,5
46,16,0,16,26,17,4
48,16,0,16,22,16,5
49,15,0,15,22,15,6
47,11,0,11,22,18,7
46,10,0,10,23,18,8
46,13,0,13,24,15,9
50,15,1,14,18,14,6
51,30,6,24,15,6,8
45,28,8,20,30,10,10
37,15,4,11,60,20,19
30,14,4,10,88,23,19
26,13,3,10,110,26,21
25,14,3,11,106,27,25
24,18,4,14,114,25,13
24,22,4,18,119,27,11
30,21,2,19,108,28,9
31,22,1,21,99,25,0
39,29,1,28,89,15,0
43,38,2,36,85,7,3
47,51,9,42,76,4,7
51,65,18,47,66,0,12
54,64,17,47,59,0,11
58,78,31,47,53,0,14
55,86,41,45,47,0,21
60,88,45,43,42,0,32
60,67,30,37,30,1,27
61,31,5,26,26,2,46
60,21,2,19,27,6,41
62,17,1,16,25,7,37
63,14,1,13,25,9,27
66,16,1,15,20,7,33
65,18,3,15,23,7,19
57,16,4,12,47,11,19
51,14,4,10,69,15,23
40,12,3,9,102,19,27
34,9,2,7,125,25,21
32,7,1,6,125,30,15
28,5,1,4,139,35,13
24,4,0,4,147,37,16
34,10,1,9,126,33,20
39,17,1,16,112,27,0
42,26,1,25,102,18,0
45,33,1,32,96,13,0
49,45,4,41,84,4,6
42,49,6,43,83,4,10
42,24,0,24,80,17,6
44,24,0,24,72,15,4
46,19,0,19,65,18,5
51,29,1,28,56,8,6
54,39,5,34,50,3,7
55,39,6,33,46,2,10
57,38,6,32,42,2,9
59,27,2,25,38,6,7
58,16,0,16,37,11,5
58,11,0,11,38,15,8
58,17,2,15,42,11,7
56,21,3,18,48,9,9
51,22,6,16,67,11,13
42,18,5,13,94,18,19
37,16,4,12,111,21,22
36,13,3,10,116,26,20
36,11,2,9,128,30,19
35,10,1,9,134,33,12
38,9,1,8,119,33,19
41,10,0,10,108,31,7
46,37,4,33,95,10,0
50,53,12,41,85,3,0
54,70,25,45,79,0,11
57,70,23,47,73,1,18
61,86,39,47,66,0,23
61,99,52,47,62,0,20
61,70,30,40,57,0,15
58,43,7,36,57,1,14
58,18.77282729,4.270792142,14.50203515,54,3,19
61,37,4,33,52,1,17
61,40,8,32,50,0,16
63,36,6,30,43,0,14
61,34,6,28,37,1,15
63,30,5,25,35,3,12
64,23,4,19,36,7,11
60,20,5,15,50,11,18
49,15,3,12,84,20,27
40,8,1,7,109,31,27
20,6,1,5,123,38,17
21,4,0,4,122,41,3
29,4,0,4,129,41,4
31,4,0,4,130,42,10
28,4,0,4,118,42,13
29,4,0,4,107,42,9
31,5,0,5,98,40,7
33,7,0,7,88,38,6
35,8,0,8,80,36,6
35,9,0,9,76,35,5
37,8,0,8,74,36,11
40,9,0,9,67,35,12
41,14,0,14,59,28,13
35,21,0,21,59,20,17
37,28,1,27,51,14,18
47,28,1,27,50,12,20
46,24,0,24,52,16,20
47,24,0,24,48,14,22
38,32,3,29,45,9,20
51,30,2,28,38,9,17
57,43,11,32,33,4,19
50,18.77220082,4.260743674,14.51145715,46,23.30780451,22
43,42,13,29,82,12,37
37,48,16,32,115,15,37
39,22,5,17,122,29,26
39,27,6,21,122,28,24
37,28,5,23,133,31,25
36,26,4,22,142,32,31
31,16,2,14,132,35,25
29,10,1,9,115,37,0
28,8,1,7,104,37,0
32,5,0,5,92,40,0
31,5,0,5,81,39,0
30,4,0,4,74,38,4
31,5,0,5,71,36,7
31,4,0,4,68,38,8
34,4,0,4,66,38,9
33,3,0,3,63,38,9
32,5,0,5,60,35,9
30,4,0,4,61,36,10
30,4,0,4,60,36,6
32,6,0,6,53,33,8
33,16,1,15,50,24,10
32,22,1,21,51,20,6
38,29,5,24,45,16,7
31,22,4,18,66,21,13
31,10,2,8,85,30,16
29,7,2,5,93,35,8
26,6,1,5,94,35,3
25,5,1,4,93,36,2
24,5,1,4,94,37,2
24,6,1,5,94,36,2
26,7,1,6,82,35,4
29,6,0,6,72,35,1
31,6,0,6,65,34,0
30,6,1,5,58,35,0
32,6,1,5,54,35,0
31,5,0,5,49,35,1
36,5,0,5,41,34,3
36,8,1,7,41,31,5
40,7,0,7,32,30,3
39,8,0,8,30,28,3
40,10,0,10,25,27,2
41,9,0,9,21,27,5
43,7,0,7,22,29,2
45,9,0,9,16,26,1
44,12,0,12,18,25,3
46,20,1,19,12,19,4
44,28,3,25,18,14,3
38,23,4,19,38,20,8
35,14,3,11,55,26,10
27,13,4,9,67,28,14
24,16,5,11,82,27,8
25,15,4,11,72,28,12
24,13,4,9,82,30,8
22,16,5,11,92,30,10
26,17,4,13,76,28,5
29,22,4,18,67,24,0
32,26,2,24,59,16,0
35,34,1,33,54,9,7
36,41,4,37,50,7,10
41,63,21,42,45,4,10
45,124,74,50,34,0,12
48,167,112,55,31,0,17
50,91,45,46,22,0,19
51,63,21,42,19,0,13
56,100,56,44,13,0,13
57,115,72,43,4,0,19
59,75,40,35,0,0,17
60,75,41,34,0,0,18
60,77,42,35,0,0,18
61,75,42,33,0,0,16
60,92,57,35,0,0,15
54,82,50,32,9,2,17
47,58,29,29,36,6,24
37,53,27,26,62,9,25
33,24,7,17,79,19,23
35,17,4,13,78,25,19
35,18,4,14,86,27,15
32,18,3,15,97,27,14
35,21,2,19,84,25,15
38,28,1,27,74,18,11
40,41,2,39,67,8,6
43,48,4,44,58,4,13
45,56,7,49,53,1,24
46,61,12,49,46,0,26
46,68,19,49,43,0,27
47,68,20,48,36,0,28
50,63,18,45,32,0,29
52,93,45,48,27,0,32
55,87,43,44,21,0,35
58,65,28,37,14,0,29
61,63,28,35,8,0,29
62,52,21,31,4,0,29
62,46,17,29,3,0,29
62,41,13,28,5,0,24
60,42,16,26,7,1,20
59,24,6,18,16,7,21
54,21,5,16,31,10,21
49,22,5,17,47,13,25
48,20,3,17,54,16,31
51,19,2,17,55,17,36
48,20,2,18,57,16,39
61,20,1,19,55,15,40
70,26,2,24,50,10,40
78,26,1,25,47,8,42
81,20,1,19,43,13,38
84,13,0,13,42,18,29
86,11,0,11,47,20,19
87,10,0,10,50,21,18
87,6,0,6,46,29,13
86,4,0,4,41,30,11
86,4,0,4,40,28,7
84,4,0,4,42,29,4
84,3,0,3,46,30,3
83,3,0,3,49,31,1
81,4,0,4,54,32,3
81,3,0,3,60,34,4
81,2,0,2,60,34,3
81,6,0,6,60,28,0
77,5,0,5,66,29,0
78,6,1,5,68,28,1
77,7,1,6,75,28,3
78,11,2,9,79,25,3
73,14,3,11,86,23,5
70,8,1,7,90,28,4
64,8,1,7,100,27,5
59,9,2,7,112,28,10
60,14,2,12,104,25,13
62,16,1,15,96,21,5
67,34,5,29,88,7,1
68,31,2,29,84,9,0
54,34,2,32,87,9,1
52,15,0,15,80,23,1
52,14,1,13,77,26,0
55,17,1,16,72,21,0
62,19,0,19,61,16,1
60,22,1,21,63,14,3
55,18.94309428,4.354852353,14.58824192,69,20,0
49,9,0,9,75,28,0
47,7,0,7,70,30,0
44,10,0,10,67,29,1
43,13,0,13,67,28,1
42,15,1,14,67,28,5
39,17,1,16,71,25,3
38,18.93684302,4.351316433,14.58552659,80,23.25387484,5
34,14,3,11,96,27,10
31,15,4,11,107,29,9
29,12,3,9,120,30,8
29,15,4,11,117,29,12
30,15,3,12,125,31,12
31,18,4,14,136,30,15
41,31,5,26,116,21,22
44,34,3,31,106,15,0
45,44,3,41,101,7,0
49,54,9,45,92,3,1
54,90,39,51,84,0,5
60,105,54,51,78,0,11
60,133,79,54,72,0,18
45,80,31,49,79,1,12
44,38,2,36,75,8,5
38,12,0,12,73,27,5
35,8,0,8,71,30,2
38,5,0,5,63,33,2
37,7,0,7,57,31,0
38,8,0,8,54,30,0
42,10,0,10,48,28,2
41,13,0,13,45,23,0
42,18,2,16,43,20,0
37,22,4,18,55,17,4
34,16,4,12,74,22,12
28,14,4,10,90,25,11
24,15,4,11,102,26,10
24,14,4,10,97,28,9
23,18,5,13,105,28,9
23,19,4,15,115,28,13
34,24,3,21,99,24,6
40,27,2,25,89,20,0
44,43,5,38,82,8,0
48,71,22,49,75,0,1
28,38,8,30,75,13,4
35,15,0,15,62,24,0
40,32,2,30,53,9,1
42,36,2,34,46,4,8
42,32,2,30,43,8,6
45,38,3,35,36,3,8
42,50,15,35,34,3,8
46,36,4,32,32,6,6
42,34,3,31,34,7,5
43,34,3,31,32,7,4
46,55,17,38,30,2,7
48,126,79,47,25,0,8
47,120,73,47,28,1,10
39,90,49,41,38,3,11
31,61,25,36,74,8,20
30,55,22,33,97,12,19
26,65,29,36,111,10,19
25,34,11,23,110,19,15
23,24,6,18,122,23,9
18,21,4,17,125,25,10
21,22,6,16,106,25,6
15,25,4,21,91,23,0
27,36,4,32,84,13,0
29,37,3,34,74,11,0
31,49,6,43,67,3,0
35,50,8,42,59,4,5
37,71,22,49,54,0,5
36,69,22,47,53,0,6
37,68,20,48,52,1,10
46,71,24,47,45,0,10
50,93,45,48,40,0,11
47,95,48,47,43,0,16
51,82,39,43,34,0,10
54,119,74,45,27,0,10
52,158,108,50,31,0,13
56,131,84,47,24,0,11
52,160,110,50,28,0,13
47,97,54,43,42,1,16
42,130,81,49,68,2,29
33,53,22,31,95,13,28
28,33,10,23,112,20,18
30,39,12,27,107,19,16
30,46,13,33,108,15,16
28,40,7,33,108,18,3
33,35,7,28,99,20,0
32,29,4,25,91,22,5
35,16,1,15,80,27,0
49,23,1,22,67,17,0
56,26,1,25,54,11,6
60,34,3,31,46,5,11
67,33,3,30,42,5,9
68,41,9,32,38,3,10
69,33,4,29,32,5,9
69,39,7,32,28,1,10
69,43,10,33,26,1,10
64,53,17,36,22,0,9
67,35,6,29,10,1,8
74,51,22,29,4,0,8
69,72,41,31,0,0,15
66,63,30,33,0,0,14
60,59,25,34,5,2,7
55,73,38,35,25,3,8
43,38,13,25,51,13,24
38,30,8,22,61,16,15
33,17,4,13,65,24,4
49,9,1,8,39,29,5
36,8,1,7,47,28,0
32,8,1,7,42,28,0
29,8,1,7,38,29,0
37,12,1,11,31,25,2
39,11,1,10,19,24,3
36,10,1,9,10,24,3
39,11,0,11,4,21,5
39,12,0,12,0,20,3
38,11,1,10,0,22,6
38,10,0,10,0,21,4
37,9,0,9,0,21,5
43,10,0,10,0,20,5
42,8,0,8,0,22,3
42,6,0,6,0,24,3
36,5,0,5,0,25,2
31,7,0,7,0,24,5
29,6,0,6,0,25,3
33,9,0,9,0,23,1
39,11,1,10,0,22,9
40,6,1,5,6,28,4
34,5,1,4,18,29,8
31,5,1,4,32,30,9
29,4,1,3,43,30,3
28,4,1,3,40,31,5
29,4,1,3,43,32,0
27,4,1,3,47,32,3
29,4,1,3,37,32,0
36,6,1,5,27,30,3
41,6,0,6,17,28,0
44,10,0,10,11,24,0
48,15,1,14,6,20,0
50,19,1,18,2,17,3
52,23,1,22,0,13,2
53,20,0,20,0,15,3
55,31,1,30,0,6,6
56,34,1,33,0,3,9
57,40,5,35,0,1,11
57,47,10,37,0,0,10
55,50,13,37,0,0,12
57,75,36,39,0,0,12
56,112,72,40,0,0,13
48,90,52,38,0,0,8
50,104,65,39,0,0,9
45,93,54,39,8,2,11
36,43,18,25,39,11,19
26,18,6,12,58,22,10
24,12,4,8,67,27,5
20,10,3,7,67,28,4
17,9,3,6,76,31,5
21,10,3,7,75,30,3
25,14,3,11,69,28,2
29,16,3,13,59,26,4
36,15,1,14,50,25,0
41,15,1,14,44,24,0
43,15,1,14,43,24,0
48,11,0,11,42,26,0
51,8,0,8,37,29,0
49,14,1,13,35,25,0
50,21,1,20,29,17,2
54,18,0,18,29,18,1
60,19.35002915,4.55572436,14.79430479,27,23,0
57,8,0,8,31,28,0
58,10,0,10,27,25,0
58,20,0,20,22,15,1
56,31,2,29,27,9,2
59,23,1,22,25,14,1
57,21,2,19,30,16,0
52,19.34958576,4.552530089,14.79705567,44,23.07189585,2
43,24,7,17,66,18,11
35,19,6,13,84,22,13
32,11,3,8,95,27,8
35,12,3,9,89,28,8
28,17,7,10,102,28,12
25,9,2,7,104,30,0
29,9,2,7,95,31,0
34,12,1,11,84,27,0
35,18,1,17,74,21,0
40,26,2,24,66,15,0
43,27,2,25,56,14,3
46,34,3,31,46,8,7
50,60,20,40,38,1,9
50,62,21,41,38,0,8
52,50,12,38,33,0,9
56,74,32,42,28,0,10
54,61,22,39,30,1,13
56,31,1,30,22,5,3
58,36,4,32,16,2,4
60,38,6,32,12,1,5
61,42,10,32,7,0,3
63,50,17,33,3,0,7
61,56,23,33,10,2,7
60,58,28,30,22,3,11
49,51,22,29,53,8,21
40,33,12,21,82,16,17
33,31,11,20,97,19,20
30,21,6,15,94,25,15
29,20,5,15,107,26,12
29,17,4,13,106,29,11
35,18,2,16,99,28,7
38,24,2,22,93,22,1
41,37,2,35,85,10,1
46,52,9,43,76,3,4
52,80,30,50,70,0,6
55,73,24,49,73,0,10
55,71,22,49,70,0,14
57,93,43,50,59,0,13
50,94,45,49,49,0,15
49,76,32,44,42,0,14
51,43,7,36,35,1,15
51,36,4,32,33,2,12
50,28,1,27,31,6,8
52,37,5,32,28,2,9
50,45,11,34,30,0,8
52,42,10,32,27,1,10
52,60,25,35,28,1,10
51,72,36,36,36,1,14
47,60,27,33,58,5,17
40,41,14,27,81,12,20
26,16,4,12,103,28,18
26,11,2,9,103,33,9
21,11,2,9,109,34,6
24,12,2,10,109,34,13
26,12,2,10,101,34,11
28,15,1,14,89,31,13
27,32,3,29,80,18,5
29,26,1,25,67,19,9
38,27,1,26,56,16,12
40,26,2,24,43,15,14
41,26,1,25,35,13,14
43,25,2,23,30,16,13
45,32,2,30,24,9,19
47,26,1,25,20,13,18
47,27,1,26,18,12,17
46,23,0,23,23,14,20
47,18,0,18,23,17,22
49,21,0,21,21,13,22
53,25,1,24,13,9,23
52,40,7,33,15,1,22
50,45,9,36,19,3,23
51,37,6,31,20,5,27
52,44,12,32,23,5,24
52,53,19,34,29,4,31
55,47,17,30,33,8,38
58,41,12,29,33,10,40
58,37,8,29,34,11,36
64,46,12,34,32,6,36
67,44,9,35,31,6,42
70,43,6,37,26,5,36
74,39,4,35,21,5,36
76,39,4,35,20,3,34
71,37,3,34,20,4,30
69,32,2,30,23,7,27
72,22,1,21,25,16,24
74,19,1,18,28,17,22
73,14,0,14,33,21,20
74,8,0,8,34,24,13
72,8,0,8,33,24,6
68,7,0,7,33,26,3
65,7,0,7,34,28,2
65,7,0,7,27,29,2
64,11,0,11,27,26,3
64,15,0,15,24,22,4
64,23,2,21,28,16,6
57,17,3,14,52,21,10
52,10,2,8,73,28,13
45,10,2,8,89,30,7
35,9,2,7,99,32,9
31,6,1,5,98,33,2
24,8,2,6,103,34,2
22,7,1,6,99,37,4
24,7,1,6,87,37,6
27,9,0,9,79,35,9
27,13,1,12,69,33,7
27,13,0,13,60,35,12
30,13,0,13,53,36,21
33,19,0,19,44,28,24
37,33,2,31,39,16,27
47,36,3,33,37,10,24
59,34,2,32,37,8,18
44,37,2,35,37,5,18
44,52,7,45,36,1,24
44,34,1,33,34,8,26
48,20,0,20,30,16,20
50,21,0,21,27,13,20
57,26,1,25,16,7,21
59,23,1,22,9,6,22
54,24,4,20,7,11,21
49,16,3,13,22,21,17
41,14,3,11,49,25,21
35,16,4,12,82,27,29
29,18,4,14,101,29,35
28,14,2,12,112,33,24
27,18,3,15,123,34,24
25,17,2,15,129,37,14
28,12,1,11,107,38,16
28,10,0,10,97,38,5
33,22,1,21,83,28,6
37,44,4,40,74,11,17
39,46,4,42,69,9,21
40,63,12,51,62,2,25
34,43,6,37,64,11,24
36,12,0,12,63,29,7
38,8,0,8,59,33,4
36,7,0,7,55,35,4
35,5,0,5,50,36,4
34,5,0,5,45,37,0
35,6,0,6,40,37,1
37,7,0,7,34,35,1
34,13,0,13,31,28,7
34,14,0,14,27,27,5
34,15,1,14,28,26,3
29,15,2,13,41,26,5
25,12,3,9,51,30,8
21,11,3,8,62,31,7
19,10,2,8,71,32,10
21,8,2,6,64,34,9
16,8,1,7,69,33,4
19,9,1,8,60,34,4
17,9,1,8,54,34,0
18,10,1,9,46,35,1
21,10,1,9,37,34,3
22,16,1,15,30,28,4
25,13,0,13,25,31,1
26,12,1,11,21,32,4
29,12,0,12,15,31,5
29,13,0,13,11,29,4
28,16,0,16,11,26,5
30,9,0,9,9,32,5
30,19.52993894,4.578616372,14.95132257,7,28,6
31,11,0,11,3,29,3
33,24,0,24,0,17,6
31,42,4,38,0,5,5
30,30,2,28,0,14,4
29,49,8,41,3,4,7
30,57,16,41,3,5,7
23,19.54332167,4.578969487,14.96435218,25,22.95709046,12
21,21,6,15,40,24,12
22,11,3,8,53,31,4
20,11,3,8,59,31,2
15,10,3,7,63,32,7
12,8,2,6,69,34,5
13,7,2,5,69,35,4
20,7,1,6,60,35,1
27,9,1,8,44,32,1
30,13,1,12,33,28,0
32,11,1,10,27,29,0
34,12,1,11,19,27,0
35,12,1,11,16,27,1
36,13,1,12,14,27,3
38,12,1,11,10,29,3
41,12,1,11,4,27,3
41,20,1,19,1,19,3
39,19,1,18,0,20,7
39,19,1,18,0,19,7
36,23,1,22,0,16,8
35,28,1,27,0,13,8
33,34,2,32,3,8,5
32,39,5,34,2,9,7
33,86,40,46,4,2,8
27,54,19,35,26,9,11
23,25,7,18,53,24,15
21,16,4,12,72,31,12
18,10,2,8,81,34,6
18,9,2,7,83,35,4
17,9,2,7,88,37,5
19,9,2,7,86,37,6
19,11,3,8,76,36,2
24,10,2,8,66,36,3
26,13,1,12,55,32,0
30,14,1,13,47,30,0
33,20,1,19,39,24,0
36,20,1,19,32,23,1
40,20,1,19,26,23,3
41,18,0,18,21,23,5
39,17,1,16,22,25,5
41,14,0,14,17,26,4
40,18,0,18,13,22,7
38,23,0,23,14,18,8
42,26,1,25,6,14,7
42,35,2,33,4,8,9
44,27,1,26,0,12,6
45,42,6,36,0,4,4
42,37,6,31,0,10,11
37,42,12,30,19,11,10
32,33,10,23,41,19,21
27,32,10,22,73,20,19
24,31,9,22,91,22,22
24,29,8,21,93,24,16
21,26,6,20,105,26,15
18,21,4,17,118,30,11
18,18,3,15,99,32,13
20,25,2,23,87,25,0
24,42,3,39,76,11,0
29,62,13,49,72,3,0
36,93,35,58,61,0,2
41,131,68,63,60,1,13
36,91,34,57,58,0,18
37,68,15,53,60,0,14
41,72,20,52,53,0,20
49,103,48,55,52,0,22
50,119,64,55,39,0,22
52,154,95,59,29,0,22
50,83,39,44,20,0,20
50,70,29,41,17,0,14
50,69,29,40,16,0,16
51,103,60,43,13,0,18
51,88,46,42,14,0,14
50,74,36,38,21,1,15
46,93,53,40,32,1,21
43,88,48,40,42,2,22
35,81,41,40,74,5,26
37,80,36,44,118,8,36
33,19,4,15,155,31,31
33,17,3,14,157,34,22
36,18,3,15,152,34,11
38,22,2,20,143,29,9
32,23,1,22,136,27,3
31,18,1,17,135,31,4
36,28,1,27,116,19,5
37,37,2,35,103,13,14
39,28,1,27,96,19,8
41,30,1,29,90,16,8
43,32,1,31,84,15,3
43,40,2,38,77,8,6
44,32,1,31,68,14,4
44,25,1,24,64,18,6
44,26,1,25,57,16,19
45,23,0,23,52,17,11
48,41,4,37,45,4,5
48,47,7,40,40,2,5
47,41,9,32,47,7,6
43,35,9,26,60,12,8
35,26,7,19,81,18,17
30,20,5,15,103,23,17
25,17,4,13,122,26,14
26,14,3,11,125,29,16
25,12,2,10,134,34,15
24,16,2,14,143,34,18
26,17,2,15,129,35,0
29,24,1,23,118,29,5
32,44,3,41,108,12,4
39,28,1,27,101,22,5
42,25,1,24,93,20,8
45,27,1,26,86,18,9
49,37,2,35,74,9,9
51,36,2,34,62,8,15
54,38,2,36,54,3,13
53,28,1,27,44,7,17
53,16,1,15,39,14,16
52,14,1,13,42,15,6
51,13,0,13,42,16,8
50,14,1,13,41,16,9
50,9,0,9,41,19,7
51,11,0,11,40,18,6
51,15,1,14,43,15,7
49,13,2,11,59,17,7
50,17,3,14,72,17,17
48,17,3,14,79,19,14
46,15,3,12,94,24,18
44,14,2,12,116,31,48
44,12,2,10,134,33,44
46,9,1,8,127,35,31
42,9,1,8,124,38,12
57,11,1,10,116,35,9
61,11,1,10,108,29,7
65,14,1,13,104,24,5
67,14,1,13,99,24,5
69,19,1,18,94,19,9
71,26,1,25,89,12,8
71,29,1,28,86,8,10
71,29,1,28,85,6,11
71,29,1,28,86,6,13
71,33,3,30,88,4,16
71,37,3,34,88,2,14
70,50,14,36,86,0,14
61,64,24,40,81,0,24
62,51,12,39,78,0,30
62,42,8,34,75,3,23
62,48,14,34,76,3,19
63,71,34,37,88,3,24
65,80,39,41,147,6,35
47,56,22,34,146,11,33
49,38,13,25,147,16,30
39,29,8,21,174,23,14
35,17,3,14,177,32,20
33,15,3,12,177,33,13
29,13,2,11,170,34,0
27,11,1,10,147,35,2
27,10,1,9,129,35,0
28,10,0,10,116,33,0
30,8,0,8,106,34,0
34,8,1,7,99,36,0
27,6,0,6,92,37,0
28,4,0,4,82,39,5
37,4,0,4,71,38,1
36,4,0,4,67,37,0
39,19.80395117,4.663160838,15.14079033,58,35,0
37,5,0,5,53,35,0
36,7,0,7,50,33,3
31,7,0,7,45,34,7
27,6,0,6,38,34,3
31,12,1,11,32,28,3
30,13,1,12,35,28,3
27,12,2,10,46,28,4
22,11,3,8,64,30,8
20,19.7922961,4.65902642,15.13326968,75,22.8820907,12.50245422
19,9,2,7,93,31,5
18,9,2,7,93,32,7
18,9,2,7,101,33,6
20,9,2,7,102,34,7
20,10,2,8,91,33,6
22,11,1,10,81,32,7
24,17,1,16,74,26,0
25,19,1,18,66,24,0
26,24,1,23,60,19,0
29,24,1,23,52,18,3
33,24,1,23,45,15,4
33,19,0,19,44,17,4
34,14,0,14,44,21,7
34,17,0,17,45,18,6
34,16,0,16,42,20,7
36,11,0,11,36,25,8
36,10,0,10,35,25,3
38,12,0,12,33,23,5
38,19,1,18,31,16,5
40,23,1,22,30,13,5
40,30,4,26,27,11,8
27,29,7,22,35,14,8
32,26,7,19,54,19,13
29,29,9,20,76,20,13
28,26,8,18,90,23,21
28,28,8,20,100,24,24
27,31,8,23,107,24,24
27,30,6,24,108,26,18
28,32,4,28,98,22,9
29,34,3,31,93,19,6
31,40,3,37,83,12,8
34,59,8,51,78,2,10
34,79,25,54,72,0,14
35,68,19,49,75,3,16
30,13,1,12,66,31,9
32,7,0,7,57,35,0
32,7,0,7,47,34,0
27,4,0,4,43,38,2
25,4,0,4,36,38,5
34,4,0,4,26,37,3
32,4,0,4,23,36,1
30,6,0,6,19,34,2
26,12,1,11,19,29,4
27,13,1,12,19,28,3
27,14,1,13,22,26,2
23,10,2,8,37,30,3
65,8,2,6,60,31,7
59.90930429,8,2,6,181.4489791,32,6
59.90930429,7,2,5,78,32,6
59.90930429,6,1,5,90,33,6
59.90930429,6,1,5,90,33,6
59.90930429,7,2,5,94,34,8
25,7,2,5,78,34,5
24,10,2,8,66,32,2
30,10,1,9,54,32,0
31,12,1,11,46,30,0
32,12,0,12,39,27,0
32,19,1,18,35,22,2
33,24,2,22,36,19,5
33,35,2,33,36,10,8
34,40,3,37,39,6,8
38,63,16,47,34,0,10
39,78,29,49,30,0,10
36,65,20,45,51,2,10
41,48,9,39,35,5,5
46,48,9,39,34,4,8
36,17,1,16,48,26,3
32,15,1,14,53,29,6
33,14,1,13,56,30,5
31,15,3,12,66,29,8
25,13,3,10,93,32,14
29,9,2,7,102,35,13
28,9,2,7,115,34,10
27,9,2,7,116,35,8
26,8,2,6,119,36,8
25,9,2,7,118,36,9
25,8,1,7,113,36,6
25,11,1,10,100,33,4
26,13,1,12,89,32,0
32,16,1,15,79,27,0
33,16,0,16,72,27,1
37,17,1,16,66,27,5
36,9,0,9,66,34,3
38,7,0,7,62,36,4
39,9,0,9,60,34,5
43,7,0,7,58,36,4
44,8,0,8,54,35,4
41,8,0,8,55,35,5
40,6,0,6,56,37,3
41,7,0,7,52,35,4
43,14,0,14,47,28,4
42,18,1,17,44,25,2
41,21,2,19,48,22,7
40,27,6,21,61,20,7
32,19,5,14,98,27,25
29,11,3,8,115,34,12
27,15,5,10,127,33,10
24,7,1,6,134,36,13
23,10,3,7,140,37,7
24,9,2,7,146,38,7
24,10,2,8,136,39,12
28,15,1,14,119,35,20
34,22,0,22,110,30,0
37,27,0,27,103,25,0
45,40,1,39,96,14,6
52,48,2,46,92,7,14
54,59,8,51,85,2,17
55,61,11,50,79,0,19
56,63,14,49,70,0,22
45,63,15,48,59,0,22
47,43,3,40,54,2,15
50,29,1,28,44,6,18
49,16,0,16,40,15,20
50,13,0,13,34,15,11
50,16,1,15,33,14,9
48,26,2,24,33,8,8
48,18,2,16,34,16,7
45,13,2,11,49,20,12
40,15,3,12,75,23,19
39,17,3,14,83,24,24
40,19,3,16,88,25,19
41,21,3,18,93,26,25
41,20,2,18,88,26,22
46,20,2,18,89,27,17
46,24,1,23,89,23,22
51,25,1,24,87,22,18
53,33,1,32,89,15,19
60,35,1,34,82,12,26
61,47,3,44,82,4,24
54,36,1,35,78,8,24
55,28,1,27,77,13,28
60,19,1,18,76,21,27
64,15,0,15,74,22,16
65,12,0,12,71,24,13
66,11,0,11,68,24,10
65,13,0,13,66,19,9
65,16,0,16,63,15,10
68,20,1,19,60,12,10
72,23,2,21,53,8,13
70,38,9,29,51,1,16
66,54,22,32,58,3,15
57,54,24,30,84,7,16
40,41,15,26,129,15,27
34,14,3,11,146,32,14
34,11,2,9,145,36,0
33,9,2,7,145,39,1
31,9,1,8,132,41,0
29,8,1,7,133,42,0
30,8,1,7,116,43,1
32,9,1,8,101,41,0
31,9,1,8,92,41,3
32,11,1,10,83,39,8
33,8,0,8,76,41,10
36,6,0,6,70,44,10
39,11,0,11,62,38,13
35,7,0,7,63,43,14
36,5,0,5,58,44,13
38,5,0,5,54,42,9
39,19.80695991,4.624692574,15.18226733,51,40,7
41,6,0,6,48,40,6
42,6,0,6,44,39,5
41,7,0,7,41,37,4
42,14,1,13,37,31,5
39,20,1,19,36,26,4
33,17,2,15,45,29,4
28,12,2,10,59,32,6
26,9,2,7,69,34,10
24,7,2,5,77,37,11
24,7,2,5,84,37,13
23,8,2,6,87,37,7
23,7,2,5,90,37,7
24,6,1,5,85,37,7
26,8,2,6,75,36,4
28,8,1,7,61,34,4
31,9,1,8,52,32,0
34,9,1,8,43,31,0
34,10,0,10,38,29,0
35,12,1,11,34,28,0
36,12,0,12,29,26,3
31,14,1,13,35,27,1
34,9,0,9,30,29,0
35,10,1,9,29,28,0
33,7,0,7,29,31,1
34,7,0,7,32,31,2
32,8,0,8,37,31,5
32,8,0,8,38,32,4
32,13,1,12,38,29,6
32,21,1,20,36,22,3
31,20,2,18,43,25,4
30,15,3,12,59,29,6
30,11,2,9,77,33,9
28,9,2,7,88,35,6
27,8,2,6,93,35,6
26,7,2,5,101,36,5
27,7,2,5,102,38,7
27,8,2,6,102,22.96247766,6
28,8,1,7,97,37,6
28,8,1,7,88,36,5
29,15,1,14,78,30,3
30,31,1,30,73,16,0
31,33,1,32,72,15,4
33,39,1,38,69,9,5
33,39,2,37,67,10,5
36,32,1,31,60,13,5
38,30,1,29,55,13,10
40,28,1,27,53,12,9
43,26,1,25,48,11,9
46,25,1,24,43,8,10
48,27,1,26,39,5,13
51,37,4,33,39,1,12
80,27,1,26,19,8,9
87,31,3,28,15,4,8
87,29,3,26,18,8,8
88,27,4,23,23,12,10
85,19.77761825,4.600655716,15.17696253,28,15,15
83,19.77761825,4.600655716,15.17696253,31,20,14
83,31,8,23,33,16,15
87,25,6,19,29,16,16
90,26,5,21,24,14,15
94,29,6,23,19,13,13
99,32,6,26,14,8,12
99,31,5,26,12,7,12
99,36,5,31,11,5,18
99,32,3,29,11,7,14
99,44,10,34,13,0,15
99,42,8,34,16,1,23
99,28,2,26,17,8,26
99,22,1,21,20,12,23
99,21,1,20,21,14,18
99,19,1,18,24,16,16
99,18,1,17,25,16,14
99,14,0,14,25,19,10
99,12,0,12,25,21,7
99,18,1,17,30,16,6
99,25,2,23,25,10,6
99,39,8,31,25,2,7
85,48,20,28,31,2,14
78,32,12,20,39,7,25
42,25,9,16,71,16,17
37,10,3,7,79,33,10
32,8,2,6,82,35,8
32,8,2,6,82,35,3
31,8,1,7,77,37,4
30,11,2,9,70,35,3
29,11,1,10,65,35,1
31,13,2,11,62,34,2
30,8,1,7,55,39,3
31,10,1,9,51,36,3
36,12,0,12,44,31,4
40,17,0,17,37,23,2
38,15,0,15,29,25,6
38,13,1,12,26,30,5
42,11,0,11,20,29,6
45,13,0,13,13,25,5
41,15,0,15,11,24,9
41,11,0,11,7,28,4
41,11,0,11,7,28,7
39,12,0,12,9,27,5
42,16,0,16,4,22,5
42,22,1,21,3,18,7
43,31,5,26,10,12,9
37,21,5,16,25,21,10
33,17,4,13,55,26,19
27,16,4,12,81,28,21
25,16,4,12,94,28,18
24,10,2,8,99,33,14
25,7,1,6,89,36,7
27,8,1,7,85,36,0
24,8,1,7,82,37,0
25,7,0,7,74,36,0
27,9,0,9,65,32,0
29,11,1,10,57,30,0
31,11,0,11,50,29,2
30,14,0,14,46,26,1
30,18,1,17,42,23,4
33,23,1,22,38,19,6
35,28,1,27,33,14,5
31,15,0,15,30,25,4
34,9,0,9,27,29,0
41,6,0,6,28,32,3
43,5,0,5,27,33,0
44,4,0,4,27,33,1
47,6,0,6,23,30,2
48,9,1,8,24,28,3
44,10,1,9,34,27,0
38,7,1,6,50,29,5
32,6,1,5,78,31,9
30,4,1,3,86,35,9
29,4,1,3,94,35,6
25,4,1,3,99,36,4
27,2,0,2,100,37,1
26,4,1,3,98,38,4
27,3,0,3,94,39,2
32,3,0,3,78,38,1
34,5,0,5,67,37,1
36,5,0,5,59,37,0
39,6,0,6,52,36,0
41,6,0,6,49,35,2
43,6,0,6,41,35,3
42,7,0,7,38,34,2
45,10,0,10,32,30,4
45,9,0,9,27,29,8
42,11,0,11,28,27,6
41,6,0,6,27,32,4
41,8,0,8,25,30,4
42,12,0,12,22,26,4
45,22,1,21,16,17,6
51,54,15,39,9,2,6
40,48,14,34,18,7,8
41,26,7,19,37,17,14
37,26,8,18,63,19,18
35,24,8,16,88,21,18
59.34559644,16,5,11,177.2453247,27,19
59.34559644,8,2,6,103,34,2
14,6,1,5,109,36,0
24,6,1,5,110,37,1
23,7,1,6,105,36,7
25,10,2,8,93,35,4
26,13,1,12,84,31,0
27,12,0,12,77,31,0
30,16,1,15,70,27,0
33,18,0,18,59,23,0
36,27,1,26,50,15,2
38,41,3,38,49,5,4
41,27,1,26,47,12,4
39,22,1,21,46,17,5
41,19.7259612,4.567082237,15.15887897,41,26,3
42,10,0,10,34,29,3
43,13,0,13,31,26,0
45,15,0,15,25,23,2
48,21,0,21,16,17,6
48,34,3,31,12,8,6
42,40,9,31,28,10,7
40,23,5,18,42,21,12
34,19.72829888,4.565129259,15.16316962,71,22.96341414,15
29,19.72829888,4.565129259,15.16316962,89,26,16
26,10,2,8,101,31,11
23,9,2,7,111,32,9
23,7,1,6,115,34,10
22,7,1,6,110,37,12
25,11,2,9,106,35,8
26,14,2,12,93,33,5
27,15,1,14,88,30,0
29,18,1,17,75,26,0
32,20,1,19,64,23,0
35,21,1,20,55,21,0
38,20,0,20,46,21,4
40,16,0,16,40,23,1
43,18,1,17,40,24,4
47,13,0,13,34,27,2
50,14,0,14,26,24,2
52,14,0,14,20,23,0
52,20,0,20,16,17,5
53,46,11,35,13,4,9
51,49,12,37,14,4,8
51,69,26,43,13,1,5
49,56,19,37,22,6,8
43,35,10,25,41,14,18
37,40,14,26,76,16,19
27,20,6,14,104,27,22
24,11,3,8,115,32,9
24,8,2,6,116,36,0
23,10,2,8,125,35,1
23,9,1,8,122,39,8
24,10,1,9,121,38,11
27,18,2,16,106,33,10
29,18,2,16,91,32,1
29,15,0,15,83,33,0
33,19,0,19,74,29,0
36,22,0,22,66,25,5
39,27,1,26,59,21,6
42,29,1,28,50,17,8
46,30,1,29,42,14,10
49,29,0,29,38,15,10
49,26,0,26,33,18,13
49,27,1,26,29,14,13
50,25,0,25,24,14,11
51,30,1,29,22,11,15
51,31,1,30,22,11,13
52,48,7,41,18,3,13
49,69,26,43,26,4,15
44,53,18,35,47,11,24
36,44,15,29,83,17,27
34,37,11,26,102,20,23
32,34,10,24,121,24,25
31,27,6,21,132,29,21
32,32,7,25,137,31,23
36,39,7,32,134,29,7
45,25,3,22,126,33,12
53,22,2,20,114,35,7
58,20,1,19,108,36,8
63,27,1,26,106,29,3
64,30,1,29,102,25,10
67,51,5,46,93,9,14
69,52,6,46,87,7,15
69,59,9,50,78,2,20
68,64,13,51,78,0,24
71,61,13,48,75,0,27
74,78,26,52,72,0,26
74,91,37,54,71,0,23
69,100,47,53,66,0,26
69,103,52,51,60,0,28
63,110,59,51,53,0,29
60,97,51,46,49,0,24
62,136,84,52,56,0,25
61,121,70,51,100,3,35
55,20,4,16,169,30,31
54,20,4,16,177,31,22
47,16,3,13,187,34,21
46,11,2,9,192,38,23
50,11,2,9,196,37,22
54,13,2,11,191,36,6
54,13,2,11,193,37,18
51,12,1,11,189,37,0
54,12,0,12,181,36,10
59,14,0,14,173,33,1
45,17,1,16,163,30,7
39,9,0,9,138,37,2
38,9,0,9,124,37,0
37,7,0,7,114,40,0
36,8,0,8,107,40,0
37,6,0,6,99,42,3
38,8,0,8,96,39,4
35,7,0,7,94,39,7
35,8,0,8,89,38,6
36,11,0,11,84,33,6
46,11,0,11,78,29,5
40,9,0,9,70,31,4
39,15,1,14,71,26,3
37,13,2,11,80,29,12
33,18,3,15,87,25,13
31,13,2,11,98,31,8
30,10,1,9,95,34,11
29,8,1,7,98,36,9
30,7,0,7,91,37,9
30,8,0,8,90,37,4
37,12,1,11,92,35,9
41,13,1,12,85,31,11
47,16,1,15,81,29,10
49,16,1,15,77,29,11
47,16,0,16,76,29,10
50,13,0,13,74,30,10
52,15,0,15,72,28,7
53,14,1,13,72,30,8
52,7,0,7,70,37,6
62,5,0,5,45,36,4
84,6,0,6,23,31,3
79,4,0,4,23,35,0
51,5,0,5,30,34,1
43,3,0,3,28,39,2
41,4,0,4,27,37,2
43,5,0,5,24,36,0
40,6,0,6,34,34,4
36,6,1,5,46,35,6
28,5,1,4,66,36,10
25,4,1,3,80,38,10
23,3,0,3,89,38,8
23,3,0,3,100,39,9
23,3,0,3,108,40,9
23,3,0,3,105,41,11
23,4,0,4,109,41,13
23,6,0,6,97,42,14
30,12,0,12,89,38,3
39,21,0,21,84,26,0
48,30,1,29,84,18,3
46,35,1,34,75,14,8
44,34,1,33,66,13,10
41,32,1,31,60,14,11
48,35,1,34,52,9,17
42,31,1,30,45,7,18
44,21,0,21,34,12,12
43,15,0,15,31,19,10
44,20,0,20,34,13,11
46,33,2,31,31,4,12
45,31,2,29,26,6,11
46,42,8,34,24,4,9
45,38,10,28,31,10,19
42,42,14,28,50,12,23
45,51,20,31,98,12,30
45,38,12,26,146,23,31
44,17,4,13,183,35,24
46,8,1,7,188,41,19
50,8,1,7,190,42,18
56,9,1,8,178,42,21
58,8,1,7,179,43,14
67,8,1,7,172,43,15
79,19,1,18,109,33,14
87,21,1,20,103,28,0
89,21,1,20,103,25,1
82,23,1,22,105,19,7
50,12,0,12,98,34,5
40,5,0,5,84,41,0
37,4,0,4,75,42,0
35,4,0,4,70,43,0
36,19.82260287,4.58093879,15.24166408,63,42,2
35,6,0,6,62,40,6
41,6,0,6,55,40,10
51,7,0,7,47,38,5
52,12,1,11,40,34,1
48,13,1,12,40,32,2
46,13,2,11,46,31,2
44,19.81469485,4.577940113,15.23675474,56,23.03134995,7
35,12,3,9,75,32,6
31,9,2,7,81,35,6
34,8,2,6,78,35,4
28,8,2,6,82,36,3
25,6,1,5,82,37,1
27,7,2,5,78,37,4
28,8,2,6,73,37,5
29,8,1,7,62,37,1
30,8,1,7,52,37,0
32,9,1,8,45,36,0
31,8,0,8,44,36,3
32,6,0,6,43,38,4
31,7,0,7,42,37,2
32,8,0,8,42,36,4
35,8,0,8,35,34,6
37,8,0,8,32,32,3
39,8,0,8,31,33,7
43,8,0,8,23,31,4
46,9,0,9,20,30,5
48,10,0,10,17,29,5
50,13,0,13,12,25,3
50,25,2,23,10,16,7
47,36,8,28,19,14,10
40,27,7,20,44,21,17
36,21,6,15,78,27,23
34,21,6,15,89,28,17
36,24,6,18,87,26,13
38,20,3,17,87,30,11
42,30,5,25,94,26,2
48,19,3,16,100,32,4
53,16,2,14,100,34,7
55,16,1,15,100,32,4
54,22,1,21,97,26,7
54,46,4,42,93,7,11
58,51,5,46,92,2,18
59,43,4,39,104,8,15
59,14,1,13,106,32,12
53,13,0,13,105,33,8
57,9,0,9,105,37,8
60,7,0,7,111,40,7
64,7,0,7,110,40,6
64,7,0,7,117,38,6
67,8,0,8,119,36,6
82,14,1,13,115,30,8
81,17,1,16,125,26,10
79,15,1,14,132,27,8
77,15,1,14,143,28,10
80,16,1,15,145,28,13
85,34,11,23,87,15,15
86,40,15,25,102,14,9
84,65,33,32,76,1,14
73,50,20,30,86,5,14
68,39,12,27,108,12,18
63,36,9,27,135,18,27
63,43,9,34,142,14,33
64,34,4,30,140,16,25
67,40,3,37,132,10,16
62,48,5,43,134,5,16
39,23,1,22,139,22,10
38,9,1,8,129,35,0
37,8,0,8,117,36,0
36,6,0,6,108,39,0
37,5,0,5,98,40,0
36,5,0,5,90,42,0
36,5,0,5,85,41,3
35,5,0,5,79,41,7
35,4,0,4,73,41,5
34,5,0,5,67,41,4
33,7,0,7,64,39,4
33,8,0,8,59,37,5
32,10,1,9,59,35,6
29,10,1,9,61,35,7
26,10,2,8,83,35,7
25,9,2,7,89,35,8
25,7,1,6,100,36,10
25,7,1,6,96,37,6
23,7,1,6,108,36,5
23,9,2,7,108,36,7
23,8,1,7,102,36,10
23,10,1,9,96,35,2
24,13,1,12,85,33,0
25,15,0,15,78,29,1
26,18,1,17,76,28,2
30,15,0,15,71,27,6
33,13,0,13,66,25,2
35,12,0,12,60,25,6
43,11,0,11,57,28,2
51,9,0,9,50,32,9
53,7,0,7,49,34,4
42,8,0,8,50,32,3
54,8,0,8,48,31,6
59,12,0,12,44,25,5
57,19,0,19,45,20,5
54,22,1,21,46,17,4
50,21,2,19,52,19,9
44,23,4,19,60,19,7
35,33,9,24,72,17,12
33,28,8,20,104,22,18
41,23,6,17,113,24,22
41,19,4,15,121,30,21
42,13,2,11,121,37,16
33,13,2,11,122,42,12
36,9,1,8,121,45,14
45,11,1,10,106,44,4
52,18,0,18,101,35,5
62,14,0,14,94,33,0
66,18,1,17,88,28,0
68,17,1,16,81,28,2
72,16,1,15,75,28,4
76,17,1,16,70,24,6
81,12,0,12,64,25,5
76,10,0,10,62,26,6
75,11,0,11,53,22,9
70,10,0,10,50,23,9
68,11,0,11,50,23,11
68,16,0,16,44,18,8
63,14,0,14,41,20,8
64,17,1,16,38,18,10
57,28,6,22,46,12,11
48,20,5,15,66,19,21
42,20,5,15,100,24,23
33,15,3,12,119,31,22
32,10,2,8,128,37,20
29,8,1,7,135,41,12
27,5,0,5,146,45,17
27,5,0,5,140,48,9
26,8,0,8,128,48,11
28,10,0,10,124,47,0
27,13,0,13,117,43,4
33,18,0,18,112,38,1
49,14,0,14,105,39,8
52,19,0,19,98,33,11
57,29,1,28,87,24,15
64,18,0,18,77,28,16
66,9,0,9,78,36,9
69,4,0,4,72,42,5
67,5,0,5,66,39,4
68,7,0,7,60,35,7
66,6,0,6,55,35,4
67,7,0,7,54,34,4
67,12,0,12,55,29,5
66,17,1,16,54,24,6
62,16,2,14,57,26,7
62,18,3,15,61,25,8
57,26,6,20,62,22,7
53,22,6,16,68,25,9
51,25,8,17,76,25,7
46,19,5,14,87,30,11
45,20,6,14,85,31,15
44,16,4,12,92,34,8
48,13,3,10,86,36,11
52,13,3,10,69,39,10
56,10,1,9,60,40,1
58,10,1,9,55,40,0
59,8,1,7,52,41,2
59,6,0,6,49,42,5
60,8,0,8,47,38,4
63,12,1,11,44,35,6
63,12,0,12,39,31,9
64,12,0,12,35,30,6
62,19.72957648,4.529213675,15.2003628,31,24,8
62,11,0,11,29,26,6
60,10,0,10,24,29,7
59,11,0,11,27,28,8
57,19,0,19,29,19,9
57,22,1,21,28,18,10
56,22,3,19,34,19,7
53,23,6,17,48,22,12
51,32,11,21,73,21,20
45,18,5,13,80,30,23
46,19,7,12,84,30,9
46,15,4,11,89,34,12
43,19.72769948,4.527612008,15.20008748,99,23.17621038,12.16833128
44,13,3,10,95,37,12.16833128
44,11,2,9,95,38,12.16833128
48,12,2,10,79,39,12.16833128
53,12,1,11,65,39,12.16833128
57,12,1,11,55,37,12.16833128
59,12,1,11,49,35,12.16833128
63,12,1,11,43,35,12.16833128
66,11,0,11,37,34,12.16833128
68,10,0,10,33,34,12.16833128
70,13,0,13,28,30,12.16833128
70,12,0,12,26,29,12.16833128
70,16,0,16,25,24,12.16833128
73,22,0,22,20,17,12.16833128
73,25,0,25,17,14,12.16833128
74,29,1,28,14,9,12.16833128
77,48,10,38,10,1,12.16833128
75,71,32,39,10,0,12.16833128
71,59,25,34,22,5,12.16833128
62,41,14,27,47,13,12.16833128
57,25,7,18,70,25,12.16833128
53,15,3,12,83,34,12.16833128
51,18,5,13,92,33,12.16833128
47,18,4,14,102,36,12.16833128
42,19,3,16,114,41,12.16833128
42,17,2,15,110,45,12.16833128
41,17,2,15,115,46,29
44,24,1,23,107,40,21
47,24,1,23,104,39,16
56,23,0,23,101,37,14
73,22,1,21,91,32,16
80,19,0,19,86,31,11
87,18,1,17,80,30,12
90,18,1,17,76,28,10
91,14,0,14,72,26,13
92,14,0,14,69,24,14
92,11,0,11,69,27,12
90,11,0,11,67,29,11
90,12,0,12,66,28,9
90,19,1,18,65,19,13
89,17,1,16,64,20,13
88,19,1,18,61,18,15
88,20,2,18,64,16,18
86,20,3,17,67,18,25
83,24,5,19,72,18,24
80,26,6,20,76,17,22
74,25,6,19,88,21,20
76,23,4,19,87,24,19
87,23,2,21,82,23,21
89,29,5,24,82,20,10
90,30,5,25,80,19,14
90,35,5,30,82,15,17
91,35,2,33,82,12,20
90,43,3,40,82,6,20
89,35,2,33,80,13,25
86,37,3,34,80,9,22
85,35,2,33,81,7,26
86,44,4,40,79,2,32
86,50,8,42,75,0,31
84,35,3,32,71,5,25
87,33,2,31,65,2,20
87,37,5,32,62,1,25
86,47,14,33,60,0,24
85,53,20,33,54,0,24
88,76,43,33,50,0,18
87,103,68,35,52,0,23
63,66,31,35,77,7,17
49,16,3,13,103,29,10
39,14,3,11,127,33,7
34,12,2,10,138,36,8
34,11,2,9,145,40,9
32,11,2,9,148,42,7
30,10,2,8,149,42,5
28,12,2,10,134,41,5
25,11,2,9,128,40,3
26,10,1,9,113,39,3
28,11,1,10,94,38,1
29,9,0,9,85,37,0
32,8,0,8,77,38,0
34,8,0,8,71,37,3
37,8,0,8,66,36,3
37,9,0,9,63,35,7
40,10,0,10,56,33,6
43,11,0,11,48,31,6
43,18,0,18,44,23,6
47,32,3,29,45,12,8
46,42,4,38,47,5,9
47,57,15,42,42,0,11
51,67,25,42,39,1,9
50,87,40,47,41,1,11
44,50,14,36,55,9,11
36,30,7,23,77,21,20
37,22,4,18,96,27,24
42,32,7,25,107,26,20
43,28,6,22,113,26,15
44,29,6,23,117,26,18
41,17,3,14,132,33,17
41,10,1,9,133,41,15
44,10,1,9,126,43,10
50,15,1,14,122,38,6
52,15,0,15,117,37,7
53,18,0,18,114,35,4
54,19,0,19,109,31,7
56,19,0,19,105,29,14
61,29,1,28,95,20,16
65,38,2,36,83,10,15
69,30,1,29,75,12,15
70,46,4,42,71,2,16
75,41,3,38,63,2,14
76,36,3,33,54,2,18
67,28,2,26,50,5,20
67,20,0,20,47,10,19
67,20,0,20,45,11,21
66,23,2,21,44,10,19
60,23,4,19,57,15,25
55,16,3,13,80,23,32
54,15,3,12,112,30,35
56,12,2,10,133,37,37
51,10,1,9,139,43,37
47,9,1,8,151,48,31
42,10,1,9,155,51,33
35,11,1,10,153,51,34
37,14,1,13,149,51,8
56,17,1,16,139,48,20
59,10,0,10,131,49,16
62,10,0,10,124,48,13
68,11,0,11,116,41,15
74,10,0,10,107,40,20
77,8,0,8,102,39,16
75,8,0,8,94,37,15
75,8,0,8,89,38,16
74,10,0,10,82,34,18
75,10,0,10,75,30,18
74,12,0,12,77,28,23
74,16,0,16,77,22,24
74,22,0,22,77,17,28
74,26,1,25,76,13,27
75,38,4,34,74,7,28
73,48,13,35,81,6,29
70,49,14,35,91,9,32
69,50,13,37,97,10,35
67,45,11,34,104,13,31
65,48,12,36,112,14,31
66,35,6,29,114,23,34
67,33,4,29,113,22,28
81,36,4,32,107,19,26
88,44,6,38,102,13,26
85,55,8,47,102,7,21
87,49,4,45,103,7,22
88,48,3,45,103,5,20
88,64,14,50,100,0,24
87,79,26,53,97,0,32
88,90,35,55,94,0,28
87,97,43,54,90,0,27
76,54,11,43,85,2,31
51,22,1,21,76,22,27
49,19.86888397,4.540382519,15.32850145,71,35,1
53,9,0,9,60,32,0
50,13,0,13,54,27,0
48,17,0,17,53,23,3
46,15,0,15,53,25,4
47,19,1,18,54,23,6
40,21,1,20,59,22,7
42,19.86579713,4.53729213,15.328505,64,23,9
41,27,6,21,78,21,10
39,18,5,13,87,26,13
39,18,5,13,97,29,19
36,15,4,11,102,31,12
41,15,3,12,103,33,11
49,19,3,16,94,31,16
79,18,2,16,65,31,0
81,19,3,16,59,30,0
80,17,1,16,56,30,3
83,18,1,17,48,28,7
78,19,1,18,46,24,8
60,19,1,18,49,24,11
76,15,1,14,39,26,5
85,19,1,18,30,19,11
86,21,1,20,27,15,16
84,27,2,25,26,9,16
82,25,2,23,28,12,15
79,20,1,19,28,15,12
72,31,3,28,26,7,16
54,39,5,34,19,6,16
57,46,9,37,17,5,9
57,138,88,50,14,1,11
49,53,21,32,31,13,12
50,26,7,19,51,23.17196537,22
41,36,12,24,79,23.17196537,18
32,33,10,23,95,22,21
31,19,5,14,101,30,14
25,10,2,8,109,35,5
24,9,2,7,109,38,9
26,12,2,10,108,37,66
25,19,3,16,113,34,6
28,18,2,16,103,35,22
32,22,1,21,90,31,8
34,30,1,29,82,22,0
39,38,1,37,78,16,0
41,63,11,52,74,4,5
45,60,9,51,69,3,11
47,73,20,53,58,1,13
47,65,15,50,44,1,12
47,45,4,41,42,4,10
49,51,7,44,34,1,13
49,54,11,43,30,1,12
50,57,12,45,26,1,14
53,58,14,44,23,1,14
53,73,26,47,20,0,12
52,95,48,47,22,1,11
46,63,25,38,37,7,12
39,40,13,27,60,14,19
36,42,13,29,91,13,20
29,29,9,20,108,24,20
29,27,7,20,123,27,20
27,27,7,20,124,31,18
26,16,3,13,124,39,11
25,17,3,14,133,39,5
27,16,2,14,126,39,12
23,12,1,11,117,41,6
30,14,1,13,107,39,0
34,25,1,24,102,30,0
44,25,1,24,101,28,0
44,29,1,28,98,24,8
48,26,1,25,96,27,11
54,37,1,36,87,15,15
43,54,5,49,78,5,17
42,25,1,24,71,22,13
43,18,1,17,67,27,6
45,14,0,14,61,28,7
48,24,0,24,54,18,9
53,33,1,32,45,9,11
54,47,9,38,39,4,11
54,69,26,43,42,2,12
50,76,33,43,58,5,15
47,49,16,33,83,12,22
38,29,8,21,118,24,24
39,21,5,16,127,31,23
32,23,5,18,134,31,18
28,13,2,11,140,37,14
26,7,1,6,134,42,5
24,6,1,5,133,43,0
26,7,1,6,127,42,5
24,6,1,5,115,43,9
25,7,0,7,104,42,2
26,7,0,7,93,41,3
29,12,0,12,84,35,7
32,15,0,15,78,32,6
35,12,0,12,73,35,7
38,12,0,12,69,35,9
40,12,0,12,63,34,5
39,10,0,10,61,34,6
40,10,0,10,60,34,9
42,9,0,9,57,34,9
45,9,0,9,49,33,8
47,17,0,17,50,24,6
50,19,0,19,42,20,7
51,30,3,27,42,14,10
46,24,4,20,51,21,11
40,11,2,9,71,31,17
36,10,2,8,92,35,22
34,9,2,7,105,35,18
31,6,1,5,116,37,17
28,6,1,5,118,40,13
28,7,1,6,125,42,9
27,6,0,6,131,46,18
34,5,0,5,123,46,13
41,5,0,5,99,44,4
45,5,0,5,84,42,0
49,6,0,6,76,40,0
52,7,0,7,71,38,0
53,8,0,8,68,36,3
53,8,0,8,70,36,7
52,9,0,9,71,35,7
54,5,0,5,68,38,7
50,4,0,4,58,37,4
49,6,0,6,49,34,3
50,5,0,5,42,33,3
52,5,0,5,35,32,4
53,8,0,8,31,28,4
52,8,0,8,28,28,5
50,13,1,12,35,26,6
40,11,1,10,49,28,10
39,7,1,6,69,33,17
38,6,1,5,85,35,16
38,5,1,4,95,37,17
36,5,1,4,111,38,18
35,5,0,5,118,39,14
35,5,0,5,124,43,20
34,5,0,5,125,47,16
36,6,0,6,122,50,16
44,8,0,8,109,50,8
45,7,0,7,95,43,6
47,7,0,7,83,43,0
46,7,0,7,81,41,2
46,9,0,9,81,38,2
48,10,0,10,80,36,7
50,10,0,10,81,36,8
52,7,0,7,80,38,7
54,5,0,5,78,38,7
58,5,0,5,76,37,9
60,5,0,5,74,35,8
64,9,0,9,67,26,12
72,12,0,12,65,23,12
70,17,0,17,62,17,13
68,25,2,23,60,13,17
63,24,4,20,57,17,17
62,23,4,19,68,20,15
59,23,4,19,77,21,18
58,26,6,20,84,21,20
53,30,8,22,102,21,24
53,26,7,19,115,24,25
54,22,5,17,119,28,25
54,20,4,16,125,30,23
54,19,4,15,134,31,20
58,19,3,16,124,32,22
74,16,1,15,112,33,8
82,15,1,14,98,30,2
83,11,1,10,93,31,2
85,10,1,9,91,30,4
89,8,0,8,88,31,5
91,7,0,7,83,32,5
89,5,0,5,78,34,7
90,5,0,5,75,34,7
91,19.89983152,4.531293001,15.36853852,74,29,8
90,9,0,9,72,26,10
88,11,0,11,69,24,9
91,15,0,15,69,20,11
91,19,1,18,67,12,12
92,22,2,20,66,12,10
91,20,2,18,68,12,10
90,19.89702454,4.528631322,15.36839322,72,23.25540838,12.22779133
87,24,7,17,79,16,8
83,24,6,18,90,16,14
82,20,5,15,94,20,16
81,18,4,14,99,22,12
75,15,3,12,105,24,10
75,16,4,12,106,26,7
73,21,4,17,104,26,8
72,14,2,12,103,29,4
73,12,2,10,92,29,3
78,12,1,11,85,30,1
73,11,1,10,83,31,1
70,10,1,9,81,34,0
68,9,1,8,78,35,1
79,9,1,8,69,35,0
69,8,0,8,70,34,1
66,6,0,6,68,36,8
66,7,0,7,65,36,17
70,5,0,5,59,38,20
85,6,0,6,50,38,17
87,7,0,7,45,36,8
87,9,0,9,41,32,9
87,11,1,10,37,32,10
84,10,1,9,39,35,7
84,17,4,13,43,31,3
80,18,3,15,48,29,3
75,18,4,14,55,30,4
73,22,5,17,54,27,3
71,15,4,11,55,31,4
65,18,5,13,62,28,2
61,19,5,14,70,27,1
60,18,5,13,71,28,6
58,15,4,11,69,30,4
66,13,2,11,61,30,2
68,16,2,14,55,26,4
66,15,1,14,50,26,5
66,19,2,17,49,23,9
68,21,1,20,48,19,11
70,19,1,18,45,18,8
70,17,1,16,43,20,8
71,13,0,13,41,22,7
71,13,0,13,39,22,7
73,21,1,20,37,14,11
76,37,8,29,33,5,9
78,49,15,34,31,1,9
80,80,44,36,28,0,11
74,110,69,41,30,1,7
61,63,28,35,52,6,13
50,48,19,29,80,13,24
44,28,9,19,106,22,20
38,24,7,17,122,25,12
28,12,3,9,136,33,15
28,7,1,6,137,38,4
27,7,1,6,147,40,4
27,9,2,7,140,40,7
41,26,3,23,124,31,10
41,25,3,22,123,32,7
41,22,1,21,115,33,13
28,19,1,18,104,34,4
28,16,0,16,97,33,4
34,14,0,14,86,34,5
38,16,0,16,78,29,3
40,18,0,18,71,24,4
42,18,0,18,65,24,2
44,17,0,17,61,26,6
48,16,0,16,55,25,4
51,16,0,16,51,24,5
54,18,0,18,47,21,4
54,32,1,31,43,11,6
53,25,1,24,41,17,7
50,25,2,23,46,19,8
46,19,4,15,59,24,9
41,18,4,14,82,29,17
38,16,4,12,103,29,20
33,17,4,13,123,29,17
29,11,2,9,125,36,12
27,10,2,8,134,37,7
25,9,2,7,141,39,12
26,9,2,7,143,42,14
25,8,1,7,139,43,14
25,10,1,9,132,43,4
26,10,1,9,125,43,0
27,11,0,11,120,39,0
39,14,1,13,107,39,3
43,12,0,12,105,39,8
51,10,0,10,94,39,8
32,8,0,8,89,41,5
34,11,0,11,83,39,6
37,11,0,11,75,36,7
38,12,0,12,70,34,9
40,14,0,14,63,31,10
43,23,0,23,55,21,14
43,30,1,29,56,15,15
43,42,3,39,53,7,16
41,37,4,33,63,15,14
37,30,5,25,80,23,16
35,21,4,17,100,28,22
28,14,3,11,125,36,24
25,7,1,6,140,41,18
24,6,1,5,149,42,10
25,6,1,5,151,44,14
24,5,0,5,154,46,14
24,5,0,5,152,48,14
27,7,0,7,147,49,12
29,16,1,15,136,45,11
40,22,1,21,130,39,2
45,34,1,33,125,27,9
48,23,1,22,122,37,15
51,21,1,20,118,39,18
54,22,0,22,114,36,17
57,25,1,24,108,31,16
43,27,1,26,101,28,22
39,19,0,19,92,36,23
38,18,0,18,84,35,28
38,14,0,14,84,39,25
42,20,0,20,78,29,25
53,31,1,30,69,16,29
49,34,1,33,65,12,25
44,27,2,25,74,19,23
36,26,3,23,97,25,28
31,18,2,16,129,40,37
29,8,1,7,145,61,46
28,6,0,6,156,63,48
27,7,0,7,167,62,48
26,7,0,7,173,63,45
26,6,0,6,176,63,49
26,6,0,6,174,64,49
26,7,0,7,169,65,49
28,7,0,7,155,66,48
29,8,0,8,148,64,44
31,10,0,10,143,64,46
33,9,0,9,136,61,45
35,9,0,9,128,60,44
39,14,0,14,119,53,42
43,11,0,11,112,55,40
46,10,0,10,103,53,34
46,7,0,7,98,56,23
38,7,0,7,97,52,18
41,5,0,5,90,52,22
37,5,0,5,91,52,30
35,5,0,5,95,56,32
35,8,0,8,92,56,43
34,13,0,13,93,48,45
31,14,1,13,105,45,44
28,9,1,8,122,50,48
27,8,1,7,134,52,45
25,6,0,6,153,51,44
23,7,1,6,164,51,42
22,5,0,5,169,51,40
22,4,0,4,176,51,35
21,5,0,5,180,52,37
22,5,0,5,179,52,22
22,10,0,10,161,58,22
25,13,0,13,152,56,13
44,20,0,20,140,53,26
46,13,0,13,130,59,27
48,14,0,14,127,53,28
51,15,0,15,124,50,30
52,15,0,15,124,50,29
52,16,0,16,123,47,32
55,15,0,15,123,47,32
57,19.83388179,4.488548821,15.34533297,125,48,27
71,10,0,10,119,49,25
78,11,0,11,112,47,19
76,10,0,10,110,44,17
76,13,0,13,105,40,15
79,22,1,21,101,32,17
82,14,1,13,96,41,13
85,19.82929533,4.485617107,15.34367822,97,34,10
83,21,2,19,97,32,10
86,21,3,18,101,33,11
83,21,4,17,103,33,11
87,17,3,14,102,36,7
86,18,3,15,105,36,5
88,18,3,15,107,35,1
90,15,3,12,104,35,4
92,16,2,14,98,35,1
94,14,1,13,94,33,0
91,11,0,11,91,33,2
90,14,1,13,85,30,6
90,12,0,12,82,32,3
90,16,1,15,78,30,0
88,11,0,11,76,32,1
85,12,0,12,76,27,4
72,12,0,12,76,29,3
61,9,0,9,78,37,2
52,6,0,6,80,46,0
42,4,0,4,76,50,2
43,5,0,5,68,50,16
44,8,0,8,65,46,17
45,11,1,10,64,41,15
42,10,1,9,77,39,17
40,9,1,8,99,39,23
35,10,2,8,111,41,23
33,10,2,8,126,40,18
31,10,2,8,131,40,16
28,6,1,5,139,42,13
28,9,2,7,143,42,14
27,9,2,7,144,44,14
29,7,1,6,142,45,6
29,7,1,6,126,45,11
30,7,0,7,114,44,7
31,11,1,10,106,41,4
32,11,0,11,101,39,7
36,12,0,12,91,36,9
35,12,0,12,88,35,10
36,13,0,13,87,34,11
35,9,0,9,86,38,13
37,7,0,7,82,40,11
41,8,0,8,70,37,13
45,12,0,12,62,30,10
47,27,0,27,57,15,12
49,41,2,39,54,5,14
51,71,25,46,51,1,19
51,58,18,40,52,5,17
48,49,15,34,65,9,17
42,41,11,30,82,15,22
39,24,5,19,96,27,23
35,28,6,22,109,23.56585687,26
33,19,4,15,121,34,15
27,15,3,12,134,36,12
27,11,2,9,139,40,15
26,10,1,9,150,43,19
24,9,1,8,147,46,20
25,10,2,8,136,46,13
33,16,1,15,128,41,11
32,17,0,17,117,36,8
42,12,0,12,110,38,5
48,14,1,13,104,41,11
49,11,0,11,99,43,14
57,9,0,9,89,40,12
58,6,0,6,83,38,13
58,6,0,6,82,37,10
50,11,0,11,77,30,15
49,12,0,12,74,27,17
52,9,0,9,72,32,15
55,8,0,8,73,34,16
54,10,0,10,72,32,14
55,14,1,13,70,28,14
46,21,3,18,77,23,14
41,16,3,13,90,28,17
31,12,3,9,110,35,17
26,9,2,7,122,36,9
25,6,1,5,126,37,6
25,5,1,4,125,38,5
22,6,1,5,126,38,6
24,7,1,6,115,41,6
24,5,1,4,111,42,1
25,6,1,5,100,41,3
28,7,1,6,86,41,4
30,6,0,6,78,41,0
32,5,0,5,71,42,3
34,6,0,6,65,40,4
38,6,0,6,58,41,7
41,7,0,7,55,38,6
43,8,0,8,52,37,10
44,10,0,10,46,34,9
46,10,0,10,44,33,10
48,9,0,9,39,33,9
51,10,0,10,35,32,11
51,9,0,9,37,33,9
50,11,0,11,34,32,11
49,18,1,17,37,25,10
41,16,2,14,53,27,17
34,11,2,9,77,34,18
32,10,2,8,95,37,23
30,7,1,6,107,37,15
28,6,1,5,121,40,18
27,5,0,5,123,42,11
28,6,1,5,122,44,16
29,7,1,6,132,47,16
32,9,1,8,125,48,15
37,8,1,7,102,43,8
39,9,1,8,91,41,0
36,8,0,8,84,41,0
44,10,0,10,81,38,0
45,12,0,12,77,34,3
43,17,1,16,78,30,7
46,12,1,11,76,35,6
48,6,0,6,72,38,8
51,5,0,5,74,37,6
56,5,0,5,75,34,7
60,5,0,5,71,34,7
66,7,0,7,65,29,7
73,6,0,6,59,29,5
78,6,0,6,55,29,5
79,7,0,7,58,28,5
82,8,1,7,63,28,8
82,8,1,7,66,31,10
83,8,1,7,67,34,11
85,10,2,8,70,32,9
87,11,2,9,68,30,11
89,15,2,13,65,26,9
91,16,3,13,70,25,10
90,17,3,14,70,25,10
90,12,2,10,72,27,9
90,12,1,11,75,26,11
90,11,1,10,74,27,10
90,11,1,10,71,28,12
91,13,2,11,68,25,10
92,11,1,10,68,25,10
93,10,0,10,67,25,11
93,8,0,8,64,26,10
93,7,0,7,63,28,10
92,5,0,5,60,32,7
92,4,0,4,56,34,7
93,4,0,4,53,35,3
91,4,0,4,45,36,2
92,3,0,3,33,39,0
100,5,0,5,36,40,0
100,5,0,5,38,40,3
100,6,0,6,40,40,0
100,14,2,12,40,34,1
95,14,3,11,46,34,0
93,15,3,12,43,33,4
88,11,2,9,46,37,3
87,12,2,10,55,36,1
83,15,3,12,65,32,1
79,17,4,13,68,31,4
75,18,4,14,70,33,9
71,18,4,14,73,31,6
70,17,3,14,70,31,6
75,17,1,16,63,27,4
78,21,1,20,56,21,0
77,37,3,34,53,9,0
84,77,34,43,47,1,1
82,101,55,46,45,1,8
81,71,28,43,42,1,7
85,79,38,41,39,0,6
72,19.72188768,4.447567628,15.27432006,39,1,6
67,32,1,31,41,14,4
71,23,0,23,36,19,5
73,27,1,26,34,14,4
76,43,7,36,29,4,4
70,47,13,34,42,6,7
56,30,7,23,66,20,17
47,19.73153582,4.447834533,15.28370129,87,23.67607306,16
42,15,3,12,106,32,19
39,16,3,13,119,33,23
36,12,2,10,123,36,26
33,9,1,8,130,41,22
33,11,2,9,139,45,24
31,10,1,9,136,50,26
32,15,1,14,130,47,23
33,17,1,16,124,45,4
46,20,0,20,114,41,11
55,18,0,18,104,40,12
67,15,0,15,92,40,10
68,18,0,18,91,36,9
70,20,0,20,89,33,10
70,16,0,16,86,35,11
71,25,1,24,79,25,15
73,21,0,21,75,26,17
78,24,0,24,67,21,16
83,24,1,23,59,14,18
84,16,0,16,53,19,19
83,14,0,14,46,21,20
83,22,1,21,43,14,19
79,31,5,26,48,11,24
74,28,7,21,61,14,29
63,24,6,18,86,21,37
53,16,3,13,100,34,32
58.45643651,13,2,11,117,38,24
42,11,1,10,119,42,23
40,11,2,9,130,43,20
37,12,2,10,137,44,19
30,10,1,9,137,49,25
34,11,1,10,139,51,18
47,15,1,14,125,50,6
49,14,0,14,116,50,20
48,15,0,15,108,45,5
54,18,0,18,105,40,9
55,25,0,25,98,32,12
57,34,0,34,95,23,16
60,31,1,30,92,22,17
63,32,0,32,89,21,17
66,33,0,33,82,19,23
71,42,2,40,71,8,24
73,37,1,36,65,7,22
74,45,6,39,60,3,21
73,31,1,30,58,10,22
76,36,2,34,57,5,27
73,55,19,36,64,3,27
63,55,20,35,80,8,34
55,36,10,26,107,18,40
50,29,6,23,133,29,41
43,23,4,19,151,39,41
37,25,4,21,168,43,44
31,25,3,22,168,47,44
37,18,1,17,169,57,19
39,23,2,21,167,58,32
43,21,1,20,173,59,25
53,21,1,20,157,62,35
57,18,0,18,151,62,12
63,23,0,23,147,54,26
66,32,0,32,142,40,23
69,53,2,51,135,18,30
67,65,3,62,132,8,33
48,52,1,51,126,18,35
45,24,0,24,118,32,28
46,18,0,18,112,37,21
50,16,0,16,106,39,21
48,16,0,16,102,37,16
45,14,0,14,101,39,13
38,14,0,14,100,39,15
40,21,0,21,95,33,17
36,22,1,21,101,30,16
35,13,1,12,112,39,23
33,13,1,12,113,42,27
33,15,1,14,117,41,22
38,20,2,18,115,37,22
36,19,2,17,118,39,25
39,19,2,17,118,39,24
40,22,3,19,115,38,27
54,16,2,14,100,41,19
65,15,2,13,87,42,14
69,13,1,12,79,44,13
76,16,2,14,70,42,10
79,12,0,12,67,43,8
81,14,1,13,67,40,11
84,11,1,10,65,41,12
87,11,0,11,64,38,15
90,11,0,11,60,37,14
92,9,0,9,59,36,14
92,8,0,8,59,33,15
92,6,0,6,59,34,16
89,5,0,5,56,35,16
91,4,0,4,56,35,12
89,4,0,4,53,38,8
90,5,0,5,53,36,5
88,5,0,5,53,35,7
89,7,0,7,56,33,7
86,7,0,7,60,31,9
80,7,0,7,67,33,10
72,8,1,7,75,35,9
74,8,1,7,79,35,12
71,8,1,7,79,37,13
58,6,1,5,89,37,10
56,4,0,4,91,40,12
54,5,0,5,89,42,9
55,5,0,5,89,42,6
60,8,1,7,81,45,8
63,7,0,7,76,42,3
65,6,0,6,72,42,6
65,6,0,6,68,41,7
69,5,0,5,62,40,7
72,6,0,6,57,38,6
74,6,0,6,53,38,5
74,5,0,5,53,37,4
72,5,0,5,57,35,7
72,5,0,5,57,34,7
72,6,0,6,56,30,7
72,5,0,5,56,32,10
73,4,0,4,56,30,7
71,5,0,5,57,26,9
66,7,1,6,68,28,16
56,6,1,5,85,32,16
48,4,0,4,102,35,14
39,3,0,3,110,36,15
38,3,0,3,124,39,14
33,3,0,3,133,40,15
30,3,0,3,135,43,16
30,3,0,3,136,46,13
32,3,0,3,140,47,10
42,4,0,4,119,45,12
48,8,0,8,107,42,0
51,18,2,16,98,38,0
54,15,0,15,90,37,3
57,14,0,14,83,32,5
59,15,0,15,79,29,8
61,17,1,16,74,29,7
64,22,1,21,68,27,8
68,11,0,11,68,30,10
69,9,0,9,72,26,7
67,10,0,10,75,26,15
57,8,0,8,74,35,12
54,6,0,6,72,37,11
55,11,0,11,70,37,11
58,15,0,15,71,35,10
56,13,1,12,80,32,12
46,10,1,9,105,32,18
41,7,1,6,116,34,24
38,6,0,6,135,36,20
40,11,1,10,142,35,19
40,11,1,10,145,42,17
39,11,1,10,153,48,17
41,10,1,9,155,51,18
42,10,0,10,142,55,8
46,14,0,14,140,52,5
46,18,0,18,135,50,10
78,10,0,10,90,49,5
78,11,0,11,85,46,1
84,13,0,13,77,45,10
85,14,0,14,75,42,13
84,11,0,11,73,38,12
85,8,0,8,69,39,15
83,7,0,7,64,37,16
85,7,0,7,59,38,10
87,8,0,8,55,28,12
88,12,0,12,53,16,12
88,17,0,17,50,14,16
87,24,1,23,49,7,16
79,26,4,22,59,12,18
63,16,2,14,87,25,22
49,9,1,8,113,23.88931919,12.33428691
43,6,0,6,135,41,21
39,5,0,5,148,42,30
38,5,0,5,154,45,24
36,5,0,5,160,50,26
32,6,0,6,169,52,16
32,6,0,6,170,56,29
33,7,0,7,170,57,17
36,11,0,11,156,57,11
49,10,0,10,141,51,10
52,11,0,11,128,47,9
55,12,0,12,123,44,5
56,16,0,16,120,41,11
59,18,0,18,119,40,15
61,15,0,15,121,46,16
63,17,0,17,121,47,14
65,16,0,16,120,46,18
69,19.6354985,4.376433205,15.25906529,117,44,15
70,11,0,11,114,37,19
68,13,0,13,104,26,18
72,31,1,30,92,3,22
74,48,10,38,85,3,21
71,51,16,35,88,4,20
63,32,7,25,104,10,29
55,26,5,21,134,20,35
51,42,10,32,163,28,42
50,42,9,33,175,36,40
46,18,2,16,184,50,24
45,14,1,13,188,53,19
48,12,1,11,183,57,13
52,13,1,12,179,60,16
57,12,1,11,169,61,11
63,19.64565438,4.376740908,15.26891348,163,56,17
67,15,0,15,158,50,10
68,16,0,16,156,46,14
68,16,0,16,156,45,15
68,18,1,17,155,39,16
68,18,0,18,153,38,17
69,16,0,16,152,46,20
69,11,0,11,149,45,19
73,9,0,9,146,44,16
74,9,0,9,144,40,15
71,9,0,9,143,37,14
72,14,0,14,144,42,15
72,14,0,14,142,41,14
74,13,0,13,137,33,15
72,16,1,15,151,28,15
65,14,1,13,167,33,23
60,11,1,10,181,39,23
59,8,1,7,191,45,19
57,9,1,8,188,42,20
57,8,1,7,191,31,11
52,7,1,6,190,49,16
50,8,1,7,189,45,17
49,9,1,8,194,57,6
55,8,0,8,183,39,17
61,9,0,9,176,35,6
65,10,0,10,172,40,7
72,9,0,9,169,48,6
74,6,0,6,168,34,7
77,5,0,5,167,40,10
79,4,0,4,163,40,11
85,4,0,4,159,45,11
86,4,0,4,158,44,9
86,5,0,5,157,50,11
84,5,0,5,158,34,10
82,5,0,5,161,52,10
86,5,0,5,160,32,11
87,7,0,7,158,31,11
88,8,0,8,160,35,9
86,11,0,11,165,29,12
82,14,1,13,173,33,16
82,15,1,14,172,30,16
79,16,1,15,179,29,13
77,17,2,15,177,24.02406001,14
77,11,1,10,180,30,11
75,9,1,8,188,30,12
79,7,1,6,190,35,11
69,8,1,7,203,34,9
71,8,1,7,195,36,22
81,8,1,7,182,35,7
85,7,0,7,177,33,8
88,9,0,9,173,29,6
88,11,0,11,169,23,5
89,13,1,12,167,21,6
91,12,1,11,165,20,8
93,11,0,11,161,17,9
93,18,1,17,161,14,6
91,16,1,15,163,9,8
93,17,1,16,162,2,9
93,16,1,15,162,3,11
94,15,1,14,164,2,12
95,18,1,17,164,3,8
91,9,0,9,141,14,7
94,5,0,5,128,36,1
94,5,0,5,128,37,0
95,6,0,6,128,35,2
93,7,0,7,132,33,4
94,5,0,5,134,34,3
93,6,0,6,135,36,5
92,6,0,6,139,35,7
92,7,0,7,143,33,10
93,8,0,8,141,33,12
94,9,0,9,146,27,5
92,16,2,14,146,19,9
93,10,0,10,136,26,10
93,13,0,13,137,22,9
93,12,0,12,141,16,11
93,18,1,17,143,12,14
94,24,1,23,142,11,19
95,18,1,17,141,10,19
95,16,1,15,142,10,18
95,14,1,13,143,6,19
95,13,1,12,144,4,23
95,12,1,11,144,6,19
95,12,1,11,145,10,15
95,14,1,13,144,8,13
95,14,1,13,147,7,14
95,14,2,12,145,5,14
96,10,1,9,147,5,15
96,12,2,10,150,9,15
95,9,1,8,151,12,6
96,11,2,9,151,10,9
94,7,1,6,143,18,6
94,5,0,5,145,44,6
92,5,0,5,143,38,5
92,4,0,4,134,40,8
91,5,0,5,133,44,3
87,5,0,5,133,44,5
87,12,2,10,130,44,7
89,10,1,9,125,41,11
89,9,0,9,122,41,10
87,9,0,9,122,41,13
84,8,0,8,123,43,15
84,7,0,7,121,42,14
84,5,0,5,117,39,13
76,4,0,4,106,38,14
69,4,0,4,96,35,11
60,4,0,4,85,37,10
57,4,0,4,76,36,12
58,6,0,6,70,34,8
54,10,0,10,67,32,9
49,13,1,12,77,31,7
44,12,2,10,94,33,14
39,7,1,6,109,33,17
34,5,0,5,120,34,19
30,4,0,4,139,35,18
32,5,0,5,140,37,20
24,5,0,5,147,37,14
28,5,0,5,149,40,11
28,9,0,9,147,39,8
35,9,0,9,134,41,10
38,7,0,7,125,41,4
40,8,0,8,118,39,7
45,10,0,10,111,35,5
48,14,0,14,106,31,4
54,37,3,34,100,25,6
58,35,2,33,93,13,12
61,28,1,27,88,16,16
62,25,1,24,85,21,14
64,24,1,23,82,15,15
66,21,1,20,78,25,13
66,18,0,18,78,22,12
67,18,0,18,81,23,15
66,17,0,17,84,22,13
69,17,0,17,85,14,14
67,22,2,20,83,2,14
77,33,6,27,76,4,19
86,41,11,30,72,24.0397974,17
91,36,10,26,74,7,12
92,35,9,26,76,10,14
94,36,8,28,81,8,16
96,41,11,30,87,4,15
96,40,10,30,93,6,16
96,43,11,32,97,5,15
96,38,7,31,102,5,11
97,21,2,19,102,7,7
98,9,0,9,109,10,6
97,8,0,8,113,28,5
97,8,0,8,108,30,3
97,9,0,9,103,18,1
93,9,0,9,104,31,0
90,8,0,8,107,30,1
90,8,0,8,106,27,2
92,9,0,9,100,22,2
92,19.52685777,4.319980285,15.20687748,100,17,1
92,14,0,14,100,13,0
84,19,1,18,107,8,4
82,26,2,24,107,13,5
75,35,4,31,116,8,1
69,30,5,25,126,15,4
53,22,5,17,154,22,3
44,10,2,8,173,32,7
40,7,1,6,182,38,8
33,5,0,5,193,41,5
30,5,0,5,202,42,6
29,5,0,5,205,44,10
28,5,0,5,204,44,0
28,6,0,6,206,46,6
28,6,0,6,198,46,6
28,7,0,7,183,45,0
29,8,0,8,168,44,0
31,8,0,8,155,46,1
32,8,0,8,142,45,1
33,8,0,8,134,46,5
45,7,0,7,120,43,7
39,6,0,6,113,43,6
35,5,0,5,109,44,7
45,5,0,5,106,42,11
58,3,0,3,99,42,11
52,3,0,3,92,43,12
55,3,0,3,89,41,11
58,4,0,4,82,39,8
59,9,0,9,79,31,8
53,14,1,13,90,31,11
41,10,1,9,105,34,20
38,8,1,7,126,35,20
36,14,2,12,137,36,19
38,12,1,11,146,36,19
35,18,2,16,154,34,18
44,19.49276139,4.306858946,15.18590245,154,37,21
43,13,1,12,165,43,6
45,11,1,10,171,47,24
47,10,1,9,166,48,5
42,9,0,9,160,49,17
42,11,0,11,155,49,10
44,19,0,19,151,45,8
46,33,1,32,147,33,9
49,49,5,44,139,17,17
38,11,0,11,126,38,16
39,9,0,9,116,39,7
40,10,0,10,109,38,7
41,11,0,11,104,34,6
46,10,0,10,98,20,8
50,18,0,18,94,8,8
52,20,0,20,89,3,14
57,22,1,21,79,6,10
59,31,3,28,76,6,13
57,32,7,25,87,4,16
49,30,8,22,104,9,30
45,28,7,21,136,18,30
39,30,6,24,166,26,30
38,20,3,17,179,30,31
36,22,3,19,184,36,29
31,15,1,14,198,41,11
19,12,1,11,209,45,22
27,23,4,19,207,48,9
40,13,1,12,195,63,16
45,16,0,16,191,67,18
52,16,0,16,177,62,13
58,17,0,17,171,61,16
57,16,1,15,169,62,18
58,15,1,14,166,57,20
53,16,0,16,166,50,24
48,18,0,18,171,53,27
43,14,0,14,172,58,26
49,12,0,12,169,60,28
52,9,0,9,171,63,25
54,9,0,9,169,63,21
51,8,0,8,174,62,20
55,8,0,8,173,63,21
61,13,0,13,168,54,20
60,17,1,16,178,51,19
52,14,1,13,190,48,20
52,16,2,14,199,48,25
48,15,2,13,205,43,27
53,11,1,10,207,42,7
54,8,1,7,206,48,24
53,8,1,7,212,45,3
56,9,1,8,208,47,25
63,10,1,9,201,46,7
58,12,1,11,206,42,17
48,17,1,16,215,43,25
45,19,0,19,213,49,26
53,21,1,20,198,44,11
53,32,1,31,195,33,14
61,39,2,37,180,20,17
64,43,2,41,175,12,19
65,46,3,43,168,4,16
67,36,2,34,162,6,19
69,26,1,25,161,15,19
71,26,1,25,156,13,16
72,24,1,23,152,5,19
73,24,1,23,145,2,18
77,25,2,23,139,1,15
58,25,4,21,136,3,18
52,33,9,24,144,21,18
48,15,2,13,158,29,25
39,15,2,13,195,33,30
32,13,1,12,222,42,41
32,17,1,16,242,48,24
27,23,1,22,240,58,29
29,11,1,10,242,53,19
20,8,0,8,251,54,16
30,8,0,8,245,56,14
35,9,0,9,247,54,19
39,10,0,10,231,54,19
48,21,1,20,218,52,16
55,25,1,24,203,47,5
60,24,1,23,193,41,18
63,27,1,26,188,38,14
67,25,1,24,182,33,20
69,27,1,26,179,21,18
70,30,1,29,176,13,23
54,30,1,29,184,10,24
50,34,2,32,180,13,27
51,34,2,32,173,14,24
59,39,2,37,169,9,21
64,36,2,34,163,5,21
72,39,7,32,164,1,19
67,49,13,36,173,3,22
46,55,18,37,192,8,28
39,37,9,28,216,24.17903571,41
30,26,3,23,232,25,34
29,19.50796493,4.282002285,15.22596265,252,33,21
28,12,1,11,259,46,21
33,7,0,7,236,57,22
40,7,0,7,219,59,14
46,7,0,7,212,61,14
51,7,0,7,207,55,26
67,8,0,8,199,47,14
84,16,2,14,183,34,27
89,14,0,14,172,28,9
90,11,0,11,162,34,5
91,12,0,12,162,33,6
89,12,0,12,162,33,6
90,6,0,6,167,32,8
92,4,0,4,158,33,9
94,3,0,3,157,36,5
95,3,0,3,166,33,4
93,6,0,6,188,28,6
94,5,0,5,184,23,8
91,5,0,5,184,18,6
93,5,0,5,181,17,6
92,6,0,6,184,15,6
91,6,1,5,185,12,4
85,9,2,7,196,16,8
77,9,2,7,211,20,17
68,12,2,10,229,30,25
66,12,2,10,226,27,26
60,8,1,7,225,29,17
59,10,1,9,222,33,11
57,14,1,13,222,35,9
53,15,1,14,223,35,14
51,18,1,17,221,37,9
54,22,1,21,209,36,9
62,21,1,20,196,40,7
68,7,0,7,183,42,9
66,7,0,7,176,43,0
65,7,0,7,172,47,7
64,8,0,8,167,46,7
67,9,0,9,163,41,7
68,9,0,9,162,41,6
69,9,0,9,159,30,8
72,15,0,15,156,22,9
75,22,1,21,152,20,8
75,22,1,21,150,22,9
71,19,1,18,155,28,8
71,21,2,19,163,33,13
63,21,3,18,177,24,19
48,24,4,20,209,28,25
49,20,3,17,218,33,32
45,24,4,20,223,27,16
35,15,2,13,234,38,11
33,8,0,8,248,47,23
18,6,0,6,253,50,17
20,5,0,5,240,47,7
19,5,0,5,227,47,1
22,5,0,5,203,46,0
30,5,0,5,173,45,2
32,5,0,5,158,44,0
34,5,0,5,148,44,0
32,6,0,6,147,43,5
33,5,0,5,142,44,6
37,5,0,5,136,44,7
39,5,0,5,132,42,8
38,5,0,5,129,43,9
39,4,0,4,125,43,9
41,4,0,4,122,43,8
41,3,0,3,121,43,11
40,5,0,5,122,43,9
40,7,0,7,124,38,9
37,8,0,8,137,36,16
36,9,1,8,149,38,15
33,8,1,7,167,38,19
31,7,0,7,182,40,17
29,6,0,6,195,40,19
26,6,0,6,201,43,24
26,10,0,10,199,47,15
27,12,0,12,200,54,4
35,11,0,11,196,52,12
43,9,0,9,180,51,14
46,11,0,11,177,53,3
54,10,0,10,168,50,0
55,9,0,9,164,46,7
58,7,0,7,159,43,2
60,7,0,7,156,43,2
61,8,0,8,154,43,3
64,8,0,8,152,41,5
65,8,0,8,148,39,4
66,10,0,10,145,37,5
67,7,0,7,145,34,4
68,6,0,6,145,39,7
68,7,0,7,146,34,5
69,11,0,11,145,27,8
71,15,0,15,144,17,7
70,19,1,18,146,10,10
66,22,2,20,153,23,8
66,17,1,16,156,21,11
65,9,0,9,160,16,10
64,18,2,16,164,23,13
59,25,4,21,176,26,15
53,21,3,18,185,32,25
49,20,2,18,193,36,31
50,24,2,22,189,38,13
53,36,1,35,188,35,20
53,43,3,40,186,30,19
55,38,1,37,178,34,27
59,26,0,26,173,41,14
66,34,1,33,167,32,16
72,37,1,36,161,24,17
77,34,1,33,158,18,16
79,34,2,32,156,10,18
75,43,5,38,156,7,19
77,41,5,36,153,11,23
82,32,2,30,143,4,23
87,17,1,16,140,16,19
87,11,0,11,140,20,16
86,10,0,10,140,11,15
81,15,1,14,140,11,16
72,14,1,13,144,17,19
62,14,1,13,150,34,21
61,10,0,10,151,44,22
59,10,0,10,156,42,17
55,8,0,8,164,44,18
49,7,0,7,174,46,22
43,6,0,6,180,50,25
46,6,0,6,182,56,33
47,5,0,5,179,59,11
49,6,0,6,177,58,24
58,7,0,7,167,55,5
59,13,1,12,159,53,12
69,8,0,8,151,54,11
77,7,0,7,138,52,12
84,6,0,6,127,45,10
76,7,0,7,119,38,7
80,5,0,5,111,44,11
87,6,0,6,110,40,6
81,4,0,4,107,39,9
76,4,0,4,106,39,9
72,4,0,4,106,37,7
77,5,0,5,108,36,6
81,5,0,5,106,34,9
81,6,0,6,108,32,8
77,9,1,8,114,31,10
65,5,0,5,125,34,18
41,5,0,5,139,35,17
39,4,0,4,155,38,11
34,4,0,4,161,38,14
33,4,0,4,172,40,11
29,4,0,4,177,42,18
29,3,0,3,187,44,10
27,3,0,3,193,47,12
36,3,0,3,197,48,12
43,5,0,5,160,47,5
43,8,0,8,151,47,0
45,11,1,10,142,44,1
50,9,0,9,134,41,0
53,10,0,10,129,38,2
53,12,0,12,128,37,3
53,11,0,11,127,34,4
54,8,0,8,128,38,8
54,6,0,6,129,35,6
54,19.36995801,4.218804995,15.15115301,130,37,7
53,7,0,7,129,36,7
66,6,0,6,118,31,5
72,8,0,8,109,27,3
75,14,1,13,109,24,4
71,13,1,12,119,26,8
61,10,1,9,134,26,9
51,7,1,6,148,30,13
48,5,0,5,156,24.39209461,13
48,19.36084412,4.215613572,15.14523055,165,37,16
44,6,0,6,176,37,21
42,7,0,7,176,43,22
39,8,0,8,186,49,2
40,7,0,7,189,56,30
48,7,0,7,180,55,18
52,5,0,5,169,44,15
54,6,0,6,163,44,0
56,8,0,8,152,42,5
59,7,0,7,145,40,2
61,9,0,9,146,41,5
63,14,0,14,144,37,7
64,16,0,16,142,39,10
66,18,0,18,139,30,7
68,17,0,17,135,18,13
68,16,0,16,132,21,12
71,15,0,15,131,24,13
73,15,0,15,130,22,10
74,17,0,17,128,19,12
74,21,1,20,130,13,13
59,25,3,22,146,25,16
51,17,2,15,158,37,20
48,10,1,9,170,39,17
44,8,1,7,178,39,17
40,8,1,7,187,42,15
36,8,1,7,192,46,4
36,5,0,5,196,46,9
35,5,0,5,203,45,15
34,5,0,5,205,46,7
35,5,0,5,197,47,7
41,6,0,6,184,44,0
55,6,0,6,169,44,6
60,8,0,8,164,44,0
63,7,0,7,162,45,1
69,7,0,7,159,44,4
70,7,0,7,158,41,5
69,7,0,7,158,41,4
68,9,0,9,157,45,3
68,6,0,6,156,43,4
69,8,0,8,155,44,4
70,9,0,9,153,43,4
70,10,0,10,153,40,1
79,11,0,11,151,41,4
79,13,0,13,153,27,7
74,16,1,15,162,29,9
72,18,2,16,167,28,13
71,12,1,11,170,35,12
69,8,1,7,176,37,8
71,8,1,7,175,38,9
71,7,0,7,176,39,8
71,5,0,5,181,39,5
71,7,1,6,181,40,9
71,6,0,6,182,40,11
68,10,1,9,184,36,9
68,9,0,9,179,38,7
74,12,0,12,173,40,6
78,9,0,9,167,38,5
78,8,0,8,168,37,4
79,7,0,7,168,34,7
73,9,0,9,169,30,6
70,12,0,12,171,31,7
60,12,0,12,175,33,11
61,12,0,12,177,40,9
65,10,0,10,173,37,8
70,11,0,11,163,23,9
76,15,0,15,155,22,13
84,22,1,21,147,10,15
87,11,0,11,139,19,13
86,7,0,7,131,41,2
89,7,0,7,127,42,0
84,7,0,7,129,41,2
70,7,1,6,136,40,5
59,5,0,5,152,39,8
55,5,0,5,162,42,10
49,4,0,4,175,43,13
47,4,0,4,177,47,15
46,4,0,4,184,49,12
45,5,0,5,181,51,3
45,5,0,5,173,50,12
56,8,0,8,159,50,5
60,10,0,10,151,47,6
67,13,0,13,150,40,2
63,14,0,14,144,42,10
62,12,0,12,144,47,7
65,10,0,10,143,45,6
64,13,0,13,145,34,9
65,15,0,15,145,40,12
68,15,0,15,144,39,13
67,17,0,17,146,41,8
68,17,0,17,145,40,9
52,18,0,18,130,26,9
59,24,1,23,122,12,6
60,25,3,22,124,12,10
56,26,6,20,136,10,13
51,24,6,18,160,17,22
50,17,2,15,176,31,27
49,13,1,12,185,36,32
46,12,1,11,194,40,23
39,10,0,10,212,46,11
47,7,0,7,200,48,15
57,10,1,9,192,45,2
53,9,1,8,200,47,0
57,7,0,7,190,47,19
43,8,0,8,186,50,1
42,13,0,13,178,44,9
67,11,0,11,164,46,10
76,8,1,7,152,49,4
74,7,0,7,145,45,1
72,6,0,6,142,42,5
73,6,0,6,138,42,5
71,8,0,8,132,36,7
74,9,0,9,128,32,8
77,10,0,10,124,29,12
78,10,0,10,120,26,10
79,10,0,10,118,26,12
80,17,2,15,120,18,15
76,16,2,14,131,24,17
66,9,1,8,147,31,23
58,10,1,9,168,37,26
49,13,1,12,186,41,32
44,15,1,14,192,49,22
46,13,1,12,201,52,15
46,12,1,11,207,54,25
43,14,1,13,211,55,20
41,12,0,12,220,60,20
46,10,0,10,213,62,15
41,13,0,13,216,56,9
44,11,0,11,191,56,29
63,5,0,5,153,57,0
69,7,0,7,153,56,1
73,10,0,10,148,55,7
68,10,0,10,145,51,9
68,13,0,13,142,50,9
73,13,0,13,141,44,10
74,14,0,14,136,32,14
74,13,0,13,136,34,12
76,17,1,16,132,29,12
76,18,1,17,130,21,14
82,16,1,15,123,15,14
78,15,2,13,123,14,13
69,14,2,12,127,19,15
61,13,2,11,148,22,22
51,16,3,13,178,29,30
39,18,2,16,206,40,33
31,14,1,13,215,49,19
33,8,0,8,223,56,17
34,10,0,10,230,62,17
39,9,0,9,230,65,19
25,6,0,6,225,61,19
46,6,0,6,214,66,12
48,11,0,11,211,69,13
54,12,0,12,206,69,15
54,14,0,14,200,61,7
56,12,0,12,198,58,20
58,16,0,16,197,55,20
59,18,0,18,196,52,23
59,23,1,22,193,47,24
60,21,1,20,188,38,27
61,19,1,18,182,26,25
66,19.22520301,4.152954892,15.07224812,173,11,25
75,21,1,20,171,10,24
73,21,1,20,160,7,23
76,36,2,34,152,3,26
75,39,8,31,153,5,25
68,38,9,29,165,6,29
52,33,6,27,186,22,39
44,47,12,35,207,27,36
39,22,3,19,230,24.63980461,25
37,19.23607744,4.153879693,15.08219775,242,48,28
35,11,0,11,247,58,29
38,9,0,9,248,64,24
69,10,0,10,176,65,28
68,7,0,7,167,58,0
79,8,0,8,163,54,0
73,9,0,9,169,49,8
65,15,0,15,178,48,16
72,28,2,26,173,47,9
72,14,0,14,166,46,8
75,13,0,13,161,41,8
77,16,0,16,156,37,10
61,11,0,11,149,33,10
56,8,0,8,142,33,8
56,10,0,10,134,31,6
53,9,0,9,129,27,6
49,10,0,10,125,27,4
47,11,0,11,125,31,8
50,20,1,19,123,13,6
51,25,5,20,122,4,8
45,20,3,17,132,20,13
33,9,1,8,152,30,15
31,7,1,6,165,36,8
28,6,0,6,181,34,7
26,6,0,6,191,34,11
20,5,0,5,201,37,18
22,4,0,4,209,40,10
21,5,0,5,221,43,11
21,5,0,5,224,47,10
19,4,0,4,233,47,10
29,5,0,5,218,49,6
39,8,0,8,191,50,7
44,7,0,7,177,47,0
48,6,0,6,168,44,0
53,8,0,8,165,42,6
53,11,0,11,161,46,5
56,10,0,10,158,44,2
59,12,0,12,155,38,3
61,16,0,16,153,38,5
64,13,0,13,152,35,5
67,13,0,13,149,33,5
73,13,0,13,147,26,6
75,18,1,17,145,25,9
76,18,2,16,146,23,9
64,16,2,14,153,21,11
57,15,2,13,167,25,18
45,15,2,13,189,37,23
52,22,3,19,194,38,19
50,19,3,16,205,34,2
38,10,1,9,211,43,19
27,6,0,6,217,51,1
29,5,0,5,221,49,11
29,5,0,5,217,50,7
32,4,0,4,204,53,9
41,5,0,5,191,49,0
54,6,0,6,180,45,2
59,8,0,8,176,43,2
62,7,0,7,174,44,2
64,6,0,6,172,44,3
65,8,0,8,169,46,3
65,7,0,7,169,46,1
63,5,0,5,167,46,5
65,5,0,5,164,45,3
67,4,0,4,162,41,4
69,4,0,4,160,42,2
69,5,0,5,158,40,3
71,4,0,4,158,40,6
71,4,0,4,161,39,7
68,6,0,6,167,38,9
59,6,0,6,180,37,11
54,7,1,6,193,36,21
46,5,0,5,195,43,22
42,5,0,5,211,42,6
47,5,0,5,213,44,13
41,4,0,4,220,44,10
41,3,0,3,221,46,7
43,3,0,3,217,46,6
40,3,0,3,222,48,12
47,4,0,4,207,48,5
50,6,0,6,201,48,8
59,6,0,6,193,47,0
65,9,0,9,185,44,5
68,7,0,7,179,48,6
71,5,0,5,175,45,9
74,7,0,7,172,42,10
76,5,0,5,169,40,9
78,4,0,4,167,40,8
81,5,0,5,166,40,10
83,6,0,6,165,37,8
84,9,0,9,164,43,9
85,7,0,7,163,39,9
85,8,0,8,165,34,8
78,11,1,10,175,30,18
72,10,1,9,185,32,29
61,11,1,10,201,37,32
56,11,1,10,216,38,20
46,5,0,5,225,42,24
42,4,0,4,236,44,18
41,3,0,3,238,42,14
40,3,0,3,245,44,14
42,4,0,4,251,53,14
42,5,0,5,259,62,13
50,8,0,8,238,60,13
51,11,0,11,231,56,12
59,7,0,7,219,40,0
66,12,0,12,209,33,0
75,10,0,10,197,33,0
81,11,0,11,187,34,6
83,13,0,13,182,33,5
86,8,0,8,177,31,7
85,6,0,6,178,31,18
86,8,0,8,176,27,17
88,11,0,11,174,23,17
87,8,0,8,176,27,16
86,8,0,8,174,28,8
85,9,0,9,178,27,11
80,14,2,12,187,24,15
71,18,3,15,203,25,27
62,16,3,13,222,31,32
56,25,4,21,235,28,19
64,11,1,10,234,34,19
63,7,1,6,240,34,15
60,7,1,6,247,36,13
61,7,1,6,254,34,9
61,10,2,8,251,35,13
62,8,1,7,246,34,11
66,7,1,6,239,33,6
69,10,1,9,233,32,7
74,12,1,11,223,29,3
75,15,1,14,221,25,0
77,17,1,16,217,20,9
79,15,1,14,213,19,13
80,12,0,12,212,20,6
81,12,0,12,209,20,18
82,13,0,13,207,19,7
85,15,1,14,204,13,17
84,17,1,16,204,13,12
86,19,1,18,200,9,6
80,10,0,10,199,15,13
86,5,0,5,193,28,7
77,5,0,5,188,29,17
71,4,0,4,193,32,5
65,4,0,4,202,34,12.33984952
56,4,0,4,218,33,12.33984952
54,4,0,4,229,34,28
53,6,0,6,230,38,20
52,6,0,6,239,45,24
50,3,0,3,238,51,26
46,3,0,3,236,49,19
49,3,0,3,231,49,17
57,3,0,3,221,46,16
58,3,0,3,211,48,7
54,4,0,4,207,51,23
52,5,0,5,195,51,18
66,5,0,5,178,51,27
61,5,0,5,170,48,19
58,5,0,5,165,46,15
55,6,0,6,165,45,21
58,7,0,7,164,42,19
62,19.06483688,4.092286472,14.9725504,164,38,20
69,11,0,11,163,34,17
66,11,0,11,162,31,21
64,19,1,18,159,26,22
68,31,9,22,159,21,23
68,30,7,23,164,10,30
60,24,4,20,181,13,33
50,25,4,21,212,21,0
45,33,5,28,231,24.86452788,30
41,19.06809649,4.092002946,14.97609354,245,29,35
32,19,1,18,253,46,33
28,11,0,11,262,59,29
28,12,0,12,273,64,32
28,10,0,10,268,72,32
29,10,0,10,267,72,30
34,18,0,18,260,68,34
40,22,0,22,247,65,32
49,25,0,25,232,59,28
49,22,0,22,224,48,28
52,23,1,22,220,53,26
38,21,1,20,218,49,36
32,8,0,8,216,50,28
48,6,0,6,208,53,16
60,5,0,5,197,64,25
61,6,0,6,188,58,17
58,8,0,8,185,47,22
57,9,0,9,182,39,24
60,8,0,8,176,42,16
61,9,0,9,172,41,13
55,7,0,7,177,40,9
47,5,0,5,185,41,11
43,5,0,5,195,37,11
40,4,0,4,202,36,14
39,6,0,6,207,38,18
37,6,0,6,213,40,9
38,6,0,6,219,42,20
33,6,0,6,225,45,15
38,10,0,10,227,47,15
37,10,0,10,219,44,12
42,14,1,13,211,48,3
46,11,0,11,207,43,4
52,13,0,13,203,39,8
50,11,0,11,200,30,16
48,10,0,10,196,35,2
52,10,0,10,193,40,13
55,9,0,9,190,36,11
64,9,0,9,186,33,8
73,9,0,9,175,31,7
81,8,0,8,170,31,3
87,7,0,7,168,26,6
90,8,0,8,167,22,10
90,12,0,12,168,15,13
90,19,1,18,166,21,11
89,19,1,18,165,27,12
90,15,1,14,167,28,13
85,12,1,11,168,27,15
84,8,1,7,171,39,14
87,7,0,7,167,40,14
85,8,0,8,171,36,11
86,7,0,7,170,38,13
86,6,0,6,172,43,7
86,9,0,9,173,40,5
90,6,0,6,171,39,8
92,7,0,7,166,42,4
90,8,0,8,168,38,0
90,10,0,10,169,39,7
90,9,0,9,168,36,9
90,10,0,10,170,30,7
88,9,0,9,169,36,8
89,10,0,10,169,31,9
89,9,0,9,170,26,7
89,10,0,10,172,21,6
89,11,0,11,172,14,8
89,13,0,13,171,11,14
90,14,0,14,168,7,14
90,16,1,15,167,4,10
91,27,8,19,166,3,14
87,27,8,19,175,8,15
75,18,4,14,190,18,31
66,18,4,14,214,23,20
57,21,4,17,231,27,15
46,16,2,14,248,32,16
42,10,1,9,257,44,13
45,10,0,10,261,53,15
47,20,0,20,255,59,16
42,21,1,20,263,58,9
44,19,0,19,256,63,11
44,16,0,16,254,56,8
46,21,2,19,247,53,8
46,30,1,29,242,49,9
56,32,1,31,231,30,5
60,30,1,29,224,19,23
66,27,1,26,217,16,24
77,15,1,14,210,28,28
82,9,0,9,200,35,14
85,7,0,7,192,34,25
87,8,0,8,188,35,11
87,7,0,7,185,35,18
87,6,0,6,183,33,13
86,7,0,7,185,40,18
82,7,0,7,187,39,18
81,7,0,7,192,42,18
73,6,0,6,205,41,24
65,7,1,6,225,43,24
58,9,1,8,240,45,20
50,6,0,6,253,47,19
45,6,0,6,267,51,21
41,6,0,6,276,55,17
48,16,3,13,277,57,19
51,5,0,5,264,54,16
57,5,0,5,246,53,14
62,5,0,5,232,49,5
66,4,0,4,220,48,0
71,7,0,7,215,47,3
74,4,0,4,211,48,10
76,4,0,4,210,52,13
77,4,0,4,208,53,22
79,3,0,3,206,55,11
82,3,0,3,205,54,18
85,3,0,3,202,49,19
84,4,0,4,201,45,8
85,5,0,5,200,40,14
85,5,0,5,200,38,13
85,4,0,4,199,44,18
87,4,0,4,199,47,22
89,7,0,7,199,44,29
78,12,0,12,191,51,31
83,9,0,9,194,55,30
84,10,0,10,196,52,35
88,6,0,6,195,50,31
88,5,0,5,178,48,20
91,5,0,5,178,48,15
92,7,0,7,177,46,16
91,5,0,5,169,50,18
93,5,0,5,169,54,17
94,4,0,4,172,52,14
94,4,0,4,172,52,20
95,4,0,4,170,50,16
95,6,0,6,167,50,11
93,4,0,4,166,53,5
90,3,0,3,167,51,4
90,3,0,3,170,49,3
88,4,0,4,171,43,3
86,4,0,4,172,41,3
86,4,0,4,173,39,4
84,4,0,4,173,39,4
82,3,0,3,172,43,1
82,3,0,3,172,40,0
82,3,0,3,171,37,0
79,3,0,3,172,36,3
77,3,0,3,175,37,0
75,3,0,3,178,39,4
74,3,0,3,183,38,4
70,2,0,2,189,36,7
69,3,0,3,191,37,13
64,2,0,2,198,38,0
67,2,0,2,196,42,9
65,2,0,2,197,43,0
64,2,0,2,197,43,3
66,2,0,2,195,42,1
69,3,0,3,189,42,0
74,5,0,5,181,43,2
78,5,0,5,172,42,0
81,5,0,5,166,42,3
82,4,0,4,164,41,2
82,3,0,3,162,39,4
83,3,0,3,160,41,1
84,2,0,2,160,42,2
83,18.90809249,4.031644745,14.87644774,160,40,2
84,2,0,2,160,40,2
84,2,0,2,160,38,1
84,3,0,3,159,37,5
89,4,0,4,159,35,5
90,5,0,5,160,30,6
90,5,0,5,160,30,5
86,6,0,6,164,28,6
81,5,0,5,171,25.1396041,8
75,18.89595482,4.028362315,14.8675925,180,25,9
70,17,3,14,191,28,30
67,15,2,13,199,29,39
64,12,1,11,207,36,23
68,12,1,11,204,38,20
69,12,1,11,208,36,7
73,15,2,13,203,37,17
77,9,0,9,198,41,0
79,8,0,8,199,38,9
81,9,0,9,199,35,5
80,11,0,11,199,31,11
81,10,0,10,187,28,11
84,7,0,7,180,31,5
86,5,0,5,179,33,6
87,4,0,4,177,34,9
89,3,0,3,174,36,9
90,2,0,2,171,37,10
86,4,0,4,172,37,12
81,4,0,4,169,35,14
79,6,0,6,168,31,10
73,7,0,7,172,28,10
58,8,1,7,187,29,11
57,8,1,7,196,35,25
51,7,1,6,206,34,18
51,8,1,7,219,39,11
48,6,0,6,222,45,17
46,5,0,5,228,47,18
45,6,0,6,228,53,14
51,7,0,7,226,54,20
51,6,0,6,212,51,12
47,8,0,8,202,48,0
50,7,0,7,194,45,9
52,11,0,11,192,44,1
58,11,0,11,187,42,13
64,8,0,8,183,40,1
70,8,0,8,181,36,11
74,9,0,9,180,33,7
76,8,0,8,179,35,12
77,8,0,8,178,38,10
78,8,0,8,174,34,8
77,8,0,8,172,33,7
78,6,0,6,170,35,10
71,5,0,5,166,36,11
69,5,0,5,164,36,8
68,5,0,5,168,35,5
63,5,0,5,172,34,8
60,4,0,4,177,31,10
61,4,0,4,178,32,9
58,4,0,4,184,32,8
56,4,0,4,193,32,10
54,4,0,4,189,35,5
55,5,0,5,187,33,2
55,5,0,5,190,34,10
56,4,0,4,184,39,5
57,5,0,5,179,39,0
58,7,0,7,174,41,4
59,10,1,9,171,39,3
62,8,0,8,170,36,3
59,9,0,9,167,34,3
65,12,0,12,163,31,4
62,11,0,11,160,29,5
66,15,0,15,159,22,6
72,15,0,15,161,20,7
76,14,0,14,163,21,10
79,13,0,13,166,20,8
80,13,0,13,166,18,11
80,17,1,16,166,15,10
80,19,2,17,166,13,9
75,20,3,17,174,14,12
68,10,1,9,185,18,13
61,8,1,7,202,28,24
58,7,1,6,207,37,18
63,5,0,5,206,37,11
60,5,0,5,216,34,2
56,4,0,4,221,37,14
52,4,0,4,232,41,19
62,4,0,4,218,45,14
61,6,0,6,207,44,0
66,5,0,5,209,44,8
63,6,0,6,202,42,9
65,6,0,6,197,42,0
68,10,1,9,192,40,5
70,8,0,8,187,33,4
71,10,0,10,184,30,5
76,14,0,14,182,24,6
77,17,1,16,179,13,7
79,21,1,20,175,4,7
82,22,1,21,172,2,9
82,23,3,20,168,1,13
83,20,2,18,165,1,12
84,20,3,17,164,1,11
84,23,6,17,164,1,10
81,24,5,19,177,3,15
71,23,5,18,197,8,33
63,23,5,18,209,20,38
54,14,1,13,227,33,18
47,20,1,19,241,43,23
41,16,1,15,246,53,21
42,12,0,12,253,64,21
37,9,0,9,261,66,30
37,9,0,9,263,63,22
37,10,0,10,258,65,19
45,13,0,13,247,65,18
52,12,0,12,233,63,16
57,10,0,10,217,59,5
70,11,0,11,207,67,0
75,10,0,10,202,72,20
77,8,0,8,198,73,7
68,8,0,8,196,71,20
76,9,0,9,193,66,15
82,8,0,8,191,65,18
83,6,0,6,190,59,20
84,6,0,6,188,52,20
83,8,0,8,187,42,21
84,10,0,10,185,28,21
79,17,1,16,184,17,25
73,22,2,20,195,23,25
67,18,2,16,211,32,37
56,13,1,12,233,48,31
48,14,1,13,252,55,32
43,9,0,9,270,67,33
42,14,0,14,283,73,30
37,19,0,19,288,76,24
32,12,0,12,292,89,21
34,13,0,13,287,88,26
40,14,0,14,283,82,25
51,15,0,15,264,72,23
58,12,0,12,250,55,25
57,15,0,15,238,46,19
66,12,0,12,226,46,9
73,17,1,16,219,35,13
73,23,0,23,215,24,24
80,14,0,14,208,37,31
81,14,0,14,204,42,18
81,11,0,11,207,32,23
81,13,0,13,204,21,30
81,19,0,19,203,15,31
81,19,1,18,201,12,28
82,19,1,18,199,8,37
82,19,2,17,202,11,30
78,24,3,21,213,15,43
70,23,3,20,228,26,45
58,20,2,18,252,42,40
47,16,1,15,274,55,37
45,15,0,15,292,70,34
40,19,1,18,298,63,30
33,10,0,10,303,79,30
26,8,0,8,305,78,28
24,7,0,7,313,73,22
33,6,0,6,303,75,24
43,11,0,11,285,65,24
48,13,0,13,264,53,21
51,13,0,13,245,47,18
61,14,0,14,233,41,7
70,12,0,12,225,41,5
72,14,0,14,221,36,19
69,13,0,13,220,38,14
74,16,0,16,215,38,10
74,15,0,15,212,37,20
75,18.77401582,3.972830893,14.80118493,211,32,5
78,9,0,9,207,33,23
79,9,0,9,206,32,16
82,10,0,10,204,28,18
78,12,1,11,209,27,17
73,26,3,23,218,23,30
64,30,5,25,236,21,31
59,40,8,32,252,22,30
56,31,4,27,260,25.36493044,30
48,18.77569762,3.971751981,14.80394564,273,41,27
44,17,1,16,271,49,26
49,10,1,9,266,45,15
51,7,0,7,264,44,10
53,6,0,6,266,43,11
52,7,0,7,258,44,11
56,7,0,7,249,43,14
62,8,0,8,233,40,14
63,10,0,10,226,39,0
69,14,0,14,220,38,2
71,10,0,10,216,35,10
70,10,0,10,214,31,12
71,10,0,10,210,32,15
68,9,0,9,208,34,2
70,9,0,9,206,33,12
71,7,0,7,204,32,10
73,7,0,7,203,33,7
75,7,0,7,201,31,4
76,9,0,9,199,26,12
72,12,0,12,204,19,10
67,19,2,17,216,20,21
64,23,4,19,229,22,27
57,24,5,19,243,25,18
56,18,3,15,248,29,19
53,10,1,9,253,33,12
51,8,1,7,254,35,9
48,6,0,6,258,39,13
49,6,0,6,255,41,9
49,6,0,6,254,40,6
50,5,0,5,247,40,7
55,7,0,7,236,39,6
60,6,0,6,225,40,0
66,10,0,10,220,41,0
68,9,0,9,217,41,7
72,9,0,9,213,39,0
72,6,0,6,212,37,6
73,5,0,5,210,35,0
78,5,0,5,206,33,7
80,5,0,5,204,27,8
80,5,0,5,203,29,5
80,7,0,7,202,29,7
84,6,0,6,201,29,0
85,9,0,9,200,23,8
83,14,1,13,206,21,9
79,18,2,16,212,19,12
74,16,2,14,219,24,19
66,9,1,8,233,28,5
62,13,2,11,241,31,20
58,8,1,7,242,39,11
57,7,0,7,246,38,8
55,5,0,5,249,39,8
49,5,0,5,254,39,7
53,7,0,7,252,41,14
55,8,0,8,242,39,6
54,7,0,7,237,34,0
65,11,0,11,235,28,0
68,9,0,9,227,30,7
71,13,0,13,225,32,0
76,15,0,15,222,28,2
77,18,0,18,221,18,13
79,19,0,19,221,20,2
81,11,0,11,218,20,15
80,13,0,13,218,19,0
81,11,0,11,217,21,12
84,8,0,8,216,19,2
87,8,0,8,214,16,0
87,14,1,13,215,13,13
88,14,1,13,214,10,0
89,20,4,16,215,8,12
89,11,1,10,217,12,5
87,10,1,9,220,14,11
84,11,2,9,221,15,10
85,7,1,6,219,16,11
80,9,1,8,225,21,10
70,8,1,7,232,27,11
73,8,0,8,222,31,18
73,7,0,7,217,32,7
72,8,0,8,214,34,17
74,10,1,9,217,36,7
74,10,1,9,215,30,11
77,12,1,11,213,31,10
78,7,0,7,205,34,8
80,6,0,6,198,35,14
81,5,0,5,193,40,6
83,4,0,4,191,40,10
84,5,0,5,188,38,11
82,3,0,3,188,38,11
83,5,0,5,186,35,9
83,3,0,3,186,34,9
86,2,0,2,183,34,10
86,3,0,3,182,35,7
90,4,0,4,180,32,9
92,9,0,9,179,28,6
93,8,0,8,181,27,7
92,9,0,9,181,29,9
93,9,0,9,184,26,4
94,9,0,9,185,26,5
93,10,1,9,189,27,4
92,10,1,9,191,26,9
91,9,1,8,195,25,11
87,8,1,7,202,26,12
84,8,1,7,205,29,18
83,6,0,6,207,33,1
84,7,0,7,206,29,19
86,7,0,7,199,28,1
88,7,0,7,191,24,10
89,10,1,9,188,23,5
90,6,0,6,186,27,9
90,6,0,6,184,27,9
90,5,0,5,182,27,7
91,7,0,7,180,24,9
90,4,0,4,177,26,11
90,2,0,2,176,29,6
91,2,0,2,176,28,6
91,4,0,4,176,24,6
91,6,0,6,180,17,9
89,10,1,9,185,12,17
87,9,1,8,194,16,20
84,11,2,9,200,15,21
67,9,2,7,229,25,25
58,8,1,7,242,41,25
63,6,0,6,249,45,24
64,5,0,5,243,26,19
62,5,0,5,245,36,15
61,4,0,4,246,41,9
62,4,0,4,240,39,8
66,4,0,4,221,39,7
70,4,0,4,208,43,0
71,5,0,5,198,43,0
72,6,0,6,192,41,0
75,5,0,5,187,41,0
75,4,0,4,188,41,2
77,4,0,4,187,39,2
80,4,0,4,182,38,1
77,5,0,5,180,35,0
74,5,0,5,179,32,4
73,6,0,6,182,29,3
73,6,0,6,182,24,7
72,6,0,6,180,26,7
70,6,0,6,180,26,7
69,6,0,6,183,27,7
69,5,0,5,196,26,10
55,6,1,5,217,29,13
49,4,0,4,230,37,24
49,3,0,3,234,43,13
47,3,0,3,241,46,9
43,4,0,4,249,47,11
40,3,0,3,258,48,11
43,3,0,3,259,54,13
41,4,0,4,257,58,7
51,8,0,8,245,67,8
61,7,0,7,228,66,15
66,9,0,9,220,59,7
70,11,0,11,214,53,0
71,10,0,10,211,50,20
75,11,0,11,208,43,8
79,11,0,11,205,40,20
80,7,0,7,203,37,10
78,8,0,8,196,27,21
79,18.60968164,3.915558066,14.69412358,196,24,1
79,9,0,9,195,22,17
79,9,0,9,196,17,2
80,13,1,12,196,22,16
76,18,3,15,194,16,21
74,30,8,22,194,8,14
70,37,11,26,211,14,25
61,31,6,25,233,25,30
53,22,2,20,241,25.4695517,30
48,18.61166182,3.915526137,14.69613568,250,36,23
44,10,1,9,254,45,15
40,7,0,7,263,47,13
36,6,0,6,264,47,10
34,11,1,10,266,48,10
44,7,0,7,253,50,7
47,6,0,6,240,49,9
50,6,0,6,235,49,7
54,9,0,9,226,48,0
59,8,0,8,222,45,4
63,13,0,13,218,41,0
67,10,0,10,213,46,17
77,9,0,9,209,49,0
82,6,0,6,207,46,12
83,6,0,6,206,35,10
83,9,0,9,205,27,8
82,11,0,11,203,23,2
81,14,0,14,200,19,13
80,16,1,15,199,14,12
79,22,3,19,200,8,5
74,20,3,17,209,13,21
66,14,2,12,222,26,17
55,14,2,12,247,32,21
51,12,1,11,265,38,23
50,33,4,29,274,40,23
48,32,2,30,274,56,21
45,21,1,20,276,68,20
40,15,0,15,289,72,17
44,11,0,11,287,67,18
52,12,0,12,277,63,20
53,9,0,9,271,59,23
58,12,0,12,253,55,20
65,14,0,14,239,56,15
79,9,0,9,230,57,12
80,8,0,8,228,44,23
74,12,0,12,227,43,19
73,14,0,14,226,43,37
78,15,0,15,223,34,19
79,12,0,12,222,34,38
78,11,0,11,222,27,23
82,9,0,9,220,28,40
82,11,0,11,220,27,26
83,12,0,12,220,21,34
82,20,1,19,223,16,41
80,26,3,23,228,17,36
74,34,6,28,238,20,42
70,33,6,27,249,21,46
66,29,2,27,259,64,47
68,30,5,25,256,32,44
65,11,1,10,262,34,30
66,8,1,7,256,36,18
64,8,1,7,259,33,19
64,8,1,7,254,34,17
64,10,1,9,249,34,17
68,9,1,8,244,32,10
70,8,0,8,237,31,7
72,9,0,9,232,31,1
74,11,0,11,228,30,5
74,7,0,7,226,28,14
76,9,0,9,226,28,3
79,8,0,8,224,24,15
81,8,0,8,224,23,4
85,7,0,7,223,24,14
87,8,0,8,220,23,0
87,9,0,9,219,21,13
84,6,0,6,218,31,1
88,8,0,8,216,40,11
89,9,0,9,216,32,0
87,15,1,14,218,23,13
86,16,1,15,220,28,5
84,14,1,13,224,34,5
78,11,1,10,231,33,19
72,7,0,7,238,35,12
83,5,0,5,230,34,13
79,5,0,5,235,37,4
62,4,0,4,258,38,11
58,4,0,4,257,46,18
57,6,0,6,261,47,10
57,10,0,10,255,45,9
67,9,0,9,244,48,8
71,4,0,4,234,44,3
74,6,0,6,227,39,0
79,6,0,6,222,33,6
80,7,0,7,219,27,3
82,9,0,9,215,26,16
85,8,0,8,213,25,5
88,6,0,6,209,24,18
88,6,0,6,207,21,3
88,6,0,6,202,20,8
86,5,0,5,204,21,13
78,10,0,10,213,28,10
78,14,1,13,216,24,35
81,23,4,19,213,13,23
65,13,2,11,223,27,32
58,18,4,14,249,38,15
46,26,4,22,268,37,21
43,25,3,22,273,48,17
41,26,3,23,279,57,14
42,16,0,16,275,64,7
31,6,0,6,261,56,11
29,4,0,4,256,50,0
24,4,0,4,264,48,2
22,4,0,4,255,46,5
21,4,0,4,248,46,7
25,4,0,4,234,47,0
33,6,0,6,221,43,6
37,8,0,8,212,40,0
38,12,0,12,205,39,0
38,11,0,11,200,39,6
39,7,0,7,196,37,1
42,10,0,10,190,36,3
44,11,0,11,185,32,3
49,10,0,10,177,29,3
51,11,0,11,172,26,2
51,14,0,14,170,25,2
46,15,1,14,178,27,2
42,9,1,8,191,28,6
42,9,1,8,205,31,17
36,9,1,8,226,35,7
30,8,1,7,240,38,14
31,7,0,7,248,41,4
29,8,0,8,257,44,12
30,15,1,14,258,45,10
31,10,0,10,265,62,12
35,11,0,11,266,62,11
39,11,0,11,255,65,11
26,12,0,12,264,56,6
46,7,0,7,245,51,13
54,8,0,8,226,58,8
58,7,0,7,219,53,0
62,8,0,8,213,49,11
35,6,0,6,208,43,0
36,4,0,4,197,36,8
38,3,0,3,192,36,0
38,3,0,3,189,37,0
42,3,0,3,182,36,1
45,3,0,3,177,34,1
47,4,0,4,171,33,0
47,4,0,4,171,31,0
48,4,0,4,172,29,2
42,4,0,4,180,29,3
39,5,0,5,195,29,5
32,4,0,4,217,31,11
31,3,0,3,229,31,13
29,3,0,3,242,33,2
27,3,0,3,248,32,7
27,3,0,3,257,34,8
27,2,0,2,259,34,7
26,2,0,2,264,36,6
31,3,0,3,255,43,5
24,7,0,7,255,41,7
23,3,0,3,247,38,3
25,5,0,5,237,38,0
51,4,0,4,222,42,0
47,4,0,4,212,43,8
47,5,0,5,207,38,0
40,6,0,6,201,33,7
50,8,0,8,196,33,0
50,5,0,5,187,32,5
51,18.48021694,3.863433014,14.61678393,185,30,2
49,3,0,3,181,30,5
52,4,0,4,176,30,1
50,8,0,8,175,24,2
50,14,1,13,176,12,3
46,14,2,12,183,15,6
44,9,1,8,200,25,18
42,7,1,6,217,28,14
36,5,0,5,230,25.65229783,11
35,4,0,4,234,35,4
29,18.47069977,3.860551308,14.61014846,248,37,8
24,6,0,6,254,43,11
40,6,0,6,245,47,16
41,4,0,4,239,43,10
36,5,0,5,250,49,2
42,5,0,5,238,45,12
44,5,0,5,222,46,10
53,9,1,8,209,43,0
51,5,0,5,202,44,0
54,7,0,7,198,42,4
54,3,0,3,193,45,0
56,4,0,4,190,45,1
57,6,0,6,188,43,0
59,4,0,4,186,42,3
61,4,0,4,185,41,3
67,4,0,4,180,39,4
68,4,0,4,177,34,5
69,5,0,5,175,32,3
70,6,0,6,176,29,5
70,8,0,8,179,26,6
69,9,1,8,182,25,5
64,7,1,6,194,22,10
56,6,1,5,208,28,20
53,5,0,5,214,34,16
52,6,0,6,221,37,15
46,8,0,8,235,42,13
43,7,0,7,243,50,16
43,8,0,8,245,54,20
47,8,0,8,237,63,17
52,13,0,13,229,52,13
55,9,0,9,221,44,9
61,7,0,7,213,38,0
62,7,0,7,208,37,3
66,11,0,11,203,37,1
68,13,0,13,200,36,9
69,6,0,6,199,32,8
70,7,0,7,198,31,1
72,9,0,9,196,30,10
73,8,0,8,195,31,6
73,9,0,9,194,31,6
73,9,0,9,193,27,3
74,8,0,8,193,26,10
73,10,0,10,199,26,9
72,15,1,14,201,29,8
70,16,2,14,206,27,11
70,16,2,14,208,26,10
66,20,4,16,212,31,10
62,14,2,12,222,36,4
58,9,1,8,227,38,24
55,8,0,8,231,40,6
58,10,1,9,227,40,12
61,15,2,13,224,40,7
60,11,1,10,224,37,12
64,8,0,8,218,35,7
61,8,0,8,215,36,6
62,10,0,10,214,37,4
67,8,0,8,213,36,12
70,6,0,6,212,33,0
72,6,0,6,210,32,11
75,6,0,6,208,32,4
68,5,0,5,204,35,11
65,6,0,6,204,40,13
74,10,0,10,203,40,8
76,9,0,9,200,36,12
77,8,0,8,200,34,5
76,8,0,8,201,31,4
75,13,1,12,203,31,7
72,12,1,11,211,26,9
65,13,1,12,218,29,18
61,16,3,13,233,32,0
67,15,3,12,228,32,21
81,9,1,8,215,33,2
86,17,2,15,210,37,0
85,15,1,14,215,31,4
75,14,3,11,235,28,8
75,13,2,11,234,35,20
70,12,2,10,245,30,5
72,14,2,12,244,27,9
79,11,1,10,232,27,13
82,12,0,12,228,21,0
84,16,0,16,225,15,5
84,19,1,18,228,10,5
84,19,1,18,227,8,17
83,25,1,24,229,3,0
82,29,1,28,230,1,23
84,26,1,25,227,1,8
85,22,1,21,222,1,7
87,19,1,18,218,5,9
83,12,1,11,215,11,2
80,9,0,9,213,15,18
79,11,1,10,212,14,0
70,9,1,8,212,22,11
67,8,1,7,220,29,0
60,8,1,7,236,31,13
54,7,1,6,248,32,8
54,8,1,7,254,38,13
48,6,0,6,265,45,18
42,4,0,4,269,48,15
43,5,0,5,274,52,9
41,5,0,5,275,53,6
45,4,0,4,268,49,4
46,4,0,4,263,46,4
52,4,0,4,251,46,8
58,6,0,6,242,43,5
64,7,0,7,235,39,0
68,8,0,8,226,40,0
70,6,0,6,222,38,8
71,7,0,7,219,37,4
72,7,0,7,216,35,9
76,8,0,8,214,30,8
77,9,0,9,216,23,10
79,10,0,10,211,19,16
82,11,0,11,211,15,6
82,14,1,13,211,10,18
76,19,2,17,213,9,5
73,32,7,25,217,11,22
67,24,5,19,239,23,14
59,19,4,15,256,34,26
54,27,5,22,267,38,20
54,13,1,12,266,46,22
48,9,0,9,273,53,17
47,8,0,8,278,56,14
44,13,1,12,290,59,14
33,15,0,15,295,66,17
33,13,0,13,296,67,20
32,22,1,21,296,68,18
26,13,0,13,292,65,17
47,6,0,6,275,62,13
59,8,0,8,246,56,13
61,7,0,7,234,55,7
65,6,0,6,225,49,1
63,5,0,5,220,49,12
66,6,0,6,214,47,11
68,9,0,9,208,41,9
66,5,0,5,199,41,20
61,4,0,4,196,42,5
57,5,0,5,198,43,12
57,4,0,4,202,41,15
39,4,0,4,203,34,8
36,8,0,8,205,30,13
36,6,0,6,213,31,4
33,6,0,6,229,32,20
35,5,0,5,241,36,12
53,3,0,3,241,38,16
55,3,0,3,239,37,18
54,3,0,3,240,40,7
51,3,0,3,243,40,9
52,2,0,2,243,41,9
54,3,0,3,239,42,13
53,2,0,2,239,44,6
56,4,0,4,235,44,6
56,6,0,6,229,43,6
59,6,0,6,221,42,4
61,5,0,5,214,44,6
62,5,0,5,212,44,2
65,4,0,4,208,46,8
63,3,0,3,205,48,0
58,3,0,3,203,44,8
72,18.33304128,3.810774728,14.52226655,180,40,5
75,4,0,4,172,36,0
61,3,0,3,173,35,0
59,3,0,3,175,34,1
60,5,0,5,178,32,4
62,8,0,8,183,27,6
55,10,1,9,195,25,6
48,6,1,5,208,25.81414221,0
44,18.32453111,3.808424016,14.51610709,222,30,13
40,8,1,7,235,33,6
34,5,0,5,246,38,13
31,5,0,5,247,44,10
31,4,0,4,251,46,8
31,5,0,5,255,47,7
31,7,0,7,254,48,11
44,5,0,5,234,44,7
48,6,0,6,220,41,0
52,5,0,5,210,39,0
51,5,0,5,205,37,10
55,4,0,4,204,35,0
60,5,0,5,204,34,7
65,7,0,7,198,34,6
67,6,0,6,193,34,0
68,6,0,6,188,34,3
70,4,0,4,189,35,2
71,4,0,4,189,36,1
75,4,0,4,184,35,4
72,3,0,3,179,36,3
75,5,0,5,171,35,1
82,8,0,8,165,33,1
81,8,0,8,166,31,4
80,11,1,10,177,28,7
73,7,1,6,185,30,13
71,6,0,6,186,31,11
79,6,0,6,184,32,7
75,6,0,6,187,33,7
76,6,0,6,191,32,10
79,7,0,7,189,32,1
83,8,0,8,185,31,8
87,7,0,7,182,30,8
87,10,0,10,181,29,7
88,13,1,12,178,26,6
90,8,0,8,176,26,7
89,7,0,7,174,26,9
89,6,0,6,173,26,9
89,6,0,6,173,25,8
89,6,0,6,172,24,7
90,6,0,6,171,22,10
90,4,0,4,169,28,6
91,3,0,3,163,43,6
91,3,0,3,162,42,4
90,4,0,4,162,40,7
90,8,0,8,163,31,7
92,14,1,13,165,18,7
89,12,1,11,170,23,11
84,12,2,10,175,19,14
78,16,3,13,184,23,13
74,12,2,10,194,28,15
65,12,2,10,215,31,14
63,5,0,5,217,38,27
57,6,0,6,236,34,13
56,5,0,5,249,36,11
53,4,0,4,244,41,13
56,4,0,4,238,42,5
58,4,0,4,232,43,4
65,7,0,7,220,44,0
71,6,0,6,211,43,0
74,5,0,5,204,41,6
78,4,0,4,196,40,0
81,5,0,5,191,39,3
84,6,0,6,188,37,1
86,6,0,6,185,34,1
87,6,0,6,183,31,2
88,4,0,4,182,31,4
88,5,0,5,182,30,6
87,5,0,5,182,32,6
87,8,0,8,183,29,5
84,9,1,8,187,30,7
80,9,1,8,195,25,9
72,8,1,7,206,26,6
67,9,1,8,220,32,20
59,13,2,11,233,38,17
51,18,3,15,243,46,21
47,9,0,9,252,57,20
45,15,2,13,259,59,22
38,18,2,16,267,72,17
41,11,1,10,264,55,16
48,14,1,13,252,55,15
51,8,0,8,243,51,12
60,6,0,6,231,47,5
66,6,0,6,227,45,0
71,7,0,7,223,44,15
75,10,0,10,222,40,3
79,9,0,9,220,34,17
82,9,0,9,215,28,2
84,10,0,10,213,25,20
83,12,0,12,211,26,3
83,12,0,12,209,24,17
83,13,0,13,206,19,4
84,15,1,14,201,5,6
86,21,4,17,196,4,19
84,24,7,17,204,5,12
80,25,7,18,212,13,27
66,17,3,14,235,26,17
62,10,1,9,247,36,30
55,8,0,8,258,47,26
52,14,1,13,273,49,23
42,14,1,13,283,62,26
39,23,1,22,289,80,20
40,22,1,21,298,92,27
43,21,1,20,281,85,27
47,20,1,19,271,77,23
63,8,0,8,223,70,26
69,7,0,7,218,62,5
77,7,0,7,214,55,0
73,8,0,8,212,47,25
71,8,0,8,210,34,11
68,8,0,8,206,29,20
67,8,0,8,201,28,2
68,10,0,10,198,25,11
68,8,0,8,194,26,5
68,7,0,7,190,31,6
66,6,0,6,188,33,3
68,6,0,6,185,31,0
67,7,0,7,186,26,5
60,9,1,8,194,25,9
50,8,1,7,218,28,17
45,6,1,5,237,30,12
45,4,0,4,250,32,9
43,4,0,4,255,34,7
42,4,0,4,261,38,6
42,4,0,4,264,40,6
40,3,0,3,272,39,4
40,4,0,4,275,40,4
42,3,0,3,265,40,4
48,3,0,3,253,40,1
55,5,0,5,240,39,3
62,8,0,8,227,41,0
67,8,0,8,216,41,0
73,7,0,7,212,41,3
75,4,0,4,206,46,8
76,3,0,3,203,44,6
77,3,0,3,202,43,3
76,3,0,3,200,41,8
77,4,0,4,197,41,5
77,3,0,3,194,42,4
78,4,0,4,191,40,0
79,4,0,4,189,38,6
79,4,0,4,190,34,6
78,5,0,5,192,33,4
77,4,0,4,197,34,13
72,5,0,5,206,35,5
68,3,0,3,217,38,19
70,3,0,3,217,40,7
68,3,0,3,221,39,12
67,3,0,3,224,40,11
68,2,0,2,222,43,9
73,3,0,3,215,43,4
78,2,0,2,212,41,1
82,3,0,3,207,40,10
84,4,0,4,202,37,0
86,5,0,5,199,34,11
89,5,0,5,195,36,6
90,3,0,3,194,35,4
89,3,0,3,191,34,8
87,4,0,4,189,34,7
85,3,0,3,188,36,6
84,2,0,2,186,36,7
83,18.16223398,3.757420974,14.40481301,185,32,6
75,4,0,4,187,33,5
74,3,0,3,186,33,6
72,4,0,4,187,30,7
68,6,0,6,189,28,6
66,9,1,8,194,27,9
60,7,1,6,206,27,10
50,6,1,5,230,30,13
45,6,1,5,255,25.98453359,21
43,6,0,6,264,38,11
38,18.15169118,3.754625737,14.39706544,268,43,16
33,5,0,5,282,45,18
29,4,0,4,290,48,18
31,5,0,5,296,51,14
40,7,0,7,303,50,12
41,8,1,7,276,58,9
55,9,1,8,252,50,14
59,8,0,8,223,28,11
62,11,0,11,205,28,0
64,8,0,8,193,26,2
68,4,0,4,189,28,5
70,5,0,5,185,25,3
72,8,0,8,183,21,8
73,12,0,12,183,17,9
73,9,0,9,184,21,11
74,6,0,6,183,25,6
74,4,0,4,182,26,4
76,4,0,4,179,21,7
75,6,0,6,181,18,6
73,10,2,8,189,16,10
65,14,3,11,213,16,25
57,17,4,13,235,22,25
53,26,7,19,248,24,19
52,26,4,22,261,46,23
54,19,1,18,268,74,26
55,11,0,11,274,66,26
57,12,0,12,274,53,26
55,12,0,12,280,53,32
56,11,0,11,284,55,31
57,14,0,14,274,50,34
63,13,0,13,263,44,37
69,10,0,10,252,42,36
77,7,0,7,243,38,35
81,7,0,7,240,33,27
82,7,0,7,239,31,33
84,9,0,9,234,28,21
83,9,0,9,231,25,16
81,9,0,9,231,28,23
80,7,0,7,232,33,5
71,7,0,7,233,36,21
76,7,0,7,232,38,1
82,6,0,6,230,30,20
84,12,0,12,229,27,6
86,18,1,17,230,19,16
87,22,2,20,225,18,21
87,16,1,15,227,23,10
80,14,1,13,218,25,27
92,9,0,9,213,32,2
92,7,0,7,208,30,13
91,6,0,6,213,34,9
93,6,0,6,220,30,6
92,6,0,6,220,25,6
92,4,0,4,227,25,2
92,5,0,5,240,18,3
88,6,1,5,240,12,10
86,4,0,4,245,9,5
87,3,0,3,241,7,20
85,4,0,4,241,8,5
86,5,0,5,239,9,15
84,7,0,7,236,9,19
86,11,0,11,227,11,11
86,9,0,9,226,15,6
88,11,1,10,224,10,0
86,14,1,13,223,7,11
68,18,1,17,222,15,0
55,8,0,8,226,35,6
53,7,0,7,229,41,0
49,9,0,9,236,44,9
45,8,0,8,241,46,2
39,8,0,8,261,46,6
38,6,0,6,265,47,12
35,5,0,5,273,48,11
37,5,0,5,268,48,10
35,5,0,5,275,49,14
35,6,0,6,279,51,14
37,14,1,13,284,52,14
37,23,3,20,283,61,13
40,20,1,19,275,63,13
43,17,0,17,267,61,11
57,28,1,27,259,57,10
62,20,1,19,246,54,10
63,17,0,17,242,50,2
63,21,1,20,239,44,13
65,21,1,20,236,38,10
69,24,1,23,231,29,20
73,23,1,22,228,19,11
75,16,1,15,224,11,21
79,17,1,16,219,9,17
82,15,1,14,214,3,17
84,14,1,13,209,3,23
85,16,2,14,211,3,10
79,19,3,16,218,7,28
68,16,2,14,238,28,25
55,15,2,13,261,40,24
47,13,1,12,280,54,28
46,8,0,8,287,64,22
42,7,0,7,299,69,17
42,9,0,9,300,80,19
38,13,0,13,303,72,19
38,8,0,8,305,70,13
47,11,0,11,295,72,14
52,15,0,15,286,81,18
59,12,0,12,271,77,21
64,13,0,13,260,58,15
65,10,0,10,251,53,15
73,8,0,8,243,55,24
75,10,0,10,237,51,13
77,11,0,11,235,46,6
77,10,0,10,233,42,22
80,8,0,8,230,40,5
83,8,0,8,228,37,11
84,8,0,8,226,36,9
82,9,0,9,225,33,7
82,10,0,10,225,36,15
81,14,1,13,228,33,0
75,13,1,12,236,35,19
68,12,1,11,245,39,13
65,17,2,15,252,42,17
57,27,5,22,259,42,14
53,28,3,25,272,52,16
51,23,2,21,281,63,22
49,11,1,10,287,59,19
45,18,1,17,297,56,12
47,17,1,16,296,55,13
52,12,1,11,288,55,11
59,12,0,12,272,53,11
62,12,0,12,266,43,13
66,14,1,13,258,36,11
68,6,0,6,253,35,11
74,5,0,5,247,34,8
78,4,0,4,242,36,3
80,9,1,8,241,34,12
81,5,0,5,241,32,5
82,5,0,5,240,29,13
83,6,0,6,238,26,10
86,5,0,5,234,24,6
88,4,0,4,234,24,14
89,4,0,4,234,21,1
91,5,0,5,232,18,20
92,5,0,5,233,17,2
91,5,0,5,234,20,10
90,4,0,4,232,25,9
91,3,0,3,232,27,4
88,3,0,3,232,24,16
83,3,0,3,239,26,6
81,3,0,3,243,31,23
80,4,0,4,247,35,18
78,8,0,8,247,35,19
77,9,0,9,243,36,13
83,12,0,12,237,36,8
84,14,0,14,232,35,8
86,15,0,15,229,30,12
87,9,0,9,230,24,13
87,7,0,7,232,24,6
87,7,0,7,232,23,15
87,10,0,10,233,18,2
87,14,0,14,232,13,18
86,17,1,16,231,8,4
85,18.04307081,3.707468579,14.33560223,231,10,19
84,18,1,17,231,9,10
85,17,1,16,231,8,15
86,15,1,14,231,8,15
84,7,0,7,225,19,14
78,6,0,6,224,25,12
82,6,0,6,222,31,7
86,7,0,7,216,26,12
83,8,1,7,217,26.11732995,8
77,18.03750088,3.705100132,14.33240075,224,28,13
70,12,1,11,237,29,24
61,10,1,9,254,33,17
60,9,1,8,262,41,18
60,7,0,7,260,44,15
58,13,1,12,262,47,14
62,10,0,10,256,46,13
60,8,0,8,249,39,11
61,8,0,8,242,39,5
67,12,1,11,235,38,0
74,8,0,8,233,36,9
76,7,0,7,233,32,6
78,9,0,9,233,31,17
80,9,0,9,231,30,5
84,7,0,7,228,27,15
85,5,0,5,224,26,5
87,6,0,6,224,28,9
88,8,0,8,223,22,15
89,9,0,9,219,19,7
90,8,0,8,217,20,19
89,9,0,9,217,22,1
90,10,1,9,223,22,24
86,8,1,7,228,25,10
82,7,1,6,233,24,20
76,6,1,5,246,31,15
73,6,0,6,248,35,26
70,4,0,4,252,38,21
67,5,0,5,259,40,15
70,6,0,6,255,43,16
70,11,1,10,256,36,22
70,10,0,10,256,37,22
70,6,0,6,254,37,15
72,9,0,9,251,36,14
78,9,0,9,246,31,14
79,12,0,12,241,33,15
81,10,0,10,234,26,22
82,10,0,10,229,19,10
85,10,0,10,223,16,12
85,9,0,9,222,15,15
86,7,0,7,219,15,13
89,5,0,5,217,18,6
92,6,0,6,216,18,15
92,7,0,7,214,16,11
91,10,1,9,213,11,15
92,10,1,9,215,11,24
91,11,2,9,220,11,19
90,14,3,11,225,12,33
89,11,2,9,228,16,19
88,12,2,10,233,20,31
86,13,1,12,237,27,22
79,14,1,13,244,35,29
76,13,1,12,250,45,31
71,11,0,11,257,49,32
72,9,0,9,258,53,27
72,8,0,8,256,56,27
71,8,0,8,254,53,26
69,13,0,13,249,56,27
73,26,0,26,245,52,30
79,20,0,20,241,34,31
79,18,0,18,234,25,32
80,16,0,16,231,22,14
84,17,1,16,229,20,24
87,15,1,14,226,18,24
86,14,1,13,222,13,21
86,11,0,11,221,10,33
84,11,0,11,218,16,15
83,12,0,12,218,19,23
84,17,2,15,220,17,18
83,14,3,11,227,15,19
80,12,2,10,236,15,27
72,19,4,15,250,22,26
67,26,4,22,261,25,30
63,21,2,19,270,43,33
60,23,1,22,279,57,28
54,21,1,20,289,71,33
52,21,1,20,295,75,35
53,18,1,17,295,71,34
54,14,0,14,287,67,25
55,20,1,19,284,64,22
62,12,0,12,274,52,25
66,10,0,10,264,41,15
66,8,0,8,258,39,9
75,10,0,10,252,44,7
76,16,0,16,249,36,4
78,11,0,11,246,42,11
80,8,0,8,245,44,5
81,8,0,8,242,39,9
83,6,0,6,240,39,13
84,7,0,7,238,40,9
84,7,0,7,239,39,12
85,9,0,9,238,38,11
88,10,0,10,237,30,22
90,16,1,15,235,26,8
88,21,2,19,234,22,23
86,20,2,18,239,22,6
81,22,3,19,245,17,29
75,33,5,28,251,26,18
83,32,4,28,247,25,13
78,22,3,19,256,22,13
76,21,3,18,260,23,16
75,28,4,24,261,25,18
76,30,6,24,258,20,11
72,41,10,31,260,16,7
78,31,4,27,257,16,7
77,25,2,23,256,11,8
77,26,1,25,254,13,9
84,24,1,23,247,6,7
86,19,1,18,243,4,9
86,18,1,17,240,3,13
85,20,1,19,240,3,6
84,21,1,20,241,1,11
84,16,1,15,241,3,12
85,13,1,12,239,4,10
85,20,1,19,240,1,6
86,18,1,17,240,0,17
87,32,11,21,240,1,7
89,47,22,25,242,2,16
90,46,20,26,244,2,16
87,37,13,24,251,5,17
83,30,5,25,256,21,37
81,26,2,24,253,27,35
81,21,2,19,245,28,20
86,18,2,16,238,25,4
83,9,1,8,233,32,0
78,8,0,8,232,41,8
78,7,0,7,234,48,2
78,9,0,9,242,39,6
77,10,0,10,243,38,9
78,15,0,15,245,32,7
74,30,1,29,245,25,5
73,29,1,28,244,23,8
70,29,1,28,244,23,18
74,40,1,39,243,16,8
79,29,1,28,239,8,16
83,17,1,16,236,13,10
87,21,1,20,234,13,12
89,25,1,24,229,6,3
89,22,1,21,226,11,15
90,18,1,17,226,13,5
90,19,2,17,228,8,11
89,23,4,19,230,9,12
84,26,7,19,239,14,8
77,18,5,13,257,17,17
67,11,2,9,276,23,18
58,8,1,7,297,30,18
54,10,1,9,307,38,16
59,29,3,26,308,52,14
55,25,1,24,311,65,19
51,24,1,23,317,69,20
51,17,1,16,322,51,18
54,14,1,13,306,47,15
66,14,1,13,294,37,9
73,18,1,17,280,42,23
74,22,1,21,276,34,26
76,20,1,19,272,30,26
76,17,1,16,272,20,31
77,22,1,21,270,9,33
78,25,1,24,270,5,37
78,24,1,23,270,3,38
79,18.00657892,3.673042839,14.33353608,267,3,37
80,26,3,23,264,3,34
81,27,3,24,263,2,36
83,23,2,21,260,2,37
82,13,1,12,255,19,37
77,9,1,8,257,26,28
73,7,1,6,265,21,14
68,8,2,6,279,19,11
64,7,1,6,289,26.13318359,18
62,18.00439271,3.671644517,14.3327482,301,28,17
55,9,1,8,317,45,23
54,15,0,15,325,82,31
55,14,0,14,325,85,43
56,15,0,15,319,98,40
58,16,1,15,319,50,15
63,17,1,16,306,37,15
68,26,3,23,292,28,22
70,22,1,21,286,20,26
71,19,1,18,283,19,29
70,23,1,22,286,14,30
70,25,1,24,283,10,35
71,23,1,22,279,9,36
71,23,1,22,279,8,37
73,21,1,20,275,7,34
73,22,1,21,273,5,35
73,23,1,22,272,4,35
74,24,2,22,269,3,29
75,26,3,23,267,2,35
75,32,8,24,270,2,36
75,37,11,26,273,1,36
74,43,14,29,275,3,40
71,41,14,27,283,7,26
65,35,8,27,290,12,30
60,23,4,19,304,19,22
60,12,1,11,305,28,19
63,11,1,10,303,36,17
58,13,1,12,310,33,16
60,20,0,20,305,63,28
63,21,1,20,296,35,32
65,22,2,20,293,34,30
72,22,2,20,285,19,31
83,25,2,23,270,7,33
89,22,2,20,258,2,28
93,16,3,13,255,2,14
93,12,2,10,248,2,1
90,9,1,8,247,3,9
92,5,0,5,239,23,0
91,3,0,3,236,33,5
92,3,0,3,234,17,1
90,4,0,4,236,15,0
89,6,0,6,235,14,16
89,9,0,9,233,7,0
86,14,2,12,241,7,14
81,20,3,17,248,8,10
77,29,8,21,257,11,11
72,31,7,24,268,14,12
65,40,10,30,290,12,17
62,25,6,19,294,16,14
58,26,5,21,306,22,9
53,24,3,21,317,34,10
53,14,1,13,322,60,22
51,13,0,13,318,63,18
53,7,0,7,304,43,7
57,5,0,5,297,29,1
63,9,1,8,289,31,6
64,11,1,10,283,30,10
70,8,0,8,276,33,5
87,6,0,6,247,32,7
89,5,0,5,244,35,14
90,3,0,3,241,41,2
86,3,0,3,238,39,17
84,3,0,3,237,37,1
84,3,0,3,238,35,6
83,4,0,4,238,32,8
86,6,0,6,238,24,5
88,8,0,8,237,20,13
86,12,1,11,236,18,5
81,10,1,9,245,20,20
71,7,1,6,260,22,11
70,6,1,5,266,26,22
64,7,1,6,275,26,14
58,5,0,5,289,28,8
57,5,0,5,296,33,13
57,4,0,4,295,39,10
55,6,0,6,299,45,12
53,6,0,6,300,45,13
49,5,0,5,303,42,7
51,9,2,7,296,40,9
55,6,0,6,288,39,8
58,7,0,7,279,35,12
70,11,1,10,272,35,6
70,12,1,11,269,26,10
74,12,0,12,263,20,13
77,17,1,16,258,20,13
80,14,0,14,255,14,9
82,11,0,11,253,17,17
83,12,0,12,253,18,9
82,11,0,11,252,18,21
84,10,0,10,250,19,14
83,14,1,13,249,18,23
83,18,2,16,249,12,15
79,22,4,18,255,14,24
73,16,3,13,267,21,26
65,13,2,11,282,31,25
56,14,1,13,300,33,20
54,16,1,15,306,56,24
48,12,0,12,314,61,24
44,9,0,9,320,58,27
42,8,0,8,327,60,25
47,10,0,10,326,68,23
51,13,0,13,319,84,28
56,12,0,12,308,74,22
61,11,0,11,295,51,16
66,14,1,13,287,42,14
66,11,0,11,282,35,16
68,9,0,9,274,35,19
69,10,0,10,271,42,19
71,12,0,12,266,37,21
73,13,0,13,262,30,24
76,13,0,13,259,35,24
79,12,0,12,257,30,29
83,15,1,14,255,26,29
84,20,1,19,254,16,34
82,19,1,18,252,13,34
81,20,3,17,253,13,35
77,22,4,18,261,15,29
66,23,4,19,281,22,37
57,20,3,17,300,34,35
48,12,1,11,316,51,29
53,10,0,10,320,71,29
50,11,0,11,330,84,31
47,8,0,8,331,93,29
47,7,0,7,337,96,35
47,10,0,10,331,119,37
54,12,0,12,322,105,35
54,9,0,9,313,68,31
53,8,0,8,306,51,17
60,15,1,14,293,45,19
55,19,1,18,286,39,19
60,13,1,12,280,41,14
65,15,1,14,273,42,17
75,12,0,12,266,36,18
80,10,0,10,261,26,22
83,7,0,7,258,27,25
84,8,0,8,257,24,24
85,12,0,12,255,16,28
86,15,1,14,254,16,29
86,14,1,13,253,16,28
85,15,1,14,255,18,41
80,18,2,16,261,24,36
73,18,2,16,277,29,40
66,18,2,16,293,36,40
59,26,4,22,306,39,37
57,17,1,16,317,57,37
56,12,0,12,318,67,41
41,8,0,8,323,59,33
41,6,0,6,327,49,17
42,5,0,5,329,48,17
53,5,0,5,319,50,13
53,6,0,6,308,41,17
61,6,0,6,298,33,11
74,12,1,11,283,19,10
79,7,0,7,272,12,8
81,7,0,7,266,11,6
83,6,0,6,263,10,6
85,9,0,9,262,5,8
86,9,0,9,259,2,11
86,13,1,12,258,1,11
87,17.9468088,3.638213836,14.30859496,257,1,15
88,15,1,14,255,1,11
89,20,2,18,253,0,15
89,19,2,17,251,1,14
88,21,5,16,254,3,15
83,27,9,18,262,4,21
75,25,8,17,273,7,36
67,31,11,20,291,11,34
61,26,8,18,306,26.19852143,27
59,17.95042792,3.639726306,14.31070161,311,18,20
55,16,3,13,320,26,19
53,12,2,10,321,28,18
51,10,2,8,322,25,13
52,11,3,8,324,20,7
57,7,2,5,312,14,1
63,8,3,5,299,10,0
65,8,3,5,290,6,2
71,10,2,8,277,6,2
77,6,1,5,271,5,1
81,4,0,4,266,3,2
83,4,0,4,263,6,2
85,3,0,3,260,4,0
85,3,0,3,258,4,9
86,4,0,4,256,2,2
86,5,0,5,256,2,7
87,10,1,9,254,0,4
88,9,1,8,252,0,7
87,10,1,9,254,2,4
87,12,4,8,256,2,5
81,20,10,10,266,2,11
71,24,13,11,279,5,17
68,23,12,11,291,5,14
63,11,4,7,298,8,15
58,7,3,4,308,10,4
57,7,3,4,312,12,1
55,6,2,4,318,11,6
55,6,2,4,315,8,5
58,8,4,4,314,8,1
62,7,3,4,307,9,1
68,6,2,4,293,9,0
74,7,2,5,284,9,7
77,9,2,7,275,7,2
80,4,0,4,271,6,0
82,5,0,5,267,5,3
84,7,1,6,264,4,4
85,6,0,6,262,2,5
87,6,0,6,260,2,10
87,5,0,5,259,2,7
87,6,0,6,259,1,11
87,10,1,9,258,1,8
87,7,0,7,259,2,7
87,9,1,8,259,1,12
86,15,5,10,263,2,10
80,20,9,11,273,3,20
74,25,13,12,290,4,22
69,26,13,13,304,7,21
66,22,9,13,310,11,19
63,18,7,11,319,14,21
63,15,5,10,319,17,19
66,10,3,7,313,17,10
64,10,3,7,319,16,10
64,12,4,8,317,14,15
68,10,3,7,309,14,14
72,11,3,8,295,12,15
76,12,2,10,288,9,15
78,12,2,10,283,6,10
82,10,1,9,278,4,15
84,8,1,7,272,3,15
85,7,1,6,270,4,15
85,11,1,10,269,0,14
85,12,1,11,271,0,18
86,12,1,11,268,0,18
87,10,1,9,266,0,15
87,6,0,6,264,2,18
88,8,1,7,263,2,13
89,10,1,9,261,0,15
87,13,4,9,264,1,14
84,13,6,7,272,3,20
77,17,10,7,284,3,20
71,12,6,6,297,6,22
68,10,4,6,306,8,19
66,8,3,5,312,9,14
63,8,3,5,314,10,9
62,7,2,5,315,12,10
66,9,3,6,306,11,9
70,9,3,6,298,10,12
70,9,3,6,298,11,11
74,10,3,7,290,9,6
77,14,4,10,284,7,5
81,9,1,8,276,4,7
83,10,1,9,272,3,9
84,10,1,9,270,2,8
84,8,1,7,268,1,9
85,10,1,9,267,3,10
85,8,1,7,264,2,10
85,6,0,6,263,3,9
86,5,0,5,261,7,10
86,7,0,7,259,5,5
85,6,0,6,259,6,9
85,9,1,8,260,5,5
85,14,3,11,262,4,7
81,14,5,9,267,5,10
78,14,5,9,273,5,16
67,16,7,9,294,8,7
62,11,4,7,303,14,18
57,8,2,6,313,16,11
56,9,2,7,313,20,8
54,6,1,5,318,22,7
50,6,1,5,318,17,1
42,9,2,7,324,17,6
45,9,2,7,319,18,4
50,9,2,7,313,17,4
54,9,1,8,301,15,0
57,8,1,7,291,15,4
64,12,1,11,283,15,6
71,12,1,11,274,10,6
68,11,1,10,272,11,8
75,10,1,9,269,11,10
80,7,0,7,265,12,7
82,5,0,5,262,10,5
83,7,0,7,259,6,11
83,11,0,11,257,1,7
85,12,1,11,255,2,14
86,13,1,12,254,2,8
86,19,6,13,256,2,15
81,22,8,14,264,4,13
73,24,10,14,279,6,19
67,31,12,19,293,9,24
61,29,8,21,305,15,17
57,24,4,20,316,24,14
53,21,3,18,326,34,18
50,14,1,13,332,53,22
46,9,0,9,338,59,21
35,8,0,8,340,50,18
41,9,1,8,329,35,9
56,10,1,9,316,29,7
62,11,1,10,300,19,4
73,13,1,12,286,16,11
76,11,0,11,279,17,8
78,13,1,12,276,16,9
78,15,1,14,276,17,10
80,11,1,10,274,10,13
80,15,1,14,274,5,18
80,17,1,16,271,6,17
81,22,3,19,273,5,17
81,25,5,20,272,5,16
81,24,3,21,271,7,16
82,21,2,19,269,8,16
82,20,4,16,272,8,17
78,24,7,17,279,7,23
65,26,8,18,296,10,27
57,20,4,16,314,25,27
47,14,2,12,333,40,22
52,15,1,14,338,52,28
48,12,0,12,340,70,27
46,7,0,7,343,77,20
52,9,0,9,326,85,27
57,10,0,10,318,64,13
63,7,0,7,315,48,13
66,9,0,9,313,47,26
68,13,1,12,306,46,33
70,17,1,16,301,38,37
69,13,0,13,286,32,35
64,7,0,7,285,28,10
70,16,1,15,287,24,5
71,21,1,20,288,19,22
68,24,1,23,284,11,26
69,20,1,19,283,7,13
70,17.8643508,3.623742833,14.24060797,281,10,14
69,19,1,18,282,9,12
73,17,1,16,281,9,15
67,18,2,16,280,10,15
65,20,3,17,282,12,13
77,12,2,10,270,13,13
88,8,1,7,255,24,12
83,8,1,7,271,20,3
68,6,1,5,290,24,19
54,6,1,5,316,28,20
48,5,0,5,330,37,20
44,4,0,4,334,44,23
52,5,0,5,336,49,15
50,5,0,5,332,55,22
51,5,0,5,329,54,19
50,11,1,10,325,53,21
59,9,0,9,316,49,19
58,14,0,14,309,55,18
56,15,1,14,305,44,25
64,17,1,16,296,46,23
68,14,1,13,289,60,27
65,14,0,14,287,51,30
69,13,0,13,287,40,24
72,10,0,10,280,40,33
70,9,0,9,281,38,34
70,10,0,10,280,33,30
73,12,1,11,273,25,30
78,8,0,8,260,24,23
80,9,1,8,259,22,16
77,11,1,10,263,19,21
76,13,2,11,268,17,26
73,11,2,9,278,26.03234897,12.48883013
69,8,1,7,283,23,27
65,7,1,6,297,31,23
61,6,0,6,305,40,26
59,6,0,6,311,41,20
57,4,0,4,307,43,18
58,5,0,5,298,45,20
65,7,0,7,283,44,17
69,9,0,9,282,39,18
68,23,1,22,282,36,17
65,11,0,11,283,35,18
67,14,0,14,282,36,18
71,16,1,15,273,24,17
73,12,0,12,266,20,17
73,15,1,14,262,20,17
67,10,0,10,257,24,14
71,7,0,7,252,33,7
74,11,0,11,247,21,7
75,15,1,14,243,14,14
75,12,1,11,243,20,12
75,14,1,13,243,16,11
77,18,2,16,242,15,18
76,17,2,15,248,16,8
74,10,1,9,257,23,22
72,10,2,8,266,23,12
66,17.83118969,3.609662389,14.2215273,282,30,18
62,11,1,10,291,46,32
54,13,0,13,301,67,31
55,11,0,11,309,81,32
48,10,0,10,311,82,36
49,11,0,11,314,92,21
54,14,0,14,307,84,29
55,11,0,11,297,58,20
54,8,0,8,291,43,11
58,8,0,8,280,40,8
67,13,1,12,277,38,6
67,7,0,7,273,34,12
73,10,0,10,268,33,11
74,10,0,10,264,31,9
76,14,0,14,265,31,12
78,9,0,9,262,31,13
79,10,0,10,261,29,12
80,12,0,12,260,28,11
82,12,1,11,259,25,11
82,10,0,10,258,23,11
81,14,1,13,261,21,13
78,13,1,12,269,22,11
69,13,2,11,284,22,17
64,16,3,13,293,24,24
59,21,4,17,304,26,14
54,15,2,13,314,35,15
51,10,1,9,322,38,14
52,8,1,7,325,34,15
51,7,0,7,326,36,13
52,7,1,6,324,34,12
51,7,1,6,326,33,7
58,8,1,7,315,31,9
62,10,1,9,311,29,6
69,15,1,14,297,24,7
74,13,1,12,288,18,8
75,13,1,12,284,17,6
74,13,1,12,278,13,6
77,9,0,9,279,15,6
78,17,2,15,275,17,7
79,13,1,12,274,16,10
81,12,1,11,273,14,9
81,7,0,7,272,14,10
82,7,0,7,270,13,10
83,9,0,9,268,9,12
83,9,1,8,271,11,9
79,11,2,9,278,10,8
68,12,4,8,291,12,15
60,14,5,9,308,14,14
55,16,6,10,313,15,11
51,10,3,7,324,15,9
48,10,3,7,330,14,9
44,7,2,5,331,11,6
45,10,4,6,336,10,7
46,12,5,7,329,9,5
47,9,4,5,329,10,2
50,12,5,7,320,9,0
59,13,4,9,312,9,6
68,16,3,13,298,8,4
70,12,1,11,292,8,8
73,10,1,9,285,6,9
80,8,1,7,280,9,11
82,3,0,3,278,6,10
82,6,0,6,276,2,10
84,6,0,6,274,4,13
83,7,1,6,273,3,14
82,6,0,6,271,2,13
81,9,1,8,270,2,12
80,10,1,9,269,1,13
81,12,4,8,272,2,13
74,20,11,9,280,2,14
65,26,15,11,294,3,20
62,22,12,10,306,6,16
64,20,9,11,309,6,14
62,20,9,11,314,8,13
57,11,4,7,318,11,9
55,6,2,4,323,13,13
49,7,2,5,332,14,9
55,6,2,4,329,10,9
55,4,1,3,319,12,2
58,5,2,3,309,7,1
64,8,2,6,300,6,0
72,10,2,8,288,6,3
80,7,1,6,283,6,6
79,5,0,5,279,4,4
81,4,0,4,275,7,7
82,4,0,4,274,6,6
82,8,1,7,272,5,5
85,6,0,6,269,4,4
84,5,0,5,268,4,7
84,4,0,4,269,4,7
85,5,0,5,266,4,6
85,5,0,5,266,5,4
84,7,1,6,266,5,6
82,12,4,8,269,6,5
80,11,4,7,273,4,8
77,8,3,5,276,5,6
75,6,2,4,280,5,7
78,7,2,5,279,6,9
74,7,2,5,280,6,9
80,7,2,5,277,7,7
76,8,3,5,283,7,5
72,10,4,6,290,8,9
73,7,2,5,285,10,16
77,8,2,6,282,9,12
79,10,2,8,280,6,5
82,12,2,10,278,3,10
82,10,1,9,275,1,7
82,11,1,10,275,0,8
83,9,1,8,272,2,8
83,10,1,9,271,3,9
83,10,1,9,270,1,8
84,10,1,9,268,2,10
82,17.75723457,3.592816906,14.16441766,269,3,9
81,8,1,7,270,2,10
82,9,1,8,269,2,10
80,10,1,9,269,2,10
77,14,3,11,272,2,9
79,17,6,11,278,2,11
79,16,6,10,279,4,13
78,16,5,11,282,25.93745799,10
69,15,6,9,300,6,6
67,17.75401382,3.592839282,14.16117454,305,9,15
66,12,3,9,310,14,16
68,9,2,7,307,16,10
65,8,2,6,312,16,10
68,10,2,8,308,21,9
71,13,2,11,300,19,14
71,13,2,11,296,16,14
73,10,1,9,291,12,6
75,10,1,9,286,8,8
77,9,0,9,282,7,9
78,9,0,9,280,6,8
78,10,0,10,279,6,11
78,11,1,10,278,5,11
77,12,1,11,279,5,10
79,14,1,13,278,4,14
80,9,0,9,275,6,11
79,11,1,10,275,4,12
81,12,1,11,274,3,16
83,11,1,10,271,4,14
82,12,2,10,274,4,9
79,17,6,11,282,4,14
71,24,9,15,296,6,16
68,25,11,14,312,8,20
70,18,6,12,307,11,24
67,17,5,12,314,13,14
64,17,5,12,322,20,15
61,15,4,11,330,27,23
64,14,3,11,325,25,19
67,13,2,11,313,24,11
70,18,2,16,303,31,10
75,16,2,14,294,13,9
76,14,2,12,291,10,8
79,17,2,15,286,3,10
80,14,1,13,285,1,10
82,16,2,14,282,0,13
82,15,2,13,279,0,14
85,13,1,12,276,0,14
84,14,1,13,278,0,12
84,16,3,13,277,1,11
85,13,2,11,274,0,10
84,5,0,5,264,9,12
86,3,0,3,253,16,13
91,3,0,3,247,20,0
94,4,0,4,241,21,2
94,5,0,5,239,21,0
94,4,0,4,239,23,7
94,4,0,4,241,24,0
92,4,0,4,244,21,13
88,3,0,3,246,22,4
87,4,0,4,248,20,16
90,4,0,4,249,22,7
87,4,0,4,250,24,9
80,4,0,4,254,26,8
76,3,0,3,256,26,13
79,3,0,3,254,27,10
81,3,0,3,249,27,8
83,3,0,3,247,25,3
81,4,0,4,243,28,7
80,3,0,3,241,28,0
80,4,0,4,240,26,13
80,4,0,4,237,27,4
80,3,0,3,238,30,6
76,5,0,5,239,26,9
78,6,0,6,238,21,4
73,7,0,7,237,16,12
78,10,0,10,236,14,2
72,7,0,7,236,15,12
70,9,0,9,236,14,4
70,9,0,9,241,16,9
68,4,0,4,242,23,11
68,6,0,6,245,26,10
67,7,1,6,249,27,6
69,7,0,7,249,28,10
69,9,1,8,257,26,9
69,6,0,6,265,32,15
71,6,0,6,264,33,19
84,6,0,6,256,31,11
84,5,0,5,249,26,2
87,6,0,6,245,24,3
84,8,1,7,243,24,2
84,7,0,7,241,24,19
85,6,0,6,238,23,3
86,4,0,4,234,23,17
86,4,0,4,232,24,5
88,4,0,4,232,21,15
91,4,0,4,231,20,8
92,4,0,4,230,19,6
92,5,0,5,230,16,15
93,7,0,7,231,12,4
92,8,0,8,231,11,12
92,8,0,8,232,6,9
92,11,1,10,233,5,14
92,13,3,10,236,3,6
88,11,3,8,246,8,20
84,12,5,7,259,8,14
78,11,4,7,269,9,16
72,9,3,6,282,12,14
67,8,2,6,297,16,14
61,6,1,5,306,19,8
56,5,1,4,318,18,12
53,5,1,4,325,21,20
59,4,0,4,319,21,7
63,8,1,7,312,18,0
66,10,1,9,301,18,7
69,7,1,6,290,10,8
71,4,0,4,282,7,8
74,4,0,4,278,6,9
77,12,3,9,274,6,13
79,7,1,6,272,6,10
82,12,2,10,269,4,14
84,11,1,10,263,1,14
85,10,1,9,259,2,11
87,7,1,6,256,3,9
88,5,0,5,255,3,20
88,6,1,5,254,3,18
90,7,2,5,253,3,20
87,10,4,6,258,3,10
83,10,5,5,267,4,23
74,7,3,4,281,7,16
70,6,2,4,289,10,18
63,5,1,4,306,13,7
59,5,1,4,311,21,11
62,4,0,4,309,29,14
70,6,1,5,302,29,7
68,6,1,5,294,20,12
69,6,1,5,289,14,7
75,7,1,6,286,11,3
83,8,1,7,276,10,9
87,5,0,5,265,6,9
88,5,1,4,255,8,8
89,3,0,3,250,12,1
89,3,0,3,247,13,9
89,3,0,3,247,12,5
89,2,0,2,246,14,14
89,3,0,3,245,13,6
89,2,0,2,244,14,13
88,3,0,3,243,12,2
87,4,0,4,243,9,7
87,3,0,3,243,9,5
87,3,0,3,244,9,2
86,4,1,3,247,9,10
83,5,1,4,252,8,6
80,5,2,3,259,8,10
79,3,1,2,265,11,10
74,3,1,2,275,12,8
73,2,0,2,276,13,8
69,2,0,2,283,13,5
65,2,0,2,285,15,10
62,2,0,2,291,14,4
63,2,0,2,292,15,2
66,3,0,3,290,16,2
69,5,1,4,284,17,6
69,4,0,4,279,14,4
68,6,0,6,274,11,1
72,4,0,4,268,12,0
75,3,0,3,264,13,2
79,6,1,5,260,11,2
82,3,0,3,256,10,3
84,3,0,3,253,12,1
85,17.61529679,3.558405625,14.05689116,250,14,8
86,2,0,2,247,14,1
86,3,0,3,247,12,6
87,3,0,3,245,11,1
87,5,1,4,246,9,10
85,6,1,5,250,9,3
78,8,3,5,265,9,13
69,10,4,6,281,10,17
62,8,2,6,299,25.76770789,11
57,17.60708004,3.556909373,14.05017066,316,18,12
57,12,2,10,318,25,11
54,9,2,7,326,32,7
50,12,1,11,336,38,20
50,9,0,9,341,74,24
51,11,0,11,333,51,17
50,11,1,10,326,38,10
53,7,0,7,319,17,0
65,15,1,14,304,10,0
68,19,1,18,300,8,7
73,13,1,12,294,4,7
77,23,2,21,288,2,9
80,12,1,11,281,5,9
82,6,0,6,276,9,6
85,7,0,7,275,8,8
86,14,1,13,275,3,14
83,17,1,16,275,1,13
84,16,1,15,273,0,14
85,15,2,13,273,1,9
84,19,5,14,275,1,13
81,23,8,15,278,3,12
79,23,8,15,281,3,18
75,19,6,13,290,6,16
75,18,5,13,294,7,18
72,14,3,11,300,8,13
71,11,2,9,302,14,15
64,7,1,6,306,28,19
68,4,0,4,292,29,19
79,4,0,4,276,24,13
80,4,0,4,271,24,7
82,4,0,4,266,23,7
88,7,1,6,257,21,9
89,4,0,4,248,22,0
90,3,0,3,243,26,11
89,3,0,3,241,22,2
90,4,0,4,238,19,10
91,4,0,4,234,17,6
91,2,0,2,229,18,0
90,2,0,2,227,18,10
89,2,0,2,224,17,0
89,3,0,3,222,17,17
87,2,0,2,220,16,0
87,3,0,3,218,17,4
84,5,0,5,219,16,3
81,5,1,4,225,18,6
78,5,1,4,230,19,10
75,4,1,3,237,17,0
71,4,1,3,244,16,16
70,4,1,3,249,16,11
69,3,0,3,254,20,6
69,3,0,3,255,22,6
69,3,0,3,255,22,6
70,3,0,3,254,23,7
72,4,0,4,249,23,4
78,3,0,3,242,25,3
78,3,0,3,234,26,0
77,4,0,4,231,23,6
74,5,0,5,229,20,4
73,4,0,4,227,18,7
74,4,0,4,223,15,3
76,6,0,6,220,15,0
79,6,0,6,215,14,5
80,6,0,6,214,13,0
81,6,0,6,211,12,8
82,7,0,7,210,9,0
83,8,0,8,208,7,7
83,9,0,9,207,4,0
80,11,2,9,211,5,12
76,11,3,8,219,6,1
72,12,4,8,231,8,18
70,10,3,7,239,9,8
68,6,1,5,253,12,8
63,5,1,4,267,17,9
62,3,0,3,278,20,11
60,4,0,4,284,22,10
62,4,0,4,280,26,6
66,4,0,4,274,24,7
66,5,0,5,273,24,0
67,8,1,7,270,21,5
68,13,1,12,266,19,9
69,11,1,10,259,14,9
70,5,0,5,251,14,4
71,5,0,5,249,14,0
72,8,0,8,249,11,9
79,6,0,6,243,15,1
79,5,0,5,241,16,5
82,5,0,5,238,14,8
83,5,0,5,235,12,6
84,4,0,4,232,13,3
85,5,0,5,232,13,7
85,5,0,5,232,11,0
89,6,0,6,231,12,17
88,8,1,7,232,12,0
87,7,1,6,237,10,20
85,7,1,6,244,10,6
80,8,2,6,253,11,17
76,8,2,6,268,15,16
72,7,1,6,279,22,18
69,6,1,5,287,28,12
72,7,1,6,287,25,13
69,7,1,6,287,19,8
74,9,1,8,288,19,8
79,12,1,11,279,18,9
79,12,1,11,277,16,7
81,10,0,10,273,16,11
80,8,0,8,272,12,10
84,6,0,6,268,10,4
88,4,0,4,262,10,5
90,4,0,4,259,9,3
91,3,0,3,257,9,0
92,5,0,5,257,8,6
92,8,0,8,255,4,1
92,6,0,6,254,4,12
93,4,0,4,249,6,13
93,6,0,6,248,2,12
94,7,1,6,250,2,27
91,6,1,5,254,6,15
89,4,1,3,256,6,15
86,6,2,4,262,5,15
79,6,2,4,278,8,13
72,7,2,5,294,12,18
68,6,1,5,301,27,14
68,5,0,5,303,35,15
64,4,0,4,310,38,8
66,4,0,4,315,36,21
64,5,0,5,317,33,9
64,6,1,5,312,47,15
72,6,1,5,304,25,10
76,4,0,4,295,16,5
80,5,0,5,289,18,7
81,6,0,6,284,24,13
83,7,0,7,282,24,21
84,6,0,6,275,18,22
86,3,0,3,269,10,14
87,3,0,3,266,8,7
88,4,0,4,264,8,7
88,6,0,6,262,6,7
89,5,0,5,262,8,6
89,4,0,4,261,8,11
89,5,1,4,261,7,15
87,4,1,3,267,7,14
84,6,2,4,276,10,20
80,4,1,3,285,11,18
74,5,1,4,299,16,18
67,5,1,4,310,30,19
64,4,0,4,317,38,31
65,4,0,4,319,43,22
61,4,0,4,330,41,17
68,7,1,6,319,51,26
68,6,1,5,317,51,31
68,4,0,4,316,40,20
66,5,0,5,308,29,21
75,11,1,10,298,14,11
74,8,1,7,292,13,8
77,10,1,9,288,13,7
80,11,1,10,285,11,9
83,11,1,10,282,11,12
85,10,1,9,280,8,14
86,7,1,6,277,6,15
88,17.4662097,3.519556912,13.94665279,275,4,18
87,9,2,7,275,3,15
88,8,1,7,275,5,17
88,9,1,8,273,3,17
88,8,2,6,274,2,17
83,12,5,7,283,3,13
76,14,7,7,293,4,16
69,12,6,6,303,25.63667414,24
63,10,4,6,318,9,18
56,17.46133471,3.5195437,13.94179101,326,8,13
53,8,3,5,332,8,12
55,10,2,8,341,13,12
57,9,2,7,339,17,13
57,12,3,9,331,13,15
60,6,1,5,325,13,3
66,8,2,6,314,11,9
70,7,1,6,307,10,3
74,5,1,4,302,11,10
82,4,0,4,286,9,12
87,3,0,3,278,12,6
87,5,0,5,280,12,6
84,5,0,5,276,16,8
92,2,0,2,268,20,11
91,2,0,2,273,15,11
86,4,0,4,280,14,16
85,4,0,4,281,18,25
85,4,0,4,281,19,32
82,6,0,6,286,25,31
80,6,0,6,287,27,31
80,7,1,6,287,23,26
79,8,1,7,286,22,24
73,11,3,8,290,20,18
72,12,3,9,288,22,14
63,9,2,7,302,26,9
60,8,1,7,313,35,10
57,10,1,9,326,49,9
56,13,1,12,330,51,20
55,12,1,11,331,49,10
58,14,1,13,322,44,10
60,13,1,12,319,38,1
65,14,1,13,317,41,6
69,20,1,19,308,61,16
69,9,0,9,302,43,14
74,10,0,10,296,30,12
77,8,0,8,294,25,10
80,9,0,9,288,15,14
81,12,0,12,284,15,14
81,12,1,11,282,14,12
82,15,1,14,277,11,14
82,11,1,10,275,5,15
81,12,1,11,273,3,16
81,13,1,12,271,8,13
80,11,1,10,270,7,12
78,13,3,10,276,9,11
72,12,3,9,289,13,23
63,8,1,7,310,24,18
56,8,1,7,333,30,19
49,9,1,8,350,41,22
45,8,0,8,364,50,23
47,8,0,8,362,53,20
45,12,0,12,369,90,24
47,8,0,8,365,113,18
61,8,0,8,338,63,15
86,11,1,10,289,71,0
85,8,0,8,289,49,10
83,16,1,15,278,23,17
82,13,0,13,272,15,13
82,20,1,19,269,11,12
83,26,2,24,266,7,18
83,15,1,14,264,7,20
82,18,1,17,263,4,15
82,13,1,12,261,6,15
82,12,1,11,261,7,14
83,11,1,10,260,6,16
84,9,0,9,259,7,14
86,5,0,5,257,9,16
87,5,0,5,256,10,12
86,4,0,4,255,10,11
85,6,1,5,256,7,13
83,7,2,5,256,7,20
81,7,2,5,261,7,18
78,8,2,6,268,9,17
76,8,2,6,274,11,21
75,9,2,7,277,14,23
75,10,2,8,276,16,25
74,7,1,6,274,20,21
76,4,0,4,265,20,13
76,4,1,3,259,20,11
77,5,1,4,254,21,9
78,3,0,3,249,19,4
78,3,0,3,246,19,11
79,3,0,3,243,20,7
79,3,0,3,242,20,8
80,2,0,2,241,18,9
81,2,0,2,240,16,0
86,1,0,1,235,17,14
88,1,0,1,230,17,0
91,1,0,1,227,16,11
92,1,0,1,226,15,0
92,3,0,3,224,14,13
92,3,0,3,224,13,2
92,3,0,3,225,13,4
92,3,0,3,226,13,9
92,3,0,3,228,11,0
89,4,1,3,232,11,14
88,4,1,3,234,12,3
86,4,1,3,237,13,12
79,3,1,2,248,15,5
79,4,1,3,249,18,18
78,2,0,2,250,17,9
79,2,0,2,249,17,9
78,2,0,2,247,17,2
79,2,0,2,243,17,9
81,5,1,4,238,18,1
83,3,0,3,234,18,6
83,2,0,2,233,17,3
85,2,0,2,231,17,13
85,2,0,2,229,16,4
86,3,0,3,228,15,9
86,3,0,3,227,13,13
85,3,0,3,226,13,5
84,2,0,2,225,12,14
88,2,0,2,223,12,3
90,3,0,3,221,11,12
92,4,0,4,219,10,3
91,5,0,5,219,8,6
92,8,2,6,221,6,14
90,11,4,7,226,6,9
88,11,4,7,232,6,15
84,7,2,5,242,10,9
80,8,2,6,251,13,17
75,5,1,4,263,17,17
72,5,1,4,277,22,15
72,3,0,3,279,26,12
72,3,0,3,278,25,10
74,3,0,3,275,21,10
75,3,0,3,271,19,5
80,4,0,4,264,17,4
81,6,1,5,256,16,1
83,3,0,3,248,17,1
84,4,0,4,246,17,0
84,4,0,4,245,15,9
85,3,0,3,244,14,3
86,4,0,4,243,14,5
86,3,0,3,243,13,3
86,3,0,3,244,12,5
86,4,0,4,244,10,6
86,5,0,5,245,7,5
85,7,1,6,245,7,9
85,8,2,6,249,8,8
81,9,3,6,258,7,12
73,7,2,5,274,10,14
66,4,1,3,292,13,20
65,4,1,3,292,14,11
65,3,0,3,295,18,3
59,4,1,3,310,17,2
59,4,1,3,317,16,0
60,2,0,2,314,16,6
60,2,0,2,311,16,3
64,2,0,2,301,18,3
70,3,0,3,289,20,0
74,3,0,3,279,19,3
78,4,0,4,265,17,0
81,6,0,6,259,14,9
82,3,0,3,258,16,13
84,2,0,2,252,18,10
84,1,0,1,250,18,4
82,1,0,1,250,18,8
83,17.31710582,3.482289479,13.83481634,250,18,7
83,2,0,2,249,18,9
83,2,0,2,248,17,2
89,1,0,1,246,15,11
91,1,0,1,244,13,0
91,2,0,2,243,12,12
91,2,0,2,243,11,1
90,3,0,3,246,10,5
90,17.30809427,3.480259666,13.8278346,248,10,14
88,3,1,2,251,25.53754026,3
84,4,1,3,255,10,12
82,4,1,3,258,11,10
82,3,0,3,257,13,11
82,3,0,3,259,14,8
81,5,1,4,261,14,8
83,3,0,3,258,15,13
83,2,0,2,255,14,10
85,6,1,5,252,12,5
86,3,0,3,249,12,0
87,3,0,3,247,13,5
87,3,0,3,247,13,1
87,3,0,3,246,14,6
87,2,0,2,243,14,2
87,2,0,2,242,15,2
88,1,0,1,241,14,6
88,1,0,1,240,14,4
90,2,0,2,239,14,9
91,2,0,2,237,13,0
91,2,0,2,237,13,13
91,2,0,2,238,12,0
90,2,0,2,242,12,10
89,3,0,3,247,12,2
87,5,1,4,253,12,13
89,6,1,5,256,12,7
89,7,2,5,260,13,12
91,5,1,4,253,15,10
93,6,1,5,247,16,4
94,4,0,4,248,14,0
92,2,0,2,243,16,1
93,2,0,2,244,16,0
93,6,1,5,244,15,5
94,5,0,5,241,14,3
93,3,0,3,237,17,0
93,2,0,2,232,17,9
93,2,0,2,230,17,0
94,2,0,2,229,18,11
94,1,0,1,228,18,0
94,1,0,1,229,18,10
94,1,0,1,229,18,3
94,1,0,1,226,20,0
94,1,0,1,223,21,5
94,1,0,1,223,20,0
92,2,0,2,222,20,11
91,2,0,2,224,17,0
89,2,0,2,226,14,17
89,2,0,2,228,14,0
86,2,0,2,230,13,5
88,5,1,4,229,13,15
91,5,1,4,228,12,0
92,6,1,5,225,13,6
93,6,1,5,226,12,1
92,6,1,5,228,13,3
92,5,0,5,229,13,12
92,5,0,5,229,13,2
92,6,0,6,228,11,11
93,7,0,7,226,8,0
94,7,0,7,225,10,11
94,6,0,6,224,10,0
93,6,0,6,222,10,4
94,6,0,6,219,13,8
95,4,0,4,217,13,0
94,4,0,4,215,14,10
93,3,0,3,213,17,0
94,2,0,2,215,15,10
94,4,0,4,216,11,0
94,7,0,7,216,8,1
94,8,1,7,217,9,5
94,10,2,8,220,8,0
93,9,2,7,224,7,10
91,10,3,7,230,8,0
84,9,3,6,244,10,13
80,6,1,5,254,11,10
76,6,1,5,261,16,13
74,4,0,4,273,18,8
69,4,0,4,277,19,5
69,3,0,3,280,20,5
69,3,0,3,282,21,6
71,3,0,3,278,20,7
71,6,1,5,270,19,4
76,7,1,6,263,19,1
80,5,0,5,258,18,3
81,4,0,4,255,17,3
84,3,0,3,253,17,3
86,3,0,3,251,16,7
87,3,0,3,250,16,3
88,2,0,2,249,16,11
89,2,0,2,248,14,5
89,2,0,2,247,13,14
89,4,0,4,247,12,5
89,3,0,3,245,11,13
89,5,0,5,246,10,7
89,6,1,5,247,10,10
87,6,1,5,251,10,8
82,7,2,5,262,10,13
73,8,2,6,279,13,19
64,11,2,9,292,16,27
60,11,2,9,299,20,14
59,8,1,7,304,24,7
61,10,1,9,304,25,2
65,7,0,7,300,29,9
73,13,1,12,294,23,13
76,13,1,12,290,22,16
78,11,1,10,284,16,12
81,14,1,13,281,13,10
83,14,1,13,278,9,9
85,22,2,20,276,5,8
88,13,1,12,271,2,10
91,11,1,10,269,2,13
90,14,2,12,268,0,11
90,18,1,17,266,2,15
92,15,1,14,264,2,13
92,13,1,12,262,0,9
93,11,0,11,260,0,7
93,11,1,10,259,0,11
93,14,5,9,259,0,9
93,14,6,8,259,1,11
92,10,4,6,262,3,13
89,10,4,6,264,4,13
81,10,4,6,278,8,16
77,10,3,7,285,14,24
74,7,1,6,297,22,23
82,6,1,5,283,29,24
75,6,1,5,291,24,10
74,6,1,5,294,29,14
76,5,1,4,283,30,22
79,3,0,3,270,23,18
83,4,0,4,252,24,6
90,7,0,7,238,32,0
89,7,0,7,233,33,0
91,4,0,4,234,25,5
92,5,0,5,233,16,5
92,7,0,7,231,11,0
92,9,0,9,231,16,17
92,7,0,7,230,22,0
91,5,0,5,231,18,14
91,7,0,7,232,21,1
92,8,0,8,233,19,4
91,6,0,6,233,15,14
88,5,0,5,233,12,0
86,7,1,6,234,10,10
84,8,2,6,243,10,1
79,7,2,5,253,12,14
77,6,1,5,261,15,15
74,6,1,5,268,20,13
69,5,1,4,277,24,8
68,4,0,4,283,28,8
65,3,0,3,288,30,9
68,3,0,3,286,31,8
72,3,0,3,281,26,7
72,3,0,3,276,24,3
75,3,0,3,270,24,0
78,5,1,4,264,22,0
80,3,0,3,258,21,2
81,3,0,3,256,18,0
82,4,0,4,254,16,1
83,4,0,4,253,17,6
86,2,0,2,250,18,4
86,2,0,2,249,17,5
86,17.15516576,3.442922063,13.7122437,249,16,5
87,3,0,3,248,16,5
87,3,0,3,246,14,6
87,4,0,4,246,12,7
87,6,0,6,245,10,6
86,7,1,6,247,10,8
83,8,2,6,257,9,7
77,8,2,6,268,25.39359363,15
72,8,2,6,280,25.39359363,12.31547993
67,17.14775557,3.441235138,13.70652043,291,22,16
64,6,1,5,299,29,14
62,5,0,5,303,36,20
56,6,0,6,311,50,13
62,6,0,6,317,41,23
65,5,0,5,308,34,12
67,5,0,5,299,23,1
70,7,0,7,293,31,8
72,16,0,16,287,24,13
75,19,1,18,281,17,7
77,14,0,14,278,15,8
78,13,0,13,274,19,9
78,18,1,17,272,21,9
80,18,1,17,271,16,7
83,10,0,10,269,20,10
86,10,0,10,266,18,7
86,11,0,11,264,10,11
84,15,1,14,263,8,12
81,15,1,14,262,9,16
85,13,1,12,263,16,12
83,14,1,13,268,13,14
79,22,4,18,272,10,20
73,22,5,17,287,14,24
72,21,6,15,295,15,28
69,24,5,19,299,17,30
67,19,3,16,305,26,25
65,14,2,12,316,29,21
67,10,1,9,312,29,28
70,10,1,9,307,24,26
73,13,2,11,301,20,20
74,14,2,12,299,16,20
77,13,2,11,291,11,19
80,22,4,18,287,3,19
82,21,4,17,284,1,16
83,20,6,14,282,0,17
84,19,6,13,280,0,20
84,16,3,13,280,0,18
84,20,5,15,280,0,19
78,20,5,15,267,4,17
79,16,2,14,264,11,14
80,11,0,11,262,13,9
83,11,0,11,260,16,12
85,15,1,14,258,13,14
86,18,2,16,258,4,17
80,18,3,15,266,9,24
74,12,3,9,279,14,26
69,13,3,10,291,14,28
61,12,2,10,308,19,16
56,15,2,13,320,28,20
54,12,1,11,323,32,21
50,10,1,9,333,41,12
47,7,0,7,341,50,22
44,5,0,5,343,44,17
42,6,0,6,343,45,8
43,8,0,8,339,42,5
47,8,0,8,333,41,3
50,12,0,12,326,34,0
53,15,0,15,319,26,2
57,28,1,27,315,22,12
66,49,2,47,310,17,25
69,54,2,52,307,10,39
61,48,2,46,303,6,36
64,35,2,33,298,6,18
66,26,1,25,295,3,14
67,23,1,22,290,6,15
76,19,1,18,280,2,15
78,21,2,19,272,3,16
76,21,3,18,270,4,17
71,18,4,14,276,7,16
70,15,2,13,281,7,21
65,23,5,18,289,8,21
59,27,6,21,304,12,24
52,16,2,14,327,27,22
48,18,1,17,340,55,35
40,18,1,17,344,59,28
42,15,1,14,350,49,11
38,12,0,12,353,52,15
48,12,0,12,349,53,13
51,13,0,13,333,58,16
58,21,0,21,321,47,9
59,29,1,28,313,40,12
61,27,1,26,308,38,22
66,26,1,25,303,25,19
67,27,1,26,300,22,26
73,15,0,15,294,38,28
76,14,0,14,290,37,32
78,18,1,17,288,29,35
78,20,1,19,288,16,42
79,23,1,22,287,6,48
75,31,2,29,284,8,44
76,35,3,32,283,10,38
79,42,8,34,284,2,37
78,52,16,36,287,5,46
74,42,14,28,297,10,37
68,29,5,24,308,23,33
59,30,4,26,331,35,35
55,24,2,22,336,56,47
50,16,0,16,342,67,27
44,10,0,10,353,59,29
46,9,0,9,354,56,33
43,9,0,9,354,44,20
45,9,0,9,351,38,13
47,6,0,6,346,44,13
49,9,0,9,341,42,5
62,16,1,15,328,51,13
62,15,1,14,320,53,26
68,13,0,13,314,47,32
67,11,0,11,309,61,40
65,12,0,12,308,63,39
64,13,0,13,305,58,31
67,12,0,12,301,51,29
71,10,0,10,296,41,30
75,10,0,10,290,37,38
78,9,0,9,284,38,38
80,8,0,8,280,39,48
80,11,0,11,281,27,48
80,15,1,14,288,22,45
79,17,2,15,291,19,45
74,20,3,17,300,27,50
68,16,1,15,313,41,51
63,15,1,14,317,56,46
66,13,1,12,314,61,44
64,8,0,8,317,57,39
61,6,0,6,311,55,28
66,11,1,10,304,53,21
68,9,0,9,304,54,25
65,10,0,10,304,52,23
61,7,0,7,294,45,19
64,8,0,8,290,37,10
66,7,0,7,283,31,9
62,7,0,7,280,34,12
65,7,0,7,278,34,10
69,8,0,8,274,29,12
70,6,0,6,272,27,13
69,5,0,5,270,28,12
70,4,0,4,267,25,14
69,4,0,4,265,29,10
62,3,0,3,262,33,10
66,3,0,3,260,36,10
68,2,0,2,256,35,14
60,3,0,3,256,34,12
58,3,0,3,262,33,14
61,3,0,3,267,32,16
61,4,0,4,270,31,19
54,5,0,5,291,30,11
50,5,0,5,294,37,16
45,4,0,4,297,41,12
40,4,0,4,303,42,8
38,3,0,3,302,43,7
35,4,0,4,305,45,10
41,5,0,5,289,45,9
50,5,0,5,280,41,11
59,7,0,7,269,37,10
67,5,0,5,262,34,11
71,5,0,5,255,33,9
71,4,0,4,249,34,6
72,4,0,4,245,33,15
72,4,0,4,241,32,7
71,5,0,5,239,30,9
73,17.11352153,3.413860966,13.69966056,236,27,10
73,7,0,7,235,24,9
76,6,0,6,231,19,15
77,8,0,8,225,11,7
78,17,1,16,223,9,17
76,19,3,16,229,7,10
72,17,3,14,240,12,27
63,13,2,11,256,25.43544907,12
63,16,2,14,262,25.43544907,22
60,12,1,11,279,33,18
58,17.11036111,3.412344424,13.69801668,289,41,21
56,17.11036111,3.412344424,13.69801668,296,48,14
51,9,1,8,311,56,19
50,8,0,8,312,65,28
49,12,1,11,315,61,15
53,11,0,11,309,70,15
59,15,1,14,300,47,13
65,16,1,15,291,32,12
74,10,0,10,283,32,9
75,11,0,11,278,28,13
79,7,0,7,274,27,13
81,5,0,5,272,30,13
83,6,0,6,271,26,17
84,6,0,6,270,25,21
85,7,0,7,268,21,19
86,7,0,7,266,19,19
86,7,0,7,267,17,21
88,10,0,10,266,10,22
87,11,1,10,270,6,20
85,14,3,11,276,5,23
81,22,11,11,284,3,23
72,17,10,7,300,4,23
70,13,7,6,300,4,18
68,12,6,6,304,5,10
67,10,4,6,310,6,9
66,10,4,6,314,9,9
65,9,3,6,318,11,8
66,10,3,7,315,11,9
69,14,5,9,308,9,6
72,15,5,10,304,8,12
74,17,4,13,297,5,14
78,14,2,12,289,1,16
81,15,3,12,286,0,9
82,14,4,10,282,0,10
83,12,2,10,280,0,12
84,13,3,10,278,0,9
84,12,2,10,277,0,13
87,8,1,7,275,0,12
87,6,1,5,275,0,10
86,7,1,6,276,0,10
87,9,1,8,273,0,11
87,13,2,11,273,0,10
86,18,6,12,275,0,15
82,29,18,11,282,1,18
74,33,18,15,289,7,25
67,26,10,16,305,11,25
66,25,9,16,315,14,25
60,17,4,13,326,20,27
60,11,2,9,326,32,21
62,7,1,6,308,35,27
61,6,1,5,310,34,15
63,5,1,4,304,33,9
70,6,1,5,281,34,13
73,6,1,5,267,33,8
77,4,0,4,259,34,7
82,5,0,5,255,32,3
87,5,0,5,250,27,11
87,6,1,5,247,24,7
86,5,0,5,243,23,20
86,3,0,3,240,24,6
86,2,0,2,240,26,12
86,3,0,3,240,24,12
85,2,0,2,240,23,10
85,3,0,3,236,21,14
88,4,0,4,232,20,7
85,5,0,5,236,19,11
88,6,0,6,236,14,6
91,10,1,9,231,13,16
90,5,0,5,226,20,0
90,4,1,3,216,26,5
90,5,1,4,213,24,0
90,5,1,4,209,24,6
90,5,1,4,206,27,0
89,3,0,3,208,32,7
86,3,0,3,210,33,1
83,5,0,5,208,31,11
80,4,0,4,209,31,0
74,5,0,5,212,34,14
74,5,0,5,213,37,0
75,5,0,5,211,37,3
72,4,0,4,212,41,3
71,3,0,3,211,40,8
71,5,0,5,208,33,0
72,6,0,6,207,35,8
73,4,0,4,205,33,8
73,5,0,5,205,33,1
74,4,0,4,205,34,6
74,4,0,4,205,32,0
74,4,0,4,205,32,1
76,3,0,3,204,34,8
77,5,0,5,204,36,0
74,6,0,6,209,29,0
66,7,1,6,219,25,14
60,6,1,5,232,25,9
51,5,1,4,240,28,7
51,5,1,4,248,29,5
50,6,1,5,258,31,9
47,5,0,5,264,34,13
48,4,0,4,263,37,10
57,3,0,3,246,35,4
60,3,0,3,233,36,0
58,3,0,3,225,35,0
63,3,0,3,215,37,14
66,4,0,4,213,37,0
65,4,0,4,213,38,9
68,3,0,3,212,39,0
74,4,0,4,205,36,10
85,4,0,4,189,34,0
85,5,0,5,183,35,0
86,4,0,4,188,29,0
84,4,0,4,185,25,8
85,4,0,4,183,26,5
89,4,0,4,179,26,5
93,3,0,3,173,29,6
93,4,0,4,173,30,2
94,6,0,6,173,28,5
93,5,0,5,174,25,5
92,9,1,8,176,23,4
88,8,1,7,181,26,7
88,9,1,8,184,23,5
79,7,1,6,205,23,3
69,5,1,4,224,26,17
65,5,1,4,234,30,28
64,3,0,3,238,32,8
60,3,0,3,241,31,7
60,3,0,3,237,34,1
61,3,0,3,231,35,2
65,5,0,5,226,32,0
64,3,0,3,222,34,0
66,3,0,3,217,33,4
69,4,0,4,208,31,0
71,8,0,8,201,29,0
74,7,0,7,197,26,4
75,6,0,6,194,22,5
77,7,0,7,192,20,0
76,9,0,9,191,19,4
77,10,0,10,188,18,3
79,10,1,9,187,15,8
80,10,1,9,187,9,7
76,16,3,13,195,10,10
68,14,3,11,212,18,26
59,15,3,12,233,19,13
54,14,2,12,250,28,13
49,10,1,9,262,43,12
55,15,1,14,251,50,14
56,24,3,21,254,26,12
54,20,3,17,263,32,9
53,12,1,11,261,42,17
58,15,1,14,258,42,14
63,7,0,7,251,44,7
67,6,0,6,246,42,6
69,11,1,10,242,40,6
70,9,0,9,238,35,3
71,14,0,14,234,29,16
71,17,1,16,230,26,9
73,16,1,15,228,25,12
74,13,1,12,226,21,12
74,15,1,14,229,22,3
73,17.00174725,3.386488708,13.61525854,229,17,19
65,14,1,13,224,18,5
76,9,0,9,215,14,12
80,12,1,11,211,7,3
82,10,1,9,211,5,12
79,10,1,9,213,12,14
74,9,1,8,216,13,14
77,9,1,8,216,14,9
84,12,2,10,211,25.42963751,4
86,11,2,9,206,13,13
78,16.99719146,3.3848524,13.61233906,207,17,0
75,8,1,7,213,16,13
68,7,1,6,226,18,16
62,6,1,5,231,23,11
65,7,1,6,236,25,10
67,5,0,5,234,25,8
73,8,1,7,229,27,4
77,9,1,8,226,25,6
78,7,0,7,223,25,14
78,8,1,7,222,22,8
82,6,0,6,217,22,15
83,5,0,5,217,16,3
87,5,0,5,209,16,10
90,5,0,5,205,13,8
90,5,0,5,204,11,6
91,5,0,5,205,10,16
91,5,0,5,206,10,3
90,7,0,7,206,6,13
90,10,1,9,206,3,16
87,14,2,12,207,3,6
85,24,9,15,212,4,18
77,15,4,11,224,10,13
72,12,2,10,235,17,17
71,15,3,12,243,20,20
66,9,1,8,260,26,17
65,7,1,6,268,31,21
65,6,1,5,267,35,12
65,4,0,4,269,33,10
65,4,0,4,270,35,10
69,6,1,5,263,33,12
74,8,1,7,250,31,8
77,9,1,8,243,29,5
81,5,0,5,235,27,4
84,6,0,6,230,28,8
85,5,0,5,227,27,7
86,4,0,4,227,28,15
88,2,0,2,226,30,6
91,3,0,3,223,27,17
91,2,0,2,220,25,0
93,2,0,2,218,24,13
93,4,0,4,219,18,0
88,8,0,8,217,16,16
91,9,0,9,209,32,0
93,9,0,9,209,30,6
91,12,0,12,211,28,5
91,9,0,9,213,29,0
91,12,1,11,217,24,13
91,13,1,12,221,20,2
89,11,1,10,228,21,8
89,8,1,7,231,21,9
89,8,1,7,232,21,6
89,7,1,6,230,22,2
89,7,1,6,231,23,4
90,8,1,7,228,21,10
91,8,1,7,226,21,3
92,11,1,10,223,22,16
92,6,0,6,222,24,0
91,4,0,4,220,25,2
91,5,0,5,219,26,9
91,5,0,5,219,21,5
91,5,0,5,218,23,3
91,4,0,4,216,23,10
91,4,0,4,216,22,0
91,3,0,3,215,23,16
92,3,0,3,214,20,0
92,4,0,4,213,21,11
92,4,0,4,213,22,2
91,5,0,5,216,21,10
89,7,1,6,220,19,13
84,8,1,7,230,20,16
82,8,1,7,237,24,18
83,12,1,11,240,28,20
86,19,2,17,240,19,22
88,12,1,11,238,19,13
90,11,1,10,238,16,24
91,13,1,12,239,13,18
91,11,1,10,239,11,27
92,12,1,11,233,13,26
92,11,1,10,229,16,16
92,13,1,12,225,15,18
93,10,0,10,223,19,31
93,6,0,6,222,19,11
93,6,0,6,222,23,25
94,6,0,6,222,24,13
93,5,0,5,220,25,10
93,5,0,5,220,24,18
94,5,0,5,220,21,3
94,5,0,5,219,22,17
94,4,0,4,218,21,3
94,5,0,5,217,21,16
93,5,0,5,218,18,8
93,10,1,9,221,17,7
91,7,1,6,228,16,28
90,7,1,6,228,15,16
90,8,1,7,230,16,25
86,6,1,5,233,21,10
77,6,1,5,246,28,16
72,6,1,5,264,31,15
66,6,1,5,272,34,20
63,6,1,5,278,36,8
64,4,0,4,275,37,13
68,5,0,5,262,36,11
70,7,1,6,253,40,5
70,7,0,7,245,36,0
71,19,2,17,239,27,0
74,17,1,16,233,20,7
78,15,1,14,229,18,6
77,14,1,13,229,17,16
80,13,1,12,226,20,4
82,13,1,12,225,19,19
82,13,1,12,225,16,5
83,15,1,14,221,22,13
85,14,1,13,217,20,9
86,11,1,10,213,10,1
86,10,1,9,214,19,17
85,15,2,13,218,11,0
83,19,4,15,224,9,29
74,19,4,15,242,17,18
68,16,2,14,249,25,29
56,12,1,11,269,36,23
48,12,1,11,281,50,18
49,11,1,10,288,55,10
46,9,0,9,290,66,14
47,10,0,10,293,77,15
48,8,0,8,284,80,17
52,5,0,5,275,58,13
58,6,0,6,261,46,12
63,11,1,10,253,38,10
64,15,1,14,248,31,8
66,15,0,15,245,27,6
70,15,1,14,240,26,11
74,15,1,14,238,24,10
74,15,1,14,236,19,16
74,16,1,15,234,18,8
78,21,2,19,231,18,16
82,18,1,17,228,17,11
83,17,1,16,224,12,8
83,15,1,14,222,7,18
83,16,2,14,224,4,7
81,17,3,14,231,6,21
78,21,4,17,242,16,19
74,20,2,18,253,19,24
63,18,2,16,271,25,20
59,10,1,9,281,36,20
58,8,1,7,289,40,12
54,8,1,7,294,48,11
54,6,0,6,296,49,11
53,7,1,6,297,49,13
55,5,0,5,295,47,11
59,5,0,5,281,42,4
63,7,0,7,272,39,12
65,10,1,9,266,36,8
68,5,0,5,264,37,8
70,9,0,9,260,37,12
72,11,0,11,255,28,14
74,14,0,14,252,28,17
77,10,0,10,250,28,12
79,10,0,10,248,28,14
81,16.90072187,3.352624685,13.54809719,246,24,10
83,10,1,9,245,21,12
84,11,1,10,242,16,15
84,13,1,12,241,14,11
84,22,4,18,240,11,14
82,29,9,20,247,10,11
74,25,5,20,260,21,25
70,12,1,11,266,29,20
66,9,1,8,273,33,15
59,11,1,10,284,35,11
57,9,1,8,284,25.4179992,19
48,16.89930219,3.35195248,13.54734971,290,36,15
45,8,1,7,290,35,6
54,9,1,8,288,36,7
58,10,1,9,284,35,7
60,12,1,11,278,33,7
69,15,1,14,269,29,4
79,14,0,14,259,27,7
75,15,1,14,261,28,6
74,14,1,13,261,28,7
75,13,1,12,260,28,12
85,7,0,7,246,27,7
89,7,0,7,243,28,0
88,6,0,6,238,30,9
93,4,0,4,237,33,0
92,9,0,9,241,29,1
91,11,0,11,246,26,5
91,9,0,9,249,23,4
91,7,0,7,248,20,11
90,11,1,10,252,17,0
82,11,2,9,258,15,18
82,11,2,9,265,15,9
88,11,2,9,267,11,12
88,14,3,11,269,7,13
88,18,3,15,266,6,18
83,17,4,13,274,7,10
84,18,4,14,270,11,19
86,31,9,22,258,4,16
87,38,11,27,262,5,17
84,33,7,26,260,5,18
84,33,4,29,259,3,14
84,44,8,36,261,1,12
83,40,5,35,261,0,13
83,35,3,32,261,0,14
84,44,8,36,259,0,11
78,47,12,35,257,1,13
73,47,14,33,254,4,13
71,32,6,26,248,10,8
71,24,2,22,243,10,4
74,18,1,17,238,9,6
77,20,1,19,237,9,7
79,24,2,22,234,4,7
83,32,8,24,234,2,11
85,32,12,20,239,1,11
77,14,4,10,245,8,23
68,11,2,9,261,15,14
60,13,2,11,287,22,16
54,9,1,8,296,31,13
51,6,1,5,302,42,10
55,6,0,6,304,48,10
49,8,1,7,303,52,16
46,5,0,5,298,44,5
47,5,0,5,294,42,6
46,4,0,4,283,36,8
52,5,0,5,274,36,6
63,8,1,7,267,32,2
66,11,1,10,262,33,5
68,13,1,12,260,31,5
71,12,1,11,255,28,7
71,8,0,8,253,28,5
74,10,0,10,250,26,7
76,7,0,7,245,24,8
76,7,0,7,239,19,12
76,11,1,10,236,12,8
77,12,0,12,233,13,12
77,16,1,15,233,13,9
79,16,1,15,232,10,14
76,20,3,17,234,8,7
68,17,3,14,244,13,22
57,12,2,10,258,20,12
55,13,2,11,268,27,15
53,10,1,9,284,35,20
51,8,1,7,292,47,20
50,6,0,6,298,52,13
48,6,0,6,308,55,16
57,6,0,6,298,51,18
57,6,0,6,290,46,12
60,5,0,5,277,42,17
63,8,1,7,267,39,13
64,11,1,10,258,34,5
64,14,1,13,255,28,6
65,5,0,5,247,36,12
68,3,0,3,241,41,13
66,3,0,3,237,37,10
68,3,0,3,233,37,7
67,3,0,3,230,36,9
66,3,0,3,228,36,4
59,4,0,4,224,31,13
54,5,0,5,222,28,1
55,6,0,6,221,26,2
55,6,0,6,220,24,11
53,9,1,8,222,22,1
50,11,1,10,229,17,5
44,11,2,9,240,20,4
40,8,1,7,254,24,15
37,7,1,6,268,28,10
33,5,0,5,274,34,10
29,6,0,6,281,38,14
27,5,0,5,286,33,4
26,7,0,7,283,37,1
29,6,0,6,283,44,2
51,6,0,6,257,47,11
54,7,0,7,247,42,7
56,8,0,8,237,37,3
58,9,0,9,235,33,5
59,14,1,13,233,31,9
60,14,1,13,229,25,18
60,14,1,13,227,22,6
59,18,1,17,228,29,11
62,13,1,12,222,25,16
67,8,0,8,213,25,11
74,4,0,4,208,22,13
73,2,0,2,207,25,4
72,2,0,2,207,27,4
70,3,0,3,206,27,7
68,7,1,6,208,25,1
68,7,1,6,212,25,14
66,6,1,5,214,22,6
65,7,1,6,218,23,13
63,7,1,6,225,27,3
60,6,1,5,229,30,16
62,4,0,4,227,32,2
63,6,1,5,225,34,9
63,6,1,5,224,33,7
65,4,0,4,221,32,4
67,4,0,4,215,32,14
68,6,1,5,211,30,0
77,8,1,7,206,28,8
83,6,0,6,202,25,0
85,6,0,6,199,23,6
87,5,0,5,198,22,4
89,4,0,4,197,21,0
90,4,0,4,193,20,6
91,3,0,3,190,21,5
92,2,0,2,191,24,4
92,1,0,1,189,30,3
92,2,0,2,187,30,2
92,2,0,2,187,31,3
92,2,0,2,189,28,2
93,3,0,3,189,19,4
92,4,0,4,191,16,5
92,4,0,4,196,15,2
92,3,0,3,196,15,8
94,4,0,4,194,16,7
94,5,1,4,192,18,4
95,5,1,4,195,19,2
95,4,0,4,200,19,3
94,2,0,2,206,31,5
94,2,0,2,206,33,9
95,2,0,2,211,29,0
95,4,0,4,216,25,8
95,4,0,4,220,18,0
95,8,1,7,223,14,5
94,9,1,8,204,12,7
94,12,1,11,199,13,0
95,9,0,9,200,12,3
96,13,1,12,203,10,4
94,18,1,17,233,3,0
87,16.82498624,3.327039733,13.49794651,262,11,10
89,2,0,2,248,19,19
79,2,0,2,259,27,4
75,2,0,2,260,27,32
70,3,0,3,256,22,11
71,6,1,5,255,19,13
65,6,1,5,265,16,6
60,8,2,6,277,18,13
55,11,2,9,294,21,13
50,11,2,9,305,24,11
46,10,1,9,314,33,11
48,11,1,10,319,40,18
49,10,1,9,317,45,12
48,9,1,8,315,47,3
50,11,1,10,311,48,6
54,10,1,9,299,43,4
57,10,0,10,288,38,2
59,7,1,6,275,36,7
62,6,1,5,264,34,4
60,5,0,5,256,32,0
63,4,0,4,253,30,5
65,5,0,5,246,31,6
64,4,0,4,239,30,2
63,3,0,3,237,31,2
61,3,0,3,234,29,4
62,4,0,4,232,26,4
63,5,0,5,229,20,5
64,9,0,9,226,17,0
62,16,1,15,225,17,12
61,18,2,16,230,15,1
58,10,1,9,237,17,18
55,7,1,6,249,24,8
44,8,1,7,269,27,7
52,7,1,6,267,31,14
53,5,0,5,271,38,10
55,5,0,5,278,25.41518343,7
54,6,0,6,278,47,11
52,9,0,9,277,55,17
51,12,0,12,279,59,16
54,14,0,14,271,54,10
57,27,1,26,266,48,11
67,15,1,14,260,36,11
71,12,1,11,248,30,11
73,13,1,12,246,27,6
73,14,1,13,244,23,20
76,14,1,13,239,21,10
77,12,1,11,233,18,21
78,8,0,8,228,20,6
78,10,1,9,225,18,13
75,9,0,9,222,16,13
74,9,0,9,220,18,6
74,13,1,12,219,16,18
72,14,1,13,218,10,2
73,24,3,21,219,5,8
68,23,4,19,223,11,17
69,24,4,20,228,11,12
66,16.79471763,3.316263026,13.4784546,235,17,13
66,20,3,17,244,18,17
67,19,2,17,246,27,21
67,32,3,29,250,22,16
67,36,2,34,251,29,22
67,34,2,32,248,40,25
66,27,1,26,250,43,18
57,22,1,21,255,38,21
53,30,1,29,254,32,27
59,31,1,30,250,32,33
63,40,2,38,246,24,24
65,42,2,40,242,21,26
67,44,3,41,238,11,23
70,53,11,42,234,6,32
74,46,4,42,230,1,21
76,35,2,33,228,3,32
74,41,2,39,223,6,30
72,28,1,27,217,15,20
59,16,1,15,213,18,26
49,9,0,9,215,29,8
46,8,0,8,217,32,12
45,10,1,9,221,27,10
40,11,1,10,240,32,16
37,9,1,8,254,38,14
36,6,0,6,269,42,8
37,6,0,6,276,46,9
34,6,0,6,281,51,8
32,5,0,5,286,51,8
31,4,0,4,292,52,9
30,4,0,4,294,54,4
34,6,0,6,297,57,3
39,6,0,6,277,57,6
42,6,0,6,261,52,9
48,10,0,10,256,54,1
49,14,0,14,253,51,6
49,16,0,16,249,57,8
51,15,0,15,248,59,11
55,17,0,17,245,53,9
66,14,1,13,238,40,19
70,9,0,9,233,40,14
73,9,0,9,226,38,20
74,9,0,9,221,36,11
76,9,0,9,217,32,13
79,10,0,10,213,18,19
83,10,1,9,212,8,13
76,15,2,13,215,13,20
71,12,2,10,224,19,19
64,9,1,8,246,22,11
59,8,1,7,265,32,15
54,6,0,6,267,40,16
67,8,1,7,256,38,12
69,9,1,8,250,34,7
66,13,1,12,251,33,20
71,7,0,7,249,29,12
85,10,1,9,227,35,10
81,9,0,9,220,38,0
82,11,0,11,222,35,7
84,11,0,11,218,36,6
90,15,0,15,216,28,14
88,23,1,22,217,24,7
88,17,1,16,219,26,12
89,7,0,7,217,30,12
89,5,0,5,215,33,1
91,6,0,6,213,32,11
91,3,0,3,208,33,0
92,2,0,2,200,38,5
92,2,0,2,196,40,0
92,2,0,2,185,47,6
93,2,0,2,182,49,0
93,4,0,4,185,44,3
93,5,0,5,189,34,3
91,5,0,5,194,30,4
79,4,0,4,206,30,6
74,4,0,4,208,37,15
71,4,0,4,217,35,9
65,3,0,3,228,35,9
63,2,0,2,231,38,9
61,3,0,3,240,40,9
58,3,0,3,238,42,12
60,3,0,3,228,42,10
65,4,0,4,218,40,0
69,10,1,9,212,36,0
71,8,0,8,207,35,10
73,9,0,9,203,32,0
74,10,0,10,201,31,0
76,8,0,8,199,30,9
76,7,0,7,198,29,0
77,6,0,6,197,28,6
78,6,0,6,195,27,8
79,5,0,5,194,27,0
79,5,0,5,195,24,9
80,6,0,6,196,20,0
79,8,1,7,198,22,9
80,10,1,9,200,18,0
76,10,1,9,206,18,19
65,8,1,7,226,26,1
59,8,1,7,248,32,27
57,7,1,6,256,38,22
56,5,0,5,258,43,8
54,5,0,5,262,50,6
52,6,0,6,260,50,12
54,5,0,5,266,54,11
58,8,1,7,259,50,10
62,13,0,13,250,53,12
65,17,0,17,243,61,11
64,15,1,14,237,40,12
63,17,1,16,233,25,9
63,15,0,15,230,23,11
66,17,1,16,227,27,20
71,18,1,17,223,25,10
74,17,1,16,221,18,18
76,16,1,15,215,18,7
79,16.75864924,3.293732071,13.46491717,212,20,18
83,7,0,7,211,23,17
83,6,0,6,211,25,5
83,8,0,8,210,22,7
84,13,1,12,209,16,15
83,13,1,12,213,13,0
80,15,2,13,220,11,22
71,15,3,12,245,18,12
63,8,1,7,261,25.48300814,12.31250784
59,7,1,6,266,35,14
54,16.75413063,3.29214642,13.46198421,270,44,13
50,9,1,8,283,50,11
48,8,0,8,290,53,15
46,7,0,7,292,56,14
48,7,0,7,281,64,9
60,8,0,8,268,57,16
60,14,1,13,257,37,9
61,13,1,12,253,34,1
65,12,0,12,249,35,0
65,12,0,12,247,33,3
71,11,0,11,226,35,5
70,9,0,9,232,30,4
72,9,0,9,232,26,10
81,10,0,10,224,20,9
82,8,0,8,217,20,7
82,7,0,7,211,20,13
84,8,0,8,205,16,3
85,9,0,9,204,7,16
86,17,2,15,207,2,3
85,18,4,14,204,2,22
79,23,7,16,209,10,10
72,16,4,12,231,18,24
66,15,3,12,248,23,24
62,9,1,8,259,31,22
61,8,1,7,263,39,20
58,7,0,7,270,54,16
52,9,0,9,279,63,20
49,10,0,10,280,65,17
51,11,0,11,279,57,18
61,16,0,16,265,56,23
66,12,0,12,255,43,14
67,14,1,13,251,38,3
67,11,0,11,248,33,1
71,12,0,12,244,30,12
70,12,0,12,241,30,9
72,9,0,9,240,30,15
73,15,1,14,236,31,7
75,13,0,13,233,28,10
77,12,1,11,231,25,14
78,10,0,10,230,25,10
78,9,0,9,230,27,8
79,9,0,9,229,26,20
80,12,0,12,230,20,4
79,23,2,21,234,13,23
72,22,2,20,244,21,14
65,16,2,14,254,30,14
62,9,1,8,265,32,18
60,9,1,8,262,35,17
61,8,1,7,260,36,10
58,5,0,5,266,38,13
58,9,1,8,262,38,11
57,11,1,10,264,37,11
60,12,1,11,257,36,9
62,16,1,15,251,34,8
62,16,1,15,248,36,2
63,7,0,7,246,31,11
63,11,0,11,246,30,6
69,12,0,12,241,28,14
68,10,0,10,241,24,4
71,10,0,10,240,26,15
82,13,0,13,234,24,8
85,12,0,12,220,23,5
87,4,0,4,211,32,2
91,4,0,4,200,33,0
93,5,0,5,193,36,5
93,9,0,9,191,33,4
94,10,0,10,190,30,4
94,11,0,11,188,22,2
94,11,0,11,188,24,0
94,13,1,12,192,23,3
91,10,1,9,198,23,4
87,14,2,12,204,21,10
81,12,2,10,215,25,9
75,9,1,8,231,28,15
71,8,1,7,242,32,10
64,9,1,8,247,35,10
66,10,0,10,226,27,5
83,9,1,8,194,25,0
88,6,0,6,183,27,0
90,9,1,8,175,30,0
90,8,1,7,173,29,0
90,5,0,5,165,30,0
90,6,0,6,168,32,2
86,5,0,5,168,30,1
85,3,0,3,167,34,3
84,5,0,5,169,30,4
83,5,0,5,170,27,7
84,5,0,5,172,25,6
84,9,0,9,173,20,4
86,10,0,10,172,12,2
87,14,1,13,170,6,5
86,18,3,15,173,5,3
77,20,5,15,181,8,11
64,15,4,11,199,14,18
58,11,2,9,215,23,20
52,9,2,7,224,28,10
51,7,1,6,233,34,15
45,9,1,8,240,40,12
46,10,1,9,241,48,10
43,10,0,10,245,50,11
50,9,0,9,242,52,7
52,13,0,13,232,48,6
57,11,0,11,226,44,2
62,17,1,16,226,39,0
67,11,1,10,213,23,12
70,11,0,11,209,25,0
71,13,0,13,208,23,9
72,17,1,16,207,20,11
73,17,1,16,206,19,9
76,17,1,16,202,14,7
79,14,1,13,195,10,8
81,16,1,15,190,3,6
81,16,1,15,185,6,3
81,11,1,10,181,6,8
82,12,1,11,179,4,12
79,19,4,15,180,5,10
75,21,6,15,191,8,15
69,13,3,10,208,12,21
67,8,1,7,218,18,28
66,8,1,7,221,24,14
61,6,1,5,230,31,10
58,4,0,4,233,39,13
54,5,0,5,240,41,11
55,5,0,5,240,44,18
54,6,0,6,239,46,12
60,8,0,8,236,45,11
64,13,0,13,227,39,16
69,20,2,18,221,32,2
71,19,1,18,213,22,13
72,18,1,17,206,17,5
71,17,1,16,201,18,19
72,15,1,14,197,19,6
73,14,1,13,194,16,17
78,12,1,11,187,15,12
80,12,1,11,182,14,11
81,15,1,14,178,11,15
84,14,1,13,172,9,16
79,15,1,14,166,9,15
78,13,1,12,161,12,15
73,11,2,9,162,12,11
69,12,3,9,173,16,17
61,11,2,9,201,20,25
53,8,1,7,226,31,29
50,6,1,5,237,40,24
48,5,0,5,246,48,22
49,5,0,5,250,57,19
45,5,0,5,249,55,13
48,4,0,4,249,51,10
50,3,0,3,243,49,5
52,3,0,3,237,47,6
53,6,0,6,231,45,3
55,9,0,9,231,40,2
56,13,0,13,230,40,15
59,17,1,16,226,34,8
60,18,1,17,223,25,8
63,15,1,14,222,24,14
66,16,1,15,220,26,5
70,15,1,14,216,22,19
73,16.68617901,3.262559489,13.42361952,216,17,4
73,11,1,10,216,23,15
75,10,0,10,214,22,12
72,12,0,12,215,24,7
70,19,1,18,217,29,15
66,24,1,23,220,25,1
63,26,2,24,229,27,15
55,19,2,17,239,29,8
50,11,1,10,248,25.52740235,11
50,9,1,8,254,35,9
52,16.6854832,3.261015314,13.42446789,254,34,13
53,9,1,8,251,36,12
54,9,1,8,254,36,8
53,11,1,10,254,35,9
60,11,1,10,252,32,6
62,14,1,13,248,30,7
64,16,1,15,245,27,6
76,15,1,14,229,24,9
77,19,1,18,229,18,3
83,21,1,20,228,13,13
86,20,1,19,223,12,7
87,21,1,20,220,11,12
89,29,2,27,214,4,9
90,34,3,31,209,2,23
90,27,1,26,207,3,16
91,26,1,25,207,1,26
91,25,2,23,207,0,16
91,23,2,21,207,0,24
91,23,3,20,205,2,18
90,22,5,17,204,2,21
90,26,8,18,207,4,9
89,29,10,19,207,5,29
85,24,7,17,217,12,13
78,19,4,15,231,21,27
71,13,2,11,246,31,25
66,10,1,9,259,45,21
63,9,0,9,264,52,27
60,10,0,10,270,55,18
59,9,0,9,274,59,15
65,29,1,28,268,53,16
69,58,2,56,259,35,26
74,48,1,47,255,18,21
78,10,1,9,223,34,18
78,4,0,4,211,37,0
78,3,0,3,205,35,8
76,3,0,3,201,35,5
75,2,0,2,198,36,9
75,3,0,3,195,35,4
75,2,0,2,195,34,7
74,3,0,3,195,32,8
69,3,0,3,193,30,7
65,3,0,3,190,30,7
65,4,0,4,187,29,0
63,4,0,4,183,28,4
60,6,0,6,183,27,4
55,6,1,5,185,26,5
58,6,1,5,189,26,6
54,5,1,4,197,27,10
50,5,1,4,205,28,12
50,4,1,3,205,30,15
51,3,0,3,206,33,2
51,4,0,4,206,32,3
51,4,0,4,206,33,2
54,5,0,5,197,31,13
56,9,0,9,189,30,0
57,10,0,10,183,28,5
62,19,2,17,181,22,4
63,16,1,15,177,19,6
63,11,0,11,175,22,6
64,11,0,11,174,25,6
47,6,0,6,170,23,6
47,6,0,6,168,23,3
48,5,0,5,164,26,3
51,6,0,6,160,26,2
52,7,0,7,157,25,3
52,9,0,9,155,20,2
53,13,0,13,153,19,3
50,16,1,15,157,19,6
51,10,1,9,161,25,7
46,6,1,5,168,27,5
46,7,1,6,182,26,8
42,6,1,5,192,27,15
38,4,0,4,197,32,23
40,4,0,4,200,34,3
38,4,0,4,206,35,8
42,4,0,4,202,37,2
40,4,0,4,199,37,5
46,5,0,5,188,35,0
50,10,0,10,180,32,0
54,19,2,17,172,27,2
57,16,1,15,167,25,0
58,18,1,17,164,25,4
57,18,1,17,163,25,4
58,12,0,12,162,23,10
59,12,0,12,161,22,6
62,11,0,11,159,21,10
66,11,0,11,155,17,9
66,12,0,12,151,20,5
66,11,0,11,149,22,5
68,13,0,13,148,15,7
69,18,1,17,146,9,7
70,26,3,23,146,6,9
70,29,6,23,150,6,13
66,22,4,18,160,9,13
61,19,3,16,170,13,14
59,14,2,12,180,18,16
56,11,1,10,181,25,19
56,14,1,13,182,28,12
56,11,1,10,185,29,10
57,15,1,14,183,27,12
59,18,1,17,181,27,14
78,17,1,16,169,24,18
87,22,1,21,153,17,14
91,23,1,22,149,15,10
92,19,1,18,146,18,10
93,16,1,15,146,20,8
93,15,0,15,149,17,8
94,15,0,15,151,14,11
95,14,0,14,155,10,10
95,10,0,10,158,12,7
95,8,0,8,162,13,8
95,8,0,8,162,14,8
96,4,0,4,167,16,6
94,2,0,2,172,40,6
95,3,0,3,169,32,0
95,6,0,6,168,18,2
95,12,1,11,167,14,2
95,13,1,12,168,14,3
95,14,1,13,172,18,2
94,10,1,9,179,19,4
94,8,1,7,185,23,3
91,8,1,7,196,23,7
84,8,1,7,207,29,7
79,6,1,5,216,32,9
75,5,0,5,221,35,18
77,6,0,6,221,33,0
80,10,0,10,216,29,14
82,21,1,20,212,20,0
86,17,2,15,206,12,3
88,7,0,7,201,19,7
89,14,1,13,198,13,8
90,14,1,13,195,13,0
91,16,2,14,193,9,7
91,12,1,11,190,14,6
92,8,1,7,188,7,0
92,9,1,8,186,9,8
92,9,1,8,185,5,0
93,8,1,7,184,4,5
93,11,1,10,184,1,5
93,11,1,10,189,3,10
91,11,2,9,198,11,13
85,10,2,8,207,16,30
79,9,2,7,224,19,18
72,6,1,5,237,26,15
67,5,1,4,244,29,20
68,3,0,3,245,31,14
62,3,0,3,255,31,6
65,3,0,3,246,35,6
68,3,0,3,238,34,5
68,3,0,3,226,35,5
73,4,0,4,215,32,0
77,5,0,5,206,30,4
81,8,1,7,200,26,0
84,8,1,7,194,26,0
86,6,0,6,191,25,4
87,7,0,7,188,24,4
88,5,0,5,187,26,3
88,4,0,4,187,24,6
88,16.62788703,3.233590856,13.39429618,184,24,5
88,4,0,4,180,24,0
88,4,0,4,178,21,6
89,5,0,5,176,16,6
90,9,1,8,174,11,4
90,14,3,11,177,6,5
85,11,2,9,188,11,12
69,9,2,7,210,22,28
58,7,1,6,227,26,16
56,8,1,7,238,30,12
58,7,1,6,248,39,13
55,5,0,5,254,45,12
53,6,0,6,258,52,12
53,10,0,10,256,51,12
57,16,0,16,254,61,17
61,13,0,13,245,49,18
68,23,1,22,238,37,10
74,19,1,18,231,21,0
67,17,1,16,223,16,5
73,17,1,16,216,16,9
77,20,1,19,214,13,14
77,21,1,20,216,19,6
81,23,4,19,212,14,19
86,13,1,12,214,18,2
87,12,1,11,214,17,14
87,15,1,14,211,11,1
88,15,1,14,207,2,4
89,17,2,15,204,0,11
88,20,7,13,203,0,7
86,47,27,20,201,1,14
83,49,24,25,211,2,22
77,16.62468453,3.232693149,13.39199139,230,11,35
62.20464538,24,5,19,186.4076596,24,26
62.20464538,17,2,15,186.4076596,33,28
62.20464538,12,1,11,186.4076596,46,25
62.20464538,8,0,8,186.4076596,59,12
62.20464538,9,0,9,186.4076596,69,17
62.20464538,13,0,13,186.4076596,81,23
53,20,0,20,282,93,25
55,25,0,25,274,91,27
62,32,1,31,257,69,30
64,29,1,28,250,34,18
68,33,2,31,245,22,15
74,29,1,28,240,12,17
75,27,1,26,239,7,22
78,25,1,24,236,5,22
82,21,1,20,232,12,34
84,24,1,23,229,12,22
85,17,1,16,223,10,32
88,16,1,15,219,9,18
88,20,2,18,217,6,25
88,21,4,17,215,1,33
87,31,14,17,213,1,21
88,31,15,16,210,1,34
88,19,5,14,210,4,17
87,10,1,9,218,25.49980055,24
84,9,1,8,222,17,30
80,7,1,6,226,23,30
79,7,1,6,225,28,15
78,6,1,5,223,27,26
77,5,0,5,223,29,11
78,4,0,4,219,29,15
80,4,0,4,213,31,13
81,5,0,5,207,31,4
82,6,0,6,204,30,11
82,5,0,5,203,31,11
83,7,0,7,203,29,3
84,10,1,9,201,26,5
84,8,0,8,202,22,15
85,6,0,6,202,21,16
85,5,0,5,201,23,4
87,3,0,3,202,22,14
87,4,0,4,201,19,8
88,4,0,4,199,20,20
89,5,0,5,198,15,5
90,8,0,8,194,6,22
91,10,1,9,193,2,1
90,17,3,14,195,1,13
87,21,6,15,206,4,22
81,17,5,12,224,10,40
69,24,6,18,253,16,32
60,27,4,23,268,29,36
56,23,2,21,279,43,28
47,17,1,16,289,57,25
55,21,1,20,284,61,30
54,22,1,21,286,69,29
57,13,0,13,279,65,29
70,18,1,17,257,59,44
71,13,1,12,241,51,41
78,10,0,10,227,46,16
70,7,0,7,219,40,18
71,5,0,5,215,38,5
72,3,0,3,209,37,9
78,3,0,3,200,36,3
77,2,0,2,197,34,3
72,2,0,2,197,32,5
74,2,0,2,193,32,10
77,2,0,2,187,32,7
76,2,0,2,182,34,1
77,3,0,3,179,34,1
77,4,0,4,167,31,3
86,6,0,6,157,28,0
88,7,0,7,152,25,0
90,8,0,8,153,22,0
89,9,1,8,158,24,3
88,6,0,6,159,26,3
86,9,1,8,157,27,4
85,9,1,8,156,27,1
87,8,0,8,159,25,1
88,11,1,10,158,20,2
89,11,0,11,156,15,6
90,10,0,10,154,21,4
91,11,0,11,153,18,1
90,13,0,13,152,19,3
90,14,0,14,153,16,2
91,15,1,14,153,15,4
91,11,0,11,153,14,4
91,7,0,7,153,18,4
91,5,0,5,153,23,4
91,3,0,3,150,32,4
91,3,0,3,147,33,0
93,2,0,2,146,34,0
93,3,0,3,145,31,1
93,4,0,4,144,31,2
93,4,0,4,141,33,0
93,5,0,5,142,31,0
91,6,0,6,141,26,2
92,6,0,6,142,28,2
91,8,1,7,147,23,5
91,11,1,10,150,21,5
90,9,1,8,149,22,6
90,8,1,7,147,21,4
90,11,1,10,150,19,2
90,12,1,11,152,17,5
90,14,1,13,153,14,7
92,13,1,12,151,16,4
93,14,1,13,151,16,4
94,14,1,13,151,10,6
94,11,1,10,151,15,4
94,10,0,10,152,16,5
93,10,0,10,153,14,5
92,10,0,10,153,10,5
91,12,1,11,154,9,8
90,10,0,10,155,9,5
90,11,0,11,155,8,6
90,13,1,12,155,6,5
90,15,1,14,155,5,12
90,12,1,11,155,1,12
91,10,1,9,155,1,9
91,13,2,11,154,3,10
92,16,4,12,152,3,15
93,12,3,9,154,5,8
93,9,1,8,157,6,8
91,11,2,9,158,10,10
90,8,1,7,156,15,7
89,7,1,6,154,19,6
89,7,1,6,159,21,7
89,6,0,6,157,22,12
89,7,0,7,152,20,7
90,6,0,6,149,22,5
91,10,1,9,150,22,3
91,7,0,7,150,20,7
92,9,0,9,149,17,9
92,11,0,11,147,17,7
92,9,0,9,147,19,3
93,8,0,8,146,17,4
93,9,0,9,145,15,5
94,8,0,8,145,15,7
92,16.57103567,3.210074465,13.3609612,137,24,6
93,4,0,4,132,28,6
94,4,0,4,131,23,6
94,5,0,5,129,23,3
93,6,0,6,127,21,6
94,7,0,7,125,21,6
93,7,0,7,126,23,6
93,9,1,8,126,19,6
93,9,1,8,132,25.47887192,6
93,16.56500341,3.208323201,13.3566802,136,16,7
93,10,1,9,136,14,8
93,9,1,8,135,16,3
93,8,1,7,130,16,4
95,7,0,7,129,13,2
94,8,0,8,131,14,3
94,8,0,8,129,19,6
94,10,1,9,128,17,8
94,9,0,9,126,13,4
94,9,0,9,125,12,7
94,9,0,9,123,13,5
95,11,0,11,122,12,7
95,10,0,10,119,13,7
95,8,0,8,118,16,4
95,7,0,7,118,18,5
95,6,0,6,118,20,6
95,10,0,10,119,21,3
95,8,0,8,121,20,7
95,5,0,5,121,20,4
95,7,0,7,122,20,6
95,11,0,11,124,17,2
95,16,1,15,126,16,6
95,16,1,15,129,18,5
93,13,1,12,132,21,7
93,13,1,12,135,23,7
92,16,2,14,138,23,5
89,14,2,12,142,25,9
86,10,1,9,148,24,7
81,9,1,8,154,27,14
80,8,1,7,154,28,12
82,9,0,9,151,23,2
82,14,1,13,150,21,0
84,20,1,19,149,19,4
85,30,3,27,145,8,3
88,38,8,30,143,4,5
88,29,2,27,139,4,9
89,29,2,27,136,3,11
90,29,2,27,132,1,11
91,24,1,23,130,1,11
92,22,2,20,127,3,10
91,24,4,20,123,2,13
90,22,5,17,120,1,15
87,16,1,15,118,0,9
87,20,2,18,112,1,11
91,36,15,21,106,1,9
93,39,19,20,115,2,12
68,18,6,12,143,6,20
58,12,3,9,167,17,30
51,6,1,5,182,22,32
52,6,1,5,184,29,12
54,4,0,4,183,37,11
53,4,0,4,178,37,0
55,4,0,4,173,37,11
58,4,0,4,156,37,6
59,5,0,5,147,34,2
59,6,0,6,142,34,1
60,9,1,8,139,32,5
62,7,0,7,137,32,6
64,7,0,7,137,33,10
63,5,0,5,136,33,8
68,4,0,4,133,33,9
74,4,0,4,126,33,7
76,4,0,4,124,29,3
83,5,0,5,119,24,6
88,7,0,7,113,23,8
89,6,0,6,108,24,7
90,7,0,7,105,20,5
92,10,0,10,105,19,10
92,9,0,9,105,13,11
92,11,1,10,106,14,10
93,10,1,9,107,17,9
92,12,2,10,111,16,9
93,9,1,8,115,18,10
90,8,1,7,119,19,10
92,6,0,6,118,21,11
92,10,1,9,120,21,5
93,8,0,8,119,19,7
93,8,0,8,119,22,6
94,12,0,12,119,21,6
94,12,1,11,118,20,5
94,10,0,10,116,19,6
94,9,0,9,113,24,5
94,7,0,7,112,27,3
94,6,0,6,113,28,0
95,7,0,7,114,26,3
94,5,0,5,115,27,4
94,4,0,4,117,27,3
95,4,0,4,116,26,2
95,4,0,4,117,26,2
96,3,0,3,119,25,1
96,4,0,4,120,25,0
96,5,0,5,121,24,2
96,6,0,6,121,24,0
95,7,0,7,124,26,0
94,9,1,8,130,24,0
92,12,2,10,137,22,5
88,11,2,9,142,20,4
87,12,2,10,150,19,3
86,12,2,10,158,19,6
82,9,1,8,167,20,8
85,8,1,7,169,19,9
83,14,1,13,171,19,2
88,16,1,15,167,19,4
92,16,1,15,162,17,3
94,10,1,9,159,19,1
94,8,0,8,155,16,0
95,9,0,9,154,18,1
95,9,0,9,153,18,1
95,8,0,8,152,18,0
95,6,0,6,151,17,0
95,7,0,7,152,17,0
95,6,0,6,152,16,0
95,6,0,6,152,15,4
95,6,0,6,153,16,2
96,9,0,9,154,13,5
96,8,0,8,155,12,3
96,10,1,9,156,10,1
96,12,1,11,158,10,1
96,13,1,12,161,9,2
96,17,2,15,163,7,2
96,16,2,14,168,8,4
96,10,1,9,172,9,4
96,6,0,6,171,8,6
96,9,1,8,173,10,2
95,14,1,13,173,11,5
95,13,1,12,173,12,3
96,14,1,13,173,10,2
96,14,1,13,173,8,3
96,17,1,16,174,7,2
95,14,1,13,173,11,4
95,11,0,11,173,10,5
95,10,0,10,172,15,3
95,8,0,8,171,17,4
95,6,0,6,171,20,4
96,7,0,7,171,19,3
95,5,0,5,171,18,3
96,4,0,4,171,17,3
96,4,0,4,173,17,2
96,3,0,3,173,17,3
96,3,0,3,177,17,2
96,3,0,3,183,24,3
95,3,0,3,183,28,4
95,3,0,3,182,30,1
94,2,0,2,183,33,2
94,2,0,2,183,34,1
95,3,0,3,182,33,4
95,3,0,3,181,34,0
95,2,0,2,178,36,0
95,2,0,2,178,28,0
96,3,0,3,178,22,0
96,4,0,4,177,21,0
96,5,0,5,177,22,2
96,5,0,5,174,20,0
96,5,0,5,173,22,0
96,4,0,4,172,25,1
95,3,0,3,171,30,0
95,2,0,2,171,35,0
95,1,0,1,169,35,0
96,1,0,1,175,33,0
97,16.48574966,3.180992226,13.30475743,226,26,0
87,1,0,1,230,26,9
89,1,0,1,217,31,24
86,1,0,1,224,32,1
84,3,0,3,200,28,12
78,4,0,4,176,27,5
59,4,0,4,195,30,0
43,6,1,5,213,31,3
42,6,1,5,207,25.4094752,7
40,6,1,5,212,34,3
33,16.47724978,3.179120272,13.29812951,219,35,3
33,5,1,4,217,37,6
33,4,0,4,215,39,4
34,4,0,4,210,39,1
37,4,0,4,200,40,6
41,5,0,5,187,38,0
46,5,0,5,173,36,0
48,7,0,7,168,32,0
47,7,0,7,168,30,0
51,7,0,7,161,28,0
53,7,0,7,157,16,0
54,9,0,9,152,22,0
56,9,0,9,149,19,0
56,5,0,5,146,24,0
53,4,0,4,148,26,0
54,5,0,5,146,27,0
57,7,0,7,142,25,1
58,8,0,8,139,21,3
59,12,0,12,135,18,4
61,15,1,14,136,15,6
56,15,2,13,144,18,8
57,9,1,8,151,19,13
46,9,2,7,172,21,14
46,7,1,6,175,25,20
46,5,0,5,174,30,17
52,6,1,5,170,29,13
49,5,0,5,170,30,6
52,5,0,5,165,31,10
56,7,0,7,161,30,7
57,10,0,10,155,29,9
60,18,2,16,151,28,9
63,14,0,14,148,26,9
66,14,1,13,145,24,9
66,13,0,13,143,24,10
68,12,0,12,142,22,11
70,13,0,13,141,17,15
71,17,1,16,136,9,15
72,13,0,13,133,10,13
72,11,0,11,132,14,16
74,14,0,14,130,6,19
76,16,0,16,129,4,19
79,19,1,18,126,2,18
77,21,1,20,126,2,18
81,21,2,19,125,2,17
84,25,4,21,126,4,19
84,25,5,20,128,5,15
84,25,6,19,131,7,17
85,25,6,19,134,9,17
77,21,4,17,140,12,15
81,16,2,14,141,14,15
83,20,3,17,137,14,11
82,17,2,15,138,21,6
80,17,1,16,142,18,5
76,19,1,18,146,17,10
83,17,1,16,139,19,7
88,13,1,12,132,24,7
86,14,0,14,131,25,7
84,15,0,15,131,16,7
87,23,1,22,128,9,12
87,34,4,30,126,4,9
85,36,6,30,124,9,9
83,22,1,21,124,8,11
86,18,1,17,120,7,8
85,21,1,20,120,8,10
88,19,1,18,115,2,11
88,19,1,18,112,5,12
89,24,2,22,107,1,11
90,36,10,26,109,1,13
82,36,11,25,126,3,16
75,18,4,14,141,6,32
56,13,3,10,171,18,25
53,13,3,10,180,24,27
42,8,1,7,187,28,16
44,6,1,5,190,35,10
38,5,0,5,196,39,11
43,5,0,5,197,41,16
47,6,0,6,184,41,8
54,8,0,8,169,39,0
61,26,3,23,156,31,3
67,30,3,27,148,24,7
70,41,6,35,141,14,11
72,48,10,38,138,10,14
75,54,21,33,136,2,17
76,69,37,32,132,1,17
77,50,18,32,128,0,15
79,35,4,31,125,0,17
82,37,7,30,118,0,15
85,39,8,31,113,0,15
85,40,10,30,108,0,16
86,42,15,27,105,0,18
86,44,18,26,102,0,16
87,48,24,24,102,1,19
84,47,23,24,115,1,26
77,42,17,25,134,5,37
63,34,10,24,166,16,36
53,27,6,21,182,25,30
53,13,2,11,191,30,28
50,9,1,8,197,37,18
47,6,0,6,204,44,16
45,5,0,5,208,46,12
48,9,1,8,200,45,14
61,9,0,9,186,40,10
63,14,0,14,172,37,0
66,15,0,15,163,35,11
69,22,1,21,154,33,11
72,24,2,22,151,32,13
78,20,1,19,149,29,14
82,13,0,13,149,28,13
83,11,0,11,149,29,14
83,8,0,8,145,25,10
82,7,0,7,138,16,13
81,15,0,15,136,12,18
81,20,1,19,132,10,20
80,18,1,17,131,8,21
79,22,1,21,133,7,19
78,27,4,23,134,6,18
76,32,8,24,138,6,22
75,34,10,24,141,7,21
73,36,11,25,145,9,22
72,34,10,24,150,11,21
72,30,8,22,155,13,25
70,17,2,15,162,16,27
72,17,2,15,161,21,29
80,22,2,20,155,16,31
85,22,2,20,148,11,22
87,24,1,23,145,8,21
89,26,1,25,142,6,26
91,25,1,24,141,6,22
92,24,1,23,140,7,23
93,27,2,25,140,9,26
94,23,1,22,138,10,20
94,15,1,14,137,14,17
94,12,0,12,137,17,15
94,10,0,10,138,17,15
94,9,0,9,139,17,14
94,8,0,8,139,17,12
95,8,0,8,138,17,13
94,6,0,6,138,17,10
95,4,0,4,138,26,11
95,4,0,4,137,25,9
95,4,0,4,139,25,9
95,6,0,6,141,26,4
95,7,0,7,142,24,5
95,7,1,6,143,20,4
95,8,1,7,146,21,5
95,7,0,7,145,26,7
95,5,0,5,147,29,1
95,6,0,6,148,26,1
96,8,0,8,149,22,2
96,11,1,10,151,19,4
96,9,0,9,150,21,3
96,10,0,10,148,18,3
96,8,0,8,153,20,0
95,5,0,5,158,22,0
95,6,0,6,156,25,2
94,9,0,9,154,19,5
92,12,0,12,158,17,4
90,16,0,16,169,21,3
91,16.48649751,3.173768125,13.31272939,162,21,5
92,15,0,15,159,15,4
56,7,0,7,170,30,1
52,2,0,2,169,38,0
54,4,0,4,163,35,2
52,5,0,5,164,30,0
48,6,1,5,172,25,1
43,6,1,5,175,28,4
36,5,1,4,181,25.33497262,12.14189414
30,16.48058815,3.172152441,13.30843571,176,33,4
28,5,1,4,174,34,8
28,3,0,3,172,34,8
29,3,0,3,168,34,5
27,3,0,3,162,34,4
30,4,0,4,153,34,5
34,5,0,5,142,31,3
39,7,0,7,133,29,0
40,7,0,7,125,27,2
44,7,0,7,120,24,2
46,7,0,7,116,27,5
49,7,0,7,111,25,4
49,7,0,7,106,25,4
49,6,0,6,105,24,5
46,6,0,6,107,25,5
47,5,0,5,106,27,5
47,4,0,4,105,27,7
46,5,0,5,106,27,6
40,7,0,7,113,24,10
42,11,0,11,111,16,10
47,22,2,20,110,13,9
51,26,5,21,109,13,11
50,16,3,13,119,16,17
47,11,2,9,135,20,20
41,11,2,9,152,24,14
38,11,2,9,160,29,12
38,10,1,9,162,32,15
40,9,1,8,165,34,9
40,12,1,11,165,30,8
44,12,1,11,160,27,0
47,15,0,15,152,21,8
50,34,3,31,145,14,5
50,53,15,38,145,6,6
56,67,24,43,143,2,7
59,98,55,43,133,1,12
64,96,56,40,128,0,15
61,89,55,34,128,1,16
62,77,47,30,121,0,15
63,60,28,32,115,1,10
69,48,17,31,108,0,12
73,40,9,31,104,0,12
72,33,5,28,101,0,16
68,26,2,24,99,1,10
72,28,4,24,96,2,9
71,35,12,23,96,2,7
66,39,17,22,107,5,10
61,36,15,21,115,8,16
56,32,13,19,134,10,17
50,27,8,19,149,14,20
50,28,6,22,155,17,24
50,27,6,21,171,24,21
50,25,4,21,181,28,32
51,25,3,22,182,31,20
54,29,2,27,176,27,9
58,35,2,33,166,23,23
62,48,3,45,158,12,3
64,45,3,42,152,8,21
65,51,5,46,148,1,19
68,67,19,48,143,1,23
69,68,19,49,139,1,23
72,79,27,52,131,1,25
73,73,26,47,125,0,27
77,65,23,42,117,0,25
80,60,23,37,112,0,24
83,54,22,32,109,1,20
84,47,18,29,106,0,24
82,36,11,25,105,0,21
80,37,11,26,102,0,17
83,51,26,25,98,1,17
77,49,25,24,111,1,17
68,41,18,23,131,4,31
61,38,13,25,155,9,30
57,29,7,22,181,15,27
53,18,3,15,193,25,36
47,11,1,10,202,34,28
41,8,1,7,211,43,15
51,7,1,6,210,41,14
53,6,0,6,197,41,5
56,8,0,8,185,40,0
62,18,2,16,173,36,1
66,19,1,18,166,30,5
69,16,1,15,166,29,8
71,11,0,11,164,27,13
73,14,0,14,158,20,15
70,15,1,14,153,15,16
70,18,1,17,149,15,19
83,18,1,17,139,15,15
88,15,0,15,133,10,12
88,14,0,14,129,9,14
90,13,0,13,125,11,15
88,12,0,12,124,14,16
85,15,0,15,126,10,14
81,19,1,18,128,9,15
74,21,5,16,141,12,15
65,16,4,12,156,21,20
58,12,2,10,177,27,22
55,9,1,8,196,34,25
55,8,1,7,201,39,29
53,7,1,6,206,44,13
52,5,0,5,214,47,14
50,5,0,5,217,49,17
56,5,0,5,209,47,19
61,13,0,13,197,44,9
64,32,3,29,191,37,0
72,25,2,23,183,20,15
78,19,1,18,179,21,19
80,15,1,14,177,21,15
82,20,1,19,173,20,14
83,17,1,16,172,16,13
84,13,1,12,168,15,17
83,13,1,12,166,19,15
84,10,0,10,163,17,15
87,12,1,11,158,11,15
89,15,1,14,154,8,16
89,17,1,16,154,6,13
88,17,1,16,152,2,15
88,19,2,17,152,1,16
86,23,5,18,155,2,18
77,25,7,18,162,6,23
71,30,9,21,177,14,28
64,21,4,17,181,22,34
56,15,2,13,199,29,30
52,12,1,11,208,37,32
46,12,1,11,213,46,25
42,10,0,10,213,47,22
42,11,0,11,201,45,9
58,8,0,8,180,37,0
67,7,0,7,149,33,3
72,6,0,6,141,35,0
73,5,0,5,132,32,0
80,8,1,7,128,31,0
79,6,0,6,121,31,5
77,6,0,6,114,28,1
76,7,0,7,113,27,3
69,8,0,8,112,21,5
72,10,0,10,108,22,4
59,6,0,6,108,24,2
46,5,0,5,112,30,0
51,4,0,4,107,31,3
59,4,0,4,96,27,4
68,9,1,8,92,21,7
59,12,2,10,107,19,5
48,9,2,7,126,24,15
40,5,1,4,142,28,22
39,3,0,3,157,31,25
37,3,0,3,159,35,29
37,4,0,4,165,37,34
34,4,0,4,171,39,19
38,4,0,4,172,41,25
40,4,0,4,161,40,15
46,12,2,10,152,39,9
51,20,2,18,144,32,8
53,19,1,18,138,27,7
54,27,1,26,134,25,8
57,32,2,30,129,22,9
59,35,3,32,128,14,15
60,31,3,28,127,13,15
67,28,2,26,120,10,18
64,23,1,22,110,2,18
68,16.54037748,3.195324298,13.34505318,101,3,23
72,26,1,25,94,2,23
71,20,1,19,90,2,22
73,18,1,17,84,1,20
72,21,2,19,81,1,16
70,32,9,23,81,1,17
67,37,16,21,93,3,19
59,26,9,17,112,5,29
52,25,8,17,137,25.26987882,36
47,16.54555907,3.196852703,13.34870637,156,13,34
45,28,7,21,170,17,39
49,37,8,29,181,20,39
49,39,7,32,199,21,25
55,32,4,28,202,24,22
60,25,2,23,197,31,13
66,29,1,28,191,28,0
68,38,2,36,186,22,5
71,26,1,25,179,17,11
68,34,2,32,157,2,15
66,62,16,46,148,5,29
66,57,10,47,145,8,32
67,51,5,46,140,1,35
68,51,5,46,130,1,37
72,38,2,36,124,1,37
72,32,1,31,118,0,34
73,28,1,27,112,0,32
74,27,1,26,108,0,28
73,22,1,21,105,1,24
75,26,3,23,99,0,25
77,44,18,26,97,0,20
77,52,26,26,107,1,24
65,41,17,24,131,3,38
55,30,9,21,160,10,40
47,20,4,16,183,18,37
48,23,4,19,193,25,40
52,44,8,36,203,26,27
54,40,6,34,213,27,26
58,25,3,22,215,28,24
63,20,1,19,211,32,18
74,20,1,19,202,35,11
78,20,1,19,197,26,0
78,27,1,26,193,18,12
82,22,1,21,187,14,12
80,19,1,18,186,21,13
69,19,1,18,170,9,12
67,51,6,45,156,3,34
66,54,4,50,152,4,39
65,44,2,42,150,5,40
65,38,1,37,147,2,40
63,30,1,29,143,4,34
64,28,1,27,139,4,27
63,29,1,28,136,2,27
62,32,2,30,138,1,20
61,38,7,31,136,1,20
61,42,12,30,138,1,20
64,50,19,31,142,1,22
65,62,28,34,149,2,27
67,68,31,37,146,2,27
71,56,21,35,151,2,32
73,58,20,38,155,3,35
68,71,26,45,157,2,34
71,78,30,48,156,2,39
72,86,37,49,158,1,42
73,90,43,47,157,1,36
73,98,50,48,153,1,39
75,111,62,49,147,1,48
78,117,70,47,142,1,53
78,105,62,43,137,1,59
76,74,32,42,131,1,59
74,74,29,45,130,1,55
76,95,46,49,130,1,57
80,106,60,46,127,1,59
82,98,56,42,125,1,54
81,93,57,36,122,1,50
78,49,20,29,119,1,41
75,39,13,26,120,0,27
51,27,10,17,150,13,15
50,10,1,9,145,23,5
44,10,1,9,155,26,4
38,8,1,7,163,28,11
34,7,1,6,173,31,22
32,7,1,6,178,32,16
29,7,1,6,179,32,14
28,5,0,5,181,33,11
27,5,0,5,179,32,11
27,5,0,5,175,33,9
27,6,0,6,168,31,12
29,7,0,7,156,32,4
35,9,1,8,143,29,3
36,13,0,13,137,24,4
37,18,1,17,129,23,7
40,17,1,16,124,25,7
43,15,1,14,118,26,7
42,16,0,16,120,25,8
43,14,0,14,117,23,6
48,8,0,8,111,21,9
49,8,0,8,105,24,10
52,9,0,9,102,19,6
53,11,0,11,98,16,6
53,20,0,20,97,10,9
55,23,1,22,94,5,10
57,25,3,22,88,3,12
54,36,11,25,98,5,12
50,25,7,18,110,6,24
45,23,5,18,126,25.18407481,29
43,14,2,12,137,14,26
41,16,2,14,150,17,26
44,16,2,14,156,20,25
45,16,2,14,169,24,21
48,18,2,16,173,26,31
52,17,1,16,169,22,7
58,22,1,21,160,20,21
61,39,5,34,155,8,7
65,55,14,41,146,2,18
61,46,6,40,131,3,26
59,38,3,35,127,7,31
60,35,3,32,124,9,26
61,39,5,34,123,6,28
66,39,6,33,123,2,31
73,36,4,32,153,5,29
66,12,1,11,176,32,19
55,6,0,6,180,34,20
57,5,0,5,182,36,15
63,6,0,6,184,39,14
66,7,0,7,184,37,13
64,9,0,9,191,34,12
61,7,0,7,127,18,12
60,25,7,18,130,8,17
56,24,5,19,151,10,17
46,25,7,18,190,14,20
39,13,2,11,191,22,32
39,10,1,9,192,30,8
29,8,1,7,191,32,6
30,5,0,5,186,34,0
28,4,0,4,174,34,0
28,5,0,5,164,34,0
33,6,0,6,153,33,0
39,5,0,5,138,31,0
39,5,0,5,134,29,0
42,4,0,4,129,29,0
43,4,0,4,127,28,1
42,3,0,3,121,29,2
42,2,0,2,116,30,0
44,2,0,2,112,32,1
43,1,0,1,109,33,0
43,1,0,1,106,33,0
41,1,0,1,105,33,2
40,1,0,1,104,34,3
39,2,0,2,106,33,3
41,3,0,3,103,32,2
45,6,1,5,102,27,1
46,5,1,4,111,26,13
38,2,0,2,133,29,16
31,2,0,2,148,31,11
31,2,0,2,153,32,11
32,2,0,2,150,35,16
29,3,0,3,160,37,10
30,2,0,2,163,38,7
32,3,0,3,151,39,2
38,7,0,7,140,36,4
41,23,3,20,131,30,0
43,18,0,18,129,25,3
44,29,1,28,127,22,6
44,31,2,29,123,21,10
46,28,1,27,122,18,11
48,27,1,26,117,15,13
50,25,1,24,109,11,17
57,22,1,21,98,11,8
64,16.67850244,3.243796465,13.43470597,85,5,9
65,24,1,23,77,4,16
66,18,1,17,74,4,11
67,16,1,15,69,6,9
69,21,2,19,64,2,8
71,30,8,22,60,1,11
66,34,13,21,70,3,10
57,33,13,20,91,7,16
50,28,10,18,113,25.16990802,18
20,22,6,16,132,14,26
48,23,6,17,145,18,23
49,15,2,13,149,19,23
51,16.68417522,3.245720691,13.43845453,165,25,24
53,12,1,11,165,25,21
59,16,1,15,159,21,5
64,19,1,18,152,14,10
66,20,1,19,152,13,13
67,16,1,15,145,18,11
86,15,1,14,131,19,9
88,20,1,19,122,10,10
90,20,1,19,118,12,18
88,21,1,20,117,7,22
89,23,1,22,117,6,22
87,30,1,29,116,7,18
82,25,1,24,118,6,18
82,21,1,20,117,8,21
72,25,1,24,112,8,24
75,19,1,18,112,9,15
72,19,1,18,112,4,15
76,27,4,23,110,2,17
76,41,17,24,115,2,20
72,42,18,24,119,3,24
68,35,13,22,128,5,23
68,29,9,20,140,8,23
70,26,5,21,144,9,25
75,28,4,24,147,11,28
78,36,5,31,145,7,26
82,35,4,31,140,5,27
83,49,10,39,133,2,27
84,60,16,44,126,4,15
88,53,10,43,125,1,18
87,58,13,45,127,1,20
88,75,28,47,127,1,20
89,81,35,46,126,1,22
88,82,38,44,124,1,23
89,81,40,41,119,1,20
90,76,42,34,116,1,21
90,80,49,31,113,1,23
91,82,55,27,110,1,21
91,81,55,26,109,1,22
92,80,54,26,109,2,23
92,88,56,32,103,1,23
91,81,51,30,97,1,22
91,53,28,25,93,1,21
94,49,25,24,99,1,19
92,45,23,22,109,2,23
89,46,23,23,118,3,32
78,33,14,19,144,5,34
70,16,4,12,154,15,32
63,9,2,7,165,22,17
62,7,1,6,174,26,16
66,6,1,5,165,31,19
69,6,0,6,158,30,5
72,14,1,13,147,26,5
75,25,1,24,142,18,10
77,37,6,31,138,12,12
79,52,17,35,132,6,16
80,39,6,33,129,9,15
81,31,4,27,122,10,15
82,19,1,18,117,11,10
83,20,1,19,113,6,13
82,21,1,20,108,5,15
83,18,1,17,104,5,14
82,15,1,14,101,4,11
72,16,1,15,102,8,11
68,24,2,22,102,9,8
68,30,3,27,96,1,10
67,47,14,33,92,1,7
58,45,17,28,103,6,8
48,21,6,15,115,13,13
41,15,4,11,132,20,12
32,13,3,10,150,27,5
27,7,1,6,154,31,6
28,6,1,5,154,33,2
28,4,0,4,156,34,5
25,4,0,4,149,33,8
32,6,0,6,143,31,1
42,7,0,7,134,26,0
45,11,1,10,120,26,0
48,14,2,12,110,22,0
50,15,2,13,102,19,0
49,8,1,7,94,24,0
50,7,0,7,88,24,0
52,7,0,7,85,21,3
49,7,0,7,83,19,2
51,7,0,7,82,21,1
55,7,0,7,78,14,1
57,7,0,7,75,16,4
62,10,0,10,72,11,5
66,15,0,15,68,5,5
67,24,3,21,60,2,10
70,36,13,23,54,1,12
69,44,21,23,55,2,14
60,40,18,22,74,5,18
49,18,5,13,102,8,25
45,15,4,11,127,16,28
42,7,1,6,135,22,20
43,6,1,5,132,28,12
40,5,0,5,148,30,14
43,8,1,7,140,29,10
47,11,1,10,134,27,0
52,15,0,15,125,22,8
58,28,2,26,116,15,3
60,31,5,26,111,16,6
61,25,1,24,106,14,7
61,24,1,23,105,9,9
61,28,1,27,107,4,11
64,36,3,33,104,3,15
67,37,4,33,99,1,15
72,35,4,31,91,2,14
70,24,1,23,85,4,14
70,21,1,20,81,5,13
71,23,1,22,83,2,15
68,32,4,28,82,1,16
66,33,5,28,85,1,17
65,46,15,31,88,2,17
63,46,16,30,96,3,19
65,53,21,32,103,3,19
68,72,36,36,126,3,23
65,77,40,37,127,3,23
68,77,40,37,110,2,29
72,82,42,40,110,3,28
71,28,6,22,125,3,27
76,16,1,15,133,28,15
81,15,1,14,130,23,14
83,15,1,14,129,24,10
85,37,7,30,103,4,25
84,50,17,33,96,1,48
83,36,7,29,89,1,38
83,31,5,26,87,1,35
78,30,7,23,88,1,34
53,20,1,19,101,13,26
39,6,0,6,100,29,7
36,3,0,3,95,33,1
37,2,0,2,86,34,0
40,2,0,2,79,33,0
41,2,0,2,74,33,0
44,2,0,2,68,33,0
46,2,0,2,66,31,0
44,3,0,3,68,30,0
44,3,0,3,72,29,4
39,3,0,3,85,29,5
36,3,0,3,90,30,7
33,3,0,3,97,31,4
29,3,0,3,106,31,6
29,2,0,2,117,32,10
30,3,0,3,120,34,15
33,4,0,4,126,34,11
38,7,0,7,117,33,6
40,16,1,15,110,31,2
46,18,0,18,101,21,0
48,26,2,24,92,15,0
50,42,7,35,89,12,6
55,21,1,20,75,15,9
55,14,1,13,66,18,3
55,12,1,11,60,20,2
54,14,0,14,55,17,3
55,13,0,13,50,18,3
59,16.7975977,3.297271816,13.50032588,44,14,3
58,10,0,10,42,11,3
61,16,1,15,43,6,6
60,22,1,21,40,4,8
63,35,13,22,37,1,8
60,42,17,25,37,2,6
58,41,16,25,47,4,5
54,27,7,20,55,25.03305532,12
46,31,9,22,67,6,6
44,29,9,20,74,13,12
42,16.80468686,3.300288216,13.50439864,82,11,16
40,19,4,15,88,15,16
33,22,5,17,99,16,11
35,15,2,13,99,14,11
37,20,2,18,94,10,8
45,23,2,21,86,7,7
50,30,4,26,82,5,7
53,43,10,33,75,3,7
58,45,12,33,67,1,12
57,43,11,32,60,1,20
56,48,14,34,58,1,24
57,56,21,35,56,1,25
61,58,23,35,50,1,21
60,44,12,32,49,1,22
56,25,1,24,63,6,20
50,6,0,6,69,23,7
46,4,0,4,69,28,1
44,5,0,5,64,26,1
46,6,0,6,61,23,0
50,11,1,10,56,18,1
46,10,1,9,63,20,3
37,10,2,8,80,23,6
33,7,1,6,96,27,10
32,7,1,6,106,26,8
30,7,1,6,112,26,13
29,7,1,6,109,28,13
27,5,1,4,117,32,6
28,6,1,5,115,32,1
31,7,0,7,107,29,7
38,11,0,11,94,22,4
41,21,1,20,87,21,0
41,49,10,39,81,10,3
43,53,13,40,78,12,7
47,32,4,28,66,13,9
50,24,1,23,58,18,7
53,24,1,23,54,14,8
54,23,1,22,50,12,13
59,20,1,19,42,9,13
61,24,1,23,34,4,9
64,28,1,27,30,1,13
63,35,6,29,35,2,15
64,31,4,27,34,1,14
67,34,8,26,29,1,13
69,37,12,25,25,1,11
63,36,13,23,35,3,8
56,33,12,21,51,7,14
52,28,10,18,67,9,17
48,27,9,18,86,13,23
45,26,7,19,98,15,27
47,23,5,18,102,15,22
48,25,4,21,109,15,23
49,32,3,29,106,10,20
51,42,4,38,102,5,12
52,46,4,42,98,3,26
58,57,11,46,94,3,36
60,48,6,42,90,3,37
68,40,2,38,85,2,57
77,43,4,39,80,3,74
86,38,3,35,75,3,47
88,33,2,31,71,3,37
89,30,2,28,72,2,31
90,32,2,30,72,1,30
93,32,2,30,70,1,30
94,27,1,26,69,2,23
94,16,1,15,64,9,15
90,13,0,13,66,10,13
91,16,1,15,66,7,16
92,15,1,14,68,8,13
94,15,1,14,74,7,14
95,16,1,15,79,7,14
95,25,4,21,84,3,16
95,37,13,24,87,2,16
96,33,13,20,97,4,16
94,29,11,18,109,7,15
83,15,4,11,132,15,11
76,13,3,10,140,21,15
65,14,2,12,138,21,20
51,23,3,20,137,28,11
54,33,5,28,126,20,0
53,40,5,35,123,13,1
47,17,2,15,119,27,0
45,9,1,8,110,28,4
41,7,0,7,105,28,0
46,6,0,6,96,30,0
49,9,0,9,89,25,0
49,8,0,8,84,23,0
50,9,0,9,80,21,0
54,9,0,9,81,21,0
54,16,1,15,81,6,5
56,19,1,18,82,4,5
54,21,2,19,83,5,5
55,24,2,22,80,2,1
45,60,27,33,85,2,3
42,44,15,29,92,6,6
37,26,7,19,113,10,9
35,19,5,14,129,15,18
35,27,7,20,140,15,18
36,37,10,27,135,15,17
40,38,7,31,132,13,18
44,24,2,22,128,15,0
47,25,2,23,116,16,0
42,31,2,29,109,10,1
39,36,4,32,103,8,1
41,21,1,20,97,8,2
43,21,1,20,92,8,3
44,32,3,29,87,6,2
47,32,3,29,81,3,5
49,46,11,35,78,3,6
52,42,10,32,74,3,5
54,43,14,29,69,3,6
61,46,21,25,64,1,4
64,50,27,23,58,1,6
62,49,29,20,56,1,5
65,56,34,22,54,1,5
67,51,32,19,49,1,6
68,72,52,20,47,1,6
71,91,63,28,50,1,11
60,79,47,32,73,2,17
47,46,20,26,107,6,29
31,16,4,12,127,18,25
30,10,2,8,145,25,17
31,10,2,8,136,27,17
26,10,1,9,152,29,1
26,8,1,7,154,29,11
33,7,0,7,139,29,0
32,15,0,15,129,24,0
37,37,5,32,124,17,0
39,39,3,36,118,14,4
40,48,7,41,116,9,5
39,53,9,44,114,5,10
37,69,26,43,112,5,9
38,82,41,41,111,6,7
54,95,55,40,90,3,8
68,63,27,36,71,1,11
72,36,10,26,61,3,15
74,16,1,15,55,7,7
70,12,1,11,52,7,5
67,14,1,13,50,5,6
66,19,1,18,51,5,6
62,24,4,20,53,6,12
64,37,17,20,57,5,13
63,34,14,20,80,5,20
47,33,12,21,116,10,28
41,32,10,22,137,15,28
39,23,5,18,149,18,22
27,13,1,12,164,27,14
25,11,1,10,181,35,4
32,10,1,9,175,37,11
35,9,0,9,167,37,7
40,9,0,9,159,35,6
44,10,0,10,154,36,3
45,9,0,9,152,33,5
44,9,0,9,155,32,8
44,8,0,8,154,32,13
46,9,0,9,149,30,15
52,17,0,17,131,17,15
52,22,1,21,127,14,10
50,22,1,21,126,10,15
57,16.92490338,3.340358098,13.58454529,110,5,16
60,17,1,16,102,8,21
65,12,1,11,96,8,20
60,8,0,8,94,7,17
57,9,0,9,93,22,5
59,19,1,18,86,21,2
57,25,4,21,90,17,2
46,11,2,9,110,14,11
47,10,2,8,136,24.88896052,21
47,16.92322415,3.339276001,13.58394815,151,23,18
50,7,1,6,148,25,9
55,5,0,5,136,26,0
58,7,1,6,129,25,0
59,9,1,8,127,23,0
63,9,1,8,122,25,3
65,10,1,9,117,23,7
67,13,1,12,114,21,7
68,13,1,12,111,21,12
68,11,0,11,111,24,12
70,12,0,12,110,24,15
71,16,2,14,108,22,8
70,14,1,13,106,17,10
71,17,0,17,103,14,14
70,17,1,16,102,16,11
75,12,0,12,99,15,11
77,12,0,12,97,16,15
76,12,0,12,96,16,15
78,7,0,7,96,15,15
81,7,0,7,96,16,14
82,14,1,13,96,8,12
76,26,3,23,99,4,16
72,29,6,23,106,5,18
68,29,6,23,113,6,18
66,23,5,18,119,9,19
64,25,6,19,127,14,22
61,22,4,18,132,15,20
62,21,3,18,136,16,20
63,24,3,21,139,17,21
65,24,2,22,138,14,22
67,30,2,28,136,12,24
69,38,3,35,132,7,23
72,54,14,40,125,3,25
71,63,21,42,124,1,24
70,51,10,41,126,1,26
72,44,5,39,127,1,28
73,50,9,41,125,1,26
73,49,9,40,123,1,21
71,40,5,35,119,2,21
74,25,1,24,109,3,17
77,21,1,20,100,5,15
79,21,3,18,93,1,13
82,31,8,23,88,1,16
85,37,15,22,81,1,18
83,48,23,25,78,1,17
86,54,29,25,79,2,16
82,61,35,26,97,3,28
68,45,21,24,127,5,38
57,44,16,28,151,9,42
49,48,14,34,169,13,38
48,59,17,42,167,13,40
49,73,21,52,188,11,29
51,108,37,71,184,6,40
54,99,20,79,170,6,47
59,103,23,80,158,3,41
57,43,5,38,150,5,34
58,45,5,40,145,5,23
61,49,7,42,141,2,27
65,35,2,33,136,1,33
65,56,11,45,133,1,33
65,58,15,43,135,1,32
63,58,16,42,137,1,33
62,59,21,38,133,1,31
57,53,19,34,136,13,22
55,33,3,30,135,12,11
57,22,1,21,130,19,13
58,14,0,14,127,22,11
58,16,0,16,122,15,11
68,27,2,25,118,6,12
69,40,9,31,116,2,28
71,32,8,24,118,3,31
67,25,4,21,121,5,22
77,19,2,17,121,9,19
84,16,2,14,117,10,13
85,16,1,15,112,5,20
84,18,1,17,107,12,17
85,17,1,16,105,11,11
84,13,1,12,100,11,12
83,16,1,15,99,9,9
83,17,1,16,97,11,10
83,15,1,14,93,10,10
84,14,1,13,87,12,12
85,13,1,12,87,16,7
88,11,1,10,86,17,4
91,8,0,8,82,13,5
92,12,1,11,79,15,4
92,9,0,9,79,17,3
91,7,0,7,79,19,4
91,6,0,6,76,18,5
91,6,0,6,75,15,5
90,8,0,8,74,13,8
89,12,1,11,74,11,7
89,15,1,14,74,8,8
90,14,1,13,76,7,9
85,12,1,11,77,7,9
83,13,2,11,80,11,4
75,12,2,10,81,11,4
72,12,3,9,92,13,2
70,8,1,7,94,15,6
71,9,1,8,96,16,6
71,10,2,8,97,17,1
71,9,1,8,96,18,2
75,14,1,13,90,11,1
73,20,2,18,90,9,5
71,19,1,18,87,9,5
70,22,2,20,88,9,5
73,18,1,17,87,8,7
75,19,1,18,81,5,6
78,16,1,15,76,3,8
81,13,1,12,69,2,11
83,16,1,15,66,4,11
82,7,0,7,64,12,8
77,7,0,7,57,19,3
86,7,0,7,52,12,1
79,5,0,5,47,7,3
75,7,0,7,45,14,1
83,12,1,11,41,5,3
74,13,2,11,43,4,3
62,10,2,8,59,14,8
46,7,1,6,86,17,15
42,6,1,5,106,24,15
41,5,1,4,100,27,8
40,5,1,4,100,30,1
36,4,0,4,120,30,7
34,4,0,4,118,31,7
39,5,0,5,104,30,3
47,10,0,10,90,26,0
55,26,4,22,81,16,0
59,27,1,26,75,11,4
60,35,3,32,70,12,8
60,34,3,31,66,15,7
64,31,3,28,63,11,7
67,26,1,25,61,2,8
67,26,1,25,59,2,9
71,29,2,27,53,4,14
72,20,1,19,51,5,13
72,17,1,16,51,7,12
70,15,1,14,52,7,12
70,14,1,13,51,5,14
70,14,1,13,50,4,11
70,14,1,13,49,6,10
69,13,2,11,52,8,12
60,13,4,9,67,12,11
52,13,4,9,86,15,21
47,12,3,9,107,19,23
45,11,2,9,120,23,23
47,8,1,7,114,28,19
44,10,1,9,130,32,23
43,10,1,9,132,34,20
46,10,0,10,120,34,17
52,19,1,18,107,21,14
57,42,5,37,97,7,5
62,50,8,42,89,8,12
66,60,15,45,87,4,14
66,30,1,29,81,4,17
68,25,1,24,76,16,22
71,29,1,28,69,13,26
75,31,2,29,62,6,32
79,28,1,27,57,3,33
79,16.99907211,3.348833792,13.65023831,54,3,25
79,20,1,19,49,1,25
81,21,1,20,45,1,22
80,21,1,20,42,1,20
75,26,3,23,40,1,20
76,37,11,26,39,1,19
80,51,26,25,45,1,22
73,54,29,25,63,2,27
61,53,27,26,86,24.73440814,31
57,17.00907397,3.35374666,13.65532731,106,7,28
52,35,11,24,115,9,27
51,33,8,25,119,10,21
54,31,6,25,119,10,15
56,39,7,32,117,7,16
58,45,9,36,115,5,18
56,52,11,41,112,1,21
60,52,10,42,109,1,26
66,41,3,38,105,2,26
79,40,3,37,99,3,20
81,41,3,38,96,2,17
81,41,4,37,94,1,20
80,42,5,37,91,1,23
79,40,5,35,91,1,22
81,43,10,33,84,1,24
83,46,14,32,77,1,23
86,48,16,32,70,1,22
93,57,24,33,62,1,23
94,48,18,30,58,1,21
93,52,25,27,52,1,23
93,75,47,28,50,1,22
80,94,66,28,64,1,18
71,80,46,34,76,2,24
51,52,22,30,109,8,12.30618633
40,28,8,20,130,19,21
39,19,4,15,138,23,16
38,18,3,15,133,26,16
39,22,3,19,144,29,21
35,14,1,13,143,31,2
37,18,1,17,133,31,9
38,16,0,16,123,26,0
35,26,1,25,116,17,0
42,36,3,33,103,11,2
43,60,15,45,104,3,7
38,56,11,45,97,5,8
39,35,2,33,82,6,5
41,21,1,20,74,8,3
42,24,1,23,70,11,2
43,27,2,25,68,14,1
44,22,1,21,65,16,2
49,14,0,14,57,20,2
53,12,0,12,49,18,0
71,16,1,15,38,10,1
75,18,1,17,32,5,3
77,35,12,23,27,2,8
76,37,15,22,30,4,12
73,30,12,18,45,6,20
60,31,14,17,71,8,22
47,23,9,14,95,12,20
37,11,3,8,107,19,19
39,9,2,7,98,25,13
32,8,1,7,113,26,5
31,8,1,7,109,25,5
33,10,1,9,98,24,6
37,17,1,16,90,17,5
41,41,7,34,84,9,0
53,32,3,29,76,10,0
58,35,4,31,70,13,7
65,47,11,36,63,7,11
68,27,3,24,54,11,13
63,23,1,22,49,6,10
68,23,1,22,38,4,8
66,21,2,19,33,7,8
65,15,1,14,30,7,4
67,17,1,16,27,9,5
69,18,1,17,23,6,5
71,21,1,20,21,3,7
70,30,5,25,21,1,8
71,42,16,26,19,1,9
69,54,28,26,30,2,7
63,41,19,22,44,5,13
52,33,15,18,71,8,20
46,27,10,17,94,12,24
47,20,6,14,107,16,21
50,13,3,10,103,17,22
43,12,2,10,120,22,19
40,16,2,14,122,24,16
42,14,1,13,110,28,10
45,18,1,17,96,25,0
48,48,11,37,94,9,0
51,93,46,47,88,3,1
58,124,75,49,79,1,8
64,146,95,51,72,1,13
63,120,74,46,63,1,17
68,122,78,44,59,1,21
72,104,59,45,53,2,21
72,75,37,38,45,1,26
70,52,20,32,43,1,24
71,41,10,31,39,1,22
73,35,7,28,35,1,18
75,39,12,27,36,1,20
76,50,25,25,35,1,21
78,95,66,29,34,1,25
78,138,104,34,35,2,26
75,81,50,31,46,1,27
70,80,48,32,53,2,31
67,65,34,31,54,2,29
66,85,50,35,64,2,27
67,67,33,34,70,2,39
64,59,24,35,71,2,54
63,49,17,32,70,2,45
65,49,16,33,71,1,34
65,57,20,37,71,1,42
69,51,12,39,72,1,54
83,47,10,37,66,3,54
87,14,1,13,41,14,30
92,7,1,6,24,22,0
92,7,1,6,26,20,0
88,9,1,8,33,19,0
84,8,0,8,35,21,4
78,10,0,10,37,18,4
68,8,0,8,34,19,2
62,7,0,7,31,19,3
61,7,0,7,30,21,0
57,8,0,8,32,22,0
58,21,2,19,27,15,3
55,43,18,25,28,5,4
47,27,7,20,41,13,4
39,14,3,11,54,22,7
34,10,2,8,72,26,10
31,8,2,6,86,27,7
28,7,1,6,95,27,9
31,6,1,5,90,27,10
31,8,1,7,106,28,6
30,13,2,11,104,27,12
37,20,2,18,96,23,12
43,32,4,28,86,15,0
44,59,19,40,78,2,0
50,47,9,38,70,9,4
52,46,8,38,63,9,4
55,63,24,39,58,3,10
55,64,27,37,56,1,13
62,62,27,35,46,1,17
65,39,6,33,34,2,15
71,34,5,29,24,1,14
74,27,3,24,21,1,19
75,26,3,23,19,1,14
70,22,2,20,18,1,15
70,28,5,23,18,1,13
69,29,6,23,14,1,14
69,25,4,21,16,1,14
66,25,7,18,22,3,12
61,23,8,15,33,7,17
50,20,7,13,65,10,25
44,22,7,15,84,14,30
42,23,6,17,105,18,26
44,24,5,19,104,22,25
41,27,5,22,119,25,24
41,28,4,24,125,23,22
42,14,1,13,130,25,9
42,8,0,8,122,30,3
51,19,1,18,99,17,0
54,43,4,39,87,14,13
55,42,4,38,78,13,19
58,35,3,32,72,13,29
60,49,9,40,69,8,35
60,53,12,41,65,4,26
62,52,14,38,61,1,26
65,53,16,37,54,1,24
65,17.22429685,3.452024106,13.77227274,52,2,28
65,31,3,28,49,2,28
67,29,2,27,47,2,24
67,29,2,27,45,1,21
67,33,6,27,46,1,21
66,40,12,28,43,1,22
70,52,25,27,43,2,23
71,45,22,23,53,3,24
56,40,17,23,85,24.56551166,37
49,17.23514076,3.456153247,13.77898752,114,5,38
45,46,17,29,141,8,38
41,50,16,34,146,12,33
41,51,13,38,156,13,30
39,37,6,31,159,10,15
36,24,2,22,153,16,16
37,20,1,19,141,24,0
34,25,1,24,134,24,0
36,19,1,18,121,25,0
40,18,1,17,112,21,4
39,24,1,23,107,15,9
39,16,1,15,99,25,8
41,15,1,14,89,23,3
40,17,1,16,84,23,3
39,14,1,13,75,20,2
32,14,0,14,69,22,3
29,7,0,7,66,25,1
29,7,0,7,64,27,0
32,10,0,10,57,26,1
37,20,1,19,45,10,2
35,50,19,31,48,5,3
36,71,34,37,54,9,4
30,27,7,20,66,15,8
23,16,4,12,90,19,14
18,11,2,9,103,22,13
19,10,2,8,109,23,11
18,10,2,8,97,23,8
17,10,2,8,106,24,2
18,8,1,7,107,26,0
21,6,0,6,90,24,5
22,15,1,14,86,20,0
22,37,4,33,83,19,0
25,29,5,24,73,15,0
27,20,2,18,69,17,0
29,27,3,24,64,18,0
31,42,9,33,57,18,0
34,48,15,33,53,8,0
36,51,18,33,48,10,1
38,55,24,31,42,13,0
42,23,2,21,36,10,1
46,19,1,18,30,6,1
48,17,0,17,27,7,2
50,19,1,18,24,7,3
53,33,6,27,20,1,3
51,46,12,34,22,1,3
49,48,17,31,28,2,6
42,31,10,21,45,6,9
31,23,7,16,74,15,13
27,15,4,11,94,21,10
23,10,2,8,101,23,11
25,6,1,5,94,26,5
22,7,1,6,104,27,5
23,6,1,5,108,27,11
27,8,0,8,90,27,4
29,8,0,8,80,25,0
38,9,0,9,69,25,0
47,15,1,14,56,18,0
46,15,1,14,47,17,2
45,17,1,16,44,14,8
46,15,1,14,38,16,2
46,14,1,13,36,17,2
46,8,0,8,35,22,0
41,7,0,7,36,25,0
39,5,0,5,36,29,2
37,5,0,5,35,26,3
39,5,0,5,32,25,4
43,7,0,7,26,21,5
43,11,0,11,24,13,4
44,21,1,20,21,10,0
47,26,4,22,24,14,5
34,16,3,13,46,18,7
32,13,3,10,65,23,12
29,8,2,6,79,27,10
28,6,1,5,91,28,6
26,5,1,4,91,29,5
24,5,1,4,96,29,4
24,5,1,4,96,30,3
27,5,0,5,89,28,1
32,10,0,10,78,22,1
34,14,1,13,69,19,0
37,15,1,14,65,18,0
40,18,1,17,59,18,0
45,20,1,19,49,14,2
48,19,1,18,45,10,2
49,19,1,18,42,14,2
50,21,1,20,39,14,4
50,15,1,14,37,15,6
53,12,0,12,34,15,5
55,12,0,12,33,11,6
61,20,1,19,25,4,8
64,33,5,28,17,1,7
61,42,14,28,18,1,9
63,49,19,30,18,1,9
62,65,34,31,21,1,12
59,65,35,30,26,2,12
50,53,25,28,45,4,16
48,39,13,26,55,5,21
47,49,19,30,62,5,24
44,45,16,29,69,5,26
52,35,8,27,77,7,30
46,20,2,18,79,8,21
47,29,3,26,77,8,15
51,34,3,31,66,3,17
52,54,16,38,58,1,20
55,65,25,40,56,1,23
56,79,38,41,56,1,20
56,83,40,43,61,1,20
56,68,26,42,62,1,25
57,91,46,45,53,2,33
58,75,35,40,50,1,44
58,72,34,38,45,1,50
59,88,49,39,40,1,43
58,64,29,35,40,1,32
59,45,13,32,38,1,35
60,33,4,29,32,1,31
62,41,12,29,28,1,25
61,59,30,29,27,1,23
61,72,42,30,31,2,24
57,49,22,27,41,3,27
46,46,20,26,70,5,36
40,38,14,24,96,9,40
37,36,11,25,121,14,37
42,43,11,32,117,14,31
42,46,9,37,127,13,32
45,46,6,40,126,10,17
46,49,5,44,120,7,19
48,51,3,48,114,5,22
52,79,21,58,104,2,17
55,97,39,58,96,1,21
57,94,38,56,87,1,23
59,98,43,55,80,1,32
59,89,38,51,78,1,39
58,81,33,48,75,1,46
57,64,20,44,72,1,54
58,65,22,43,68,1,51
62,75,32,43,64,1,46
54,57,16,41,62,1,49
41,10,1,9,74,25,24
33,4,0,4,71,32,0
34,3,0,3,66,33,0
40,4,0,4,57,30,0
42,5,0,5,55,27,0
36,6,1,5,65,28,1
32,5,1,4,77,30,6
26,3,0,3,84,30,2
22,3,0,3,87,29,6
25,3,0,3,82,30,4
25,3,0,3,85,31,3
24,3,0,3,77,31,3
23,3,0,3,70,32,2
26,4,0,4,58,32,0
29,6,0,6,48,29,0
32,8,0,8,41,25,0
35,9,0,9,37,25,2
37,10,0,10,35,26,2
40,11,0,11,33,24,1
42,13,1,12,31,21,3
45,12,1,11,29,24,4
50,13,0,13,20,22,2
50,17.36171965,3.510125147,13.8515945,16,18,5
51,14,0,14,13,18,5
55,13,0,13,7,16,6
58,12,0,12,2,10,5
59,17,1,16,0,3,7
62,30,4,26,0,1,9
62,50,20,30,0,1,9
59,36,12,24,14,4,18
50,17.3650768,3.510951936,13.85412486,33,4,30
38,35,11,24,60,24.45469578,30
34,32,9,23,74,12,25
37,32,8,24,75,13,19
37,32,7,25,85,15,12
38,27,4,23,91,18,13
39,25,2,23,83,21,12
44,30,2,28,70,11,4
46,59,16,43,62,2,4
47,72,27,45,58,4,14
51,72,30,42,50,1,18
53,105,57,48,45,1,26
59,124,76,48,36,1,24
61,95,50,45,28,1,23
64,87,44,43,24,1,25
64,71,30,41,17,1,30
62,70,31,39,12,1,27
58,54,21,33,13,1,20
62,49,20,29,12,1,19
64,60,34,26,8,1,22
64,71,46,25,9,1,21
66,115,84,31,7,1,23
66,175,138,37,11,2,25
63,158,110,48,24,2,29
53,126,74,52,58,2,40
47,120,67,53,91,3,46
41,85,41,44,110,7,45
37,37,11,26,110,14,20
28,31,7,24,122,19,12
28,24,4,20,127,22,14
35,26,2,24,111,17,6
34,35,3,32,104,9,7
34,21,1,20,93,17,0
34,12,1,11,82,19,0
33,16,1,15,75,19,0
36,14,1,13,68,24,0
40,12,1,11,56,22,0
50,10,0,10,46,17,0
54,15,1,14,38,16,0
54,18,1,17,33,11,1
51,23,2,21,33,12,2
51,23,2,21,30,10,2
53,27,4,23,26,6,5
53,27,5,22,24,6,5
54,36,12,24,24,1,7
59,84,53,31,24,1,7
59,82,48,34,20,1,7
49,66,35,31,41,2,13
37,27,8,19,67,8,21
32,15,3,12,83,17,22
30,10,2,8,97,19,11
33,8,1,7,86,23,11
31,10,1,9,104,23,11
35,13,1,12,100,22,13
35,16,1,15,95,18,8
42,20,1,19,80,14,2
46,34,3,31,70,3,0
51,48,10,38,61,3,8
55,68,25,43,52,3,10
56,75,33,42,50,2,14
59,91,48,43,44,1,15
59,61,19,42,37,1,20
60,78,35,43,30,1,21
62,70,30,40,26,1,29
62,65,28,37,19,1,28
63,43,10,33,13,1,22
59,33,3,30,14,1,17
63,38,6,32,12,2,16
69,60,27,33,2,1,20
70,67,34,33,0,1,21
70,88,55,33,4,1,27
64,93,59,34,19,2,26
55,58,29,29,37,4,25
48,49,23,26,72,9,27
44,34,12,22,88,14,30
43,16,3,13,90,16,27
42,13,2,11,105,21,24
43,12,2,10,110,23,15
52,9,1,8,92,21,7
58,14,1,13,80,19,0
63,33,3,30,69,10,0
68,50,10,40,60,5,0
70,62,19,43,56,7,3
71,65,20,45,54,1,8
73,67,23,44,50,1,10
75,60,16,44,43,1,10
77,59,19,40,36,1,12
79,58,20,38,31,1,15
76,71,32,39,27,1,20
73,56,19,37,24,1,22
71,45,10,35,18,1,20
71,47,14,33,14,1,15
71,55,22,33,9,1,18
73,73,39,34,7,0,17
71,83,48,35,13,1,19
70,80,46,34,25,2,25
61,73,39,34,37,3,26
49,63,31,32,62,7,24
44,43,16,27,85,10,25
46,34,9,25,87,13,31
41,25,5,20,109,21,29
39,20,3,17,115,24,23
44,23,2,21,103,21,14
47,44,4,40,95,9,6
55,87,32,55,82,2,6
57,102,50,52,80,1,16
59,139,88,51,77,1,17
63,143,93,50,75,1,17
66,142,94,48,68,1,27
71,133,87,46,53,1,30
72,127,83,44,49,1,29
73,118,73,45,38,1,31
70,105,62,43,28,1,27
68,75,37,38,21,1,28
70,58,24,34,17,1,27
68,51,20,31,17,1,25
66,58,25,33,18,1,27
66,60,25,35,16,1,28
68,46,16,30,17,1,29
64,35,12,23,35,3,30
50,29,9,20,68,7,37
42,35,11,24,92,12,36
39,29,7,22,110,16,32
39,21,4,17,110,23,37
34,15,2,13,126,28,33
32,13,1,12,137,34,24
37,14,1,13,123,33,20
40,25,1,24,113,18,11
41,44,3,41,108,13,16
49,77,23,54,102,2,21
52,95,43,52,93,1,25
58,128,74,54,81,1,29
62,149,95,54,76,1,30
65,176,122,54,67,1,27
60,167,117,50,71,1,28
59,147,98,49,66,1,24
60,105,63,42,53,1,24
66,78,40,38,42,1,25
68,62,24,38,37,1,28
70,44,9,35,32,1,30
72,32,3,29,29,1,29
73,30,3,27,30,1,27
71,29,5,24,35,2,24
65,24,4,20,45,5,25
62,26,5,21,51,8,26
59,22,4,18,57,11,31
54,22,4,18,67,15,34
51,22,4,18,79,17,34
47,21,3,18,97,20,44
44,21,3,18,111,22,50
50,20,2,18,108,22,46
55,39,7,32,96,16,40
60,65,19,46,86,4,26
57,74,28,46,89,2,31
61,73,26,47,88,2,43
73,66,22,44,98,1,48
75,49,9,40,97,1,45
79,40,4,36,94,1,41
90,45,6,39,99,1,40
89,35,3,32,101,4,29
92,17.77124758,3.734262582,14.036985,96,7,21
93,20,1,19,92,7,22
94,35,8,27,66,1,44
93,27,4,23,60,5,57
88,18,1,17,66,8,26
83,19,1,18,70,4,21
65,22,2,20,101,14,19
52,13,2,11,118,22,12
42,8,1,7,132,24.27099211,11
36,17.77255202,3.733613055,14.03893896,139,34,7
31,8,1,7,141,34,4
30,8,1,7,140,34,4
29,8,1,7,134,34,2
28,8,1,7,126,34,3
33,7,0,7,108,33,5
35,8,0,8,95,29,0
38,9,0,9,86,28,0
39,10,0,10,79,24,0
39,16,1,15,76,20,1
40,11,0,11,75,25,3
40,7,0,7,75,28,0
41,6,0,6,69,29,0
43,6,0,6,66,29,0
43,6,0,6,58,29,2
42,6,0,6,56,29,0
42,6,0,6,55,28,0
42,6,0,6,56,28,2
42,7,0,7,56,25,2
42,11,0,11,53,19,2
46,20,1,19,44,7,3
46,31,5,26,44,5,5
42,36,9,27,55,11,8
36,30,8,22,81,15,18
42,31,9,22,97,17,20
45,37,12,25,109,15,14
44,32,9,23,110,16,10
38,23,5,18,127,21,8
35,17,2,15,130,24,13
26,17,1,16,121,24,9
31,10,0,10,105,24,1
31,16,1,15,96,22,0
37,14,1,13,85,21,0
37,12,0,12,74,21,0
38,16,1,15,67,22,0
42,11,1,10,57,22,0
41,8,0,8,49,23,0
43,10,0,10,46,23,0
45,9,0,9,42,24,0
46,8,0,8,38,23,0
48,8,0,8,32,21,0
48,8,0,8,28,21,0
49,14,0,14,25,21,0
51,24,2,22,21,15,0
50,30,3,27,20,12,3
48,36,8,28,25,10,0
43,23,5,18,38,14,4
30,23,6,17,65,18,11
26,11,2,9,78,25,10
21,6,1,5,82,29,7
21,3,0,3,79,32,0
27,5,1,4,75,32,0
28,5,1,4,70,31,2
29,5,0,5,59,31,1
35,7,0,7,48,29,0
38,8,0,8,40,26,0
43,7,0,7,33,24,0
45,8,0,8,28,25,2
49,9,0,9,23,23,2
53,8,0,8,16,21,0
48,9,0,9,20,25,0
49,9,0,9,18,25,0
55,8,0,8,11,23,2
57,6,0,6,6,24,1
56,7,0,7,5,23,0
42,8,0,8,19,24,2
42,7,0,7,16,26,3
43,17,1,16,16,21,2
46,26,2,24,11,6,5
49,31,4,27,11,8,3
38,28,6,22,37,9,11
28,22,5,17,67,25,14
25,7,1,6,79,31,10
23,5,1,4,87,31,4
23,4,0,4,87,32,4
23,5,1,4,91,33,2
23,4,0,4,88,33,3
26,4,0,4,75,34,3
28,6,0,6,64,31,0
34,8,0,8,54,30,0
40,8,0,8,41,26,0
41,10,0,10,36,28,0
42,13,1,12,34,27,0
45,12,0,12,29,25,1
42,13,1,12,32,28,2
41,8,1,7,33,31,0
41,6,0,6,31,31,3
35,5,0,5,38,29,1
35,3,0,3,38,32,3
38,3,0,3,36,35,2
38,6,0,6,35,32,5
37,5,0,5,36,29,2
39,6,0,6,39,32,1
37,11,1,10,37,31,4
34,13,2,11,53,28,5
31,8,1,7,74,32,10
28,6,1,5,84,34,9
25,5,1,4,92,35,4
24,3,0,3,91,34,6
24,3,0,3,97,36,5
21,4,0,4,105,37,8
24,4,0,4,94,35,5
27,15,1,14,82,30,5
32,25,2,23,79,23,0
37,20,0,20,75,22,0
38,34,3,31,68,12,9
44,49,5,44,57,2,13
46,40,3,37,56,9,7
44,15,1,14,53,24,3
44,6,0,6,50,32,0
49,5,0,5,43,33,0
51,5,0,5,38,33,0
54,6,0,6,29,31,2
56,7,0,7,25,29,0
57,12,0,12,23,24,2
54,11,0,11,26,23,3
48,12,0,12,28,18,3
49,19,2,17,31,19,8
43,15,2,13,52,25,10
36,8,1,7,71,29,14
29,6,1,5,86,30,13
26,5,1,4,98,32,10
25,3,0,3,102,32,4
23,3,0,3,110,32,7
23,3,0,3,109,33,5
27,3,0,3,100,33,2
33,4,0,4,86,31,0
35,5,0,5,75,30,0
36,12,1,11,66,27,0
39,15,1,14,60,23,0
42,13,1,12,54,27,1
47,11,1,10,48,28,5
49,8,0,8,40,28,0
50,9,0,9,37,30,0
55,11,0,11,28,27,2
57,10,0,10,25,25,4
61,14,1,13,22,17,4
61,12,0,12,22,12,3
59,13,0,13,22,16,7
59,11,0,11,20,16,9
60,11,0,11,21,16,6
61,14,1,13,24,16,7
60,14,2,12,31,17,9
60,13,2,11,35,17,13
60,13,2,11,38,17,18
58,13,2,11,42,18,31
53,13,2,11,44,18,36
73,12,1,11,36,18,34
79,12,1,11,36,20,36
79,12,1,11,42,21,37
79,12,1,11,44,21,32
81,14,1,13,43,17,30
81,22,3,19,41,14,28
83,28,4,24,37,9,26
84,28,4,24,34,9,21
84,21,2,19,33,4,23
84,29,3,26,29,3,27
85,31,4,27,26,2,41
84,30,5,25,24,1,41
84,17.71884046,3.708034586,14.01080588,21,1,36
82,26,5,21,17,2,47
80,16,1,15,14,2,46
80,15,1,14,9,4,37
78,15,1,14,7,4,28
79,14,1,13,3,3,23
80,14,2,12,4,4,23
75,16,5,11,20,9,21
65,16,5,11,55,11,26
43,13,3,10,94,20,35
29,6,1,5,117,29,22
28,3,0,3,115,31,7
24,3,0,3,123,32,3
25,3,0,3,126,32,6
26,3,0,3,112,32,2
29,5,0,5,98,31,2
34,5,0,5,85,30,0
39,5,0,5,73,29,0
42,8,0,8,65,28,0
43,6,0,6,63,30,0
42,4,0,4,60,31,0
44,4,0,4,55,31,0
44,3,0,3,53,31,2
45,2,0,2,51,32,1
49,4,0,4,41,29,3
49,5,0,5,39,26,2
51,7,0,7,32,25,2
48,8,0,8,36,26,2
44,5,0,5,40,28,3
46,6,0,6,38,28,1
47,7,0,7,34,21,4
42,8,1,7,51,24,5
34,6,1,5,74,26,11
29,3,0,3,87,30,10
27,3,0,3,97,31,7
27,3,0,3,93,32,10
25,2,0,2,101,33,4
23,2,0,2,102,33,5
25,2,0,2,91,33,2
28,5,0,5,81,32,2
32,16,1,15,70,25,0
32,28,3,25,68,20,1
35,30,3,27,62,12,1
39,46,9,37,58,9,5
45,52,12,40,49,5,6
47,58,16,42,43,1,9
46,41,5,36,39,2,9
51,16,1,15,45,22,3
54,3,0,3,43,29,2
49,3,0,3,39,30,1
54,3,0,3,31,30,1
61,4,0,4,21,27,0
63,6,0,6,13,23,0
54,5,0,5,22,24,2
51,5,0,5,26,27,0
44,5,1,4,36,27,4
31,4,1,3,55,29,9
20,3,0,3,67,31,7
19,2,0,2,72,31,6
21,2,0,2,72,31,5
21,2,0,2,77,31,3
25,2,0,2,74,32,3
34,2,0,2,62,32,1
39,3,0,3,53,32,0
46,3,0,3,43,30,0
47,4,0,4,38,29,0
45,4,0,4,38,30,0
47,4,0,4,36,30,0
43,6,0,6,36,29,1
40,6,0,6,35,30,0
40,8,0,8,33,30,3
44,11,0,11,25,27,3
44,11,0,11,25,27,1
51,10,0,10,12,20,2
49,13,1,12,13,18,1
46,16,1,15,17,20,2
50,19,2,17,12,14,4
54,27,3,24,7,14,1
56,33,8,25,6,4,4
51,24,6,18,21,13,8
34,14,3,11,54,24.26265281,19
27,17.6811182,3.695494581,13.98562362,77,23,15
24,5,1,4,85,28,3
24,3,0,3,83,29,0
26,2,0,2,86,30,2
24,3,0,3,88,31,4
26,2,0,2,76,31,2
28,5,0,5,66,31,2
31,10,1,9,55,27,0
35,14,1,13,47,26,0
36,14,1,13,47,26,0
40,19,1,18,35,25,1
45,20,1,19,27,21,3
48,22,1,21,25,16,1
52,21,1,20,18,19,4
54,14,1,13,15,18,1
56,7,0,7,14,20,3
57,9,0,9,12,19,4
56,11,0,11,11,16,1
56,13,0,13,11,15,4
58,15,0,15,7,10,5
58,28,4,24,5,2,4
56,41,12,29,7,3,7
53,41,13,28,17,6,8
47,36,11,25,30,7,13
39,29,7,22,43,12,19
35,22,4,18,52,20,14
42,13,2,11,59,20,11
47,10,1,9,60,15,9
49,11,1,10,59,14,7
55,9,1,8,58,17,6
69,10,1,9,48,20,6
73,17,2,15,43,18,5
74,18,2,16,42,17,5
74,19,1,18,40,16,10
77,30,3,27,36,12,9
79,38,6,32,32,13,13
80,51,18,33,25,7,11
83,56,25,31,21,1,12
82,64,34,30,15,1,11
70,52,22,30,7,1,14
68,49,14,35,3,1,19
63,33,4,29,2,1,21
60,28,1,27,2,2,16
62,32,3,29,0,1,13
64,43,12,31,0,1,12
59,51,20,31,2,2,10
55,49,20,29,14,4,17
47,32,10,22,45,9,29
36,30,9,21,73,13,31
31,31,9,22,89,17,23
28,20,4,16,89,24,13
25,19,3,16,100,26,9
27,25,4,21,107,28,9
44,37,5,32,93,17,11
51,24,1,23,85,16,6
50,38,4,34,80,14,0
50,41,3,38,77,10,1
41,48,5,43,71,4,10
45,18,1,17,62,24,5
44,9,0,9,53,27,0
38,5,0,5,53,32,0
37,4,0,4,53,35,1
39,4,0,4,50,35,3
42,3,0,3,45,35,1
42,2,0,2,45,36,3
40,3,0,3,41,34,4
41,5,0,5,41,32,5
38,3,0,3,41,34,5
35,4,0,4,44,32,5
34,5,0,5,50,31,6
32,4,0,4,62,30,4
28,5,1,4,78,30,10
27,3,0,3,91,32,10
24,3,0,3,102,32,10
23,3,0,3,102,33,8
23,2,0,2,110,34,4
22,2,0,2,117,33,10
25,2,0,2,103,33,13
28,5,0,5,89,30,5
31,29,4,25,78,24,0
34,56,13,43,69,11,0
39,36,3,33,69,6,3
39,55,12,43,65,7,9
40,75,30,45,59,9,9
44,79,36,43,51,5,9
49,43,11,32,43,8,8
50,22,1,21,39,8,9
53,17.70703254,3.7022038,14.00482874,37,5,13
53,19,1,18,32,11,16
55,17,1,16,31,13,11
52,14,0,14,33,12,10
52,12,1,11,33,12,11
54,16,1,15,31,12,12
53,19,2,17,34,6,16
48,21,4,17,44,9,14
45,19,3,16,51,13,15
43,25,4,21,55,15,17
43,23,4,19,62,16,17
41,25,6,19,75,17,22
50,33,5,28,76,11,25
60,52,11,41,77,4,18
68,65,21,44,80,2,16
76,75,30,45,76,1,18
85,84,39,45,73,1,16
86,65,25,40,58,1,21
86,59,20,39,50,2,36
86,49,12,37,48,6,45
88,32,3,29,42,11,30
89,18,1,17,40,12,32
88,17,1,16,41,13,32
88,18,1,17,43,7,33
87,21,1,20,46,5,35
89,21,1,20,47,4,35
90,25,1,24,49,2,31
90,29,2,27,49,1,31
90,36,7,29,51,1,29
89,49,19,30,56,1,26
87,17.73560096,3.709892989,14.02570797,57,1,27
88,76,44,32,59,24.19767896,12.31668864
87,91,58,33,70,2,31
86,87,52,35,87,2,39
77,57,27,30,120,5,28
65,32,11,21,143,9,27
38,35,11,24,155,14,34
37,14,2,12,156,27,22
41,14,1,13,142,26,0
41,19,1,18,128,24,2
30,17,1,16,114,19,0
25,13,0,13,105,29,0
37,13,1,12,86,26,0
37,13,1,12,77,27,0
34,13,1,12,68,26,0
32,15,1,14,66,25,1
33,34,4,30,60,19,7
43,37,5,32,48,9,8
33,37,7,30,51,14,8
36,38,10,28,46,12,8
37,34,5,29,44,11,6
34,28,1,27,47,12,7
44,28,1,27,45,4,9
46,34,2,32,47,8,8
44,33,4,29,52,13,8
38,39,10,29,61,13,16
32,32,8,24,88,17,29
24,22,5,17,104,23,23
26,19,4,15,111,26,16
29,12,2,10,107,30,9
31,13,2,11,108,32,7
31,12,2,10,109,32,4
33,13,1,12,101,31,7
35,14,1,13,94,26,7
34,17,1,16,90,25,3
34,16,0,16,86,24,3
33,14,0,14,84,25,6
35,15,0,15,82,23,7
39,14,0,14,79,24,8
36,11,0,11,81,27,7
44,18,1,17,65,23,6
44,24,1,23,53,10,6
43,17,0,17,45,15,5
48,15,0,15,39,19,7
53,13,0,13,34,20,4
56,16,0,16,28,15,1
54,25,2,23,28,7,2
55,40,10,30,24,6,6
55,85,49,36,24,3,8
46,70,34,36,37,5,16
38,23,6,17,63,9,25
33,25,7,18,85,16,22
30,32,10,22,89,15,21
29,32,9,23,88,17,13
26,27,6,21,94,18,9
22,17,3,14,101,22,9
17,12,1,11,83,25,4
15,7,0,7,70,26,0
18,8,0,8,59,24,0
22,13,1,12,47,21,0
23,14,1,13,42,15,0
25,16,1,15,34,13,0
27,19,2,17,29,11,3
28,13,1,12,25,15,5
32,15,1,14,18,16,4
34,16,1,15,11,13,4
32,15,0,15,13,12,5
36,16,0,16,6,12,5
37,15,0,15,2,11,4
36,14,0,14,0,3,7
37,18,1,17,0,4,6
40,42,12,30,0,1,8
39,74,39,35,0,2,10
33,76,42,34,12,5,13
28,29,10,19,37,12,18
26,14,4,10,50,19,17
26,10,2,8,57,21,13
23,10,2,8,55,24,9
19,7,1,6,62,25,12
16,9,1,8,83,27,8
18,12,1,11,61,26,9
21,17,1,16,51,19,3
25,35,5,30,46,14,0
30,47,8,39,42,5,0
38,27,2,25,33,11,4
44,36,4,32,24,6,8
50,39,5,34,16,4,9
54,50,12,38,7,1,12
58,52,15,37,2,1,16
58,49,16,33,0,1,19
59,38,8,30,0,1,12
61,33,4,29,0,1,13
62,29,2,27,0,2,11
62,35,6,29,0,1,10
62,29,3,26,0,1,9
62,35,7,28,0,1,10
60,45,17,28,0,2,13
61.87421877,46,21,25,174.0977075,24.14122907,12.29803218
61.87421877,42,19,23,174.0977075,24.14122907,12.29803218
61.87421877,28,10,18,174.0977075,24.14122907,12.29803218
61.87421877,16,4,12,174.0977075,24.14122907,12.29803218
61.87421877,17,4,13,174.0977075,24.14122907,12.29803218
61.87421877,15,3,12,174.0977075,24.14122907,12.29803218
61.87421877,19,3,16,174.0977075,24.14122907,12.29803218
29,22,2,20,67,24.14122907,7
34,30,2,28,58,24.14122907,32
39,57,14,43,50,4,15
45,114,61,53,36,1,10
46,108,57,51,34,1,17
49,89,41,48,27,1,18
52,75,28,47,19,1,17
48,52,12,40,21,3,20
53,23,1,22,16,12,19
53,15,1,14,15,18,11
54,10,1,9,11,21,5
50,7,0,7,10,22,5
45,5,0,5,21,28,3
48,4,0,4,20,32,2
49,4,0,4,14,27,1
48,7,0,7,13,25,1
48,12,1,11,12,27,2
44,6,1,5,24,28,6
38,6,1,5,51,30,16
34,5,1,4,63,32,8
29,5,1,4,76,32,9
28,3,0,3,70,35,10
25,3,0,3,78,36,6
22,2,0,2,86,37,8
23,3,0,3,75,36,7
31,7,0,7,66,35,3
33,22,2,20,54,32,0
35,28,3,25,46,25,0
38,30,2,28,39,22,2
41,35,2,33,34,19,8
40,50,9,41,33,18,16
41,47,8,39,35,14,15
48,51,14,37,29,9,12
50,60,22,38,27,5,13
54,17.82442192,3.742175888,14.08224604,24,2,16
58,52,15,37,4,1,15
57,50,12,38,0,1,16
60,46,11,35,0,1,15
62,41,9,32,0,0,15
63,48,16,32,0,1,18
63,57,25,32,0,1,22
53,52,23,29,0,24.12425837,25
44,17.83850846,3.747575745,14.09093271,35,9,28
38,39,14,25,51,12,26
37,30,8,22,63,14,19
37,36,10,26,78,13,20
37,39,10,29,97,13,19
36,16,2,14,101,12,21
40,25,4,21,83,10,22
44,47,7,40,72,4,20
46,60,12,48,64,1,14
49,86,34,52,55,1,15
49,105,53,52,54,1,23
47,125,71,54,54,1,27
52,151,95,56,47,1,30
56,158,101,57,41,1,31
54,151,98,53,37,1,33
55,155,103,52,33,1,31
55,139,91,48,34,1,34
63,138,90,48,25,1,40
63,141,92,49,22,1,38
66,148,103,45,18,1,41
66,150,105,45,9,1,37
65,138,95,43,7,1,32
64,177,133,44,9,1,27
62,127,81,46,30,2,32
47,105,57,48,77,2,49
40,49,15,34,106,4,53
37,38,9,29,123,5,48
33,23,4,19,128,13,33
31,16,2,14,140,26,23
27,12,1,11,154,33,6
33,16,1,15,133,33,23
48,23,1,22,120,23,2
50,36,2,34,108,10,9
51,63,16,47,96,2,12
56,62,16,46,92,1,18
65,88,40,48,79,1,21
73,105,56,49,77,1,25
80,123,77,46,68,1,22
77,95,52,43,62,1,27
79,104,64,40,57,1,30
73,115,73,42,50,1,29
72,81,40,41,49,1,28
67,53,16,37,52,1,30
64,47,12,35,53,1,28
62,53,18,35,54,1,28
60,73,36,37,53,1,25
61,100,61,39,52,2,26
62,93,53,40,54,2,29
67,87,46,41,56,2,38
73,60,24,36,68,2,34
76,48,15,33,75,2,41
73,47,16,31,80,3,38
81,43,15,28,91,3,50
77,39,12,27,91,3,48
81,40,12,28,90,1,55
89,39,11,28,82,1,61
94,55,22,33,84,1,58
94,21,2,19,83,7,21
94,22,2,20,77,8,15
94,16,1,15,75,13,9
92,14,1,13,67,15,6
90,8,0,8,63,22,6
92,7,0,7,61,26,0
91,6,0,6,60,26,0
87,5,0,5,57,28,1
87,6,0,6,50,26,0
87,7,0,7,46,23,2
88,11,0,11,43,19,2
89,28,3,25,40,6,3
90,42,11,31,41,4,1
88,44,15,29,45,4,3
82,43,15,28,58,8,6
70,49,18,31,90,7,18
59,56,21,35,113,12,17
54,35,10,25,126,18,20
59,43,11,32,129,16,23
61,33,6,27,129,19,16
62,28,3,25,128,17,9
62,23,2,21,125,21,8
66,25,1,24,119,14,3
70,44,7,37,112,2,7
70,66,20,46,111,1,10
69,66,21,45,104,2,11
73,77,30,47,93,1,14
76,73,29,44,88,1,15
80,76,33,43,84,1,15
83,83,42,41,81,1,18
75,70,27,43,73,1,20
67,37,4,33,68,2,19
63,25,1,24,65,14,19
61,19,1,18,61,16,24
58,16,1,15,63,22,19
58,19,1,18,59,15,11
57,28,2,26,57,7,9
49,40,7,33,66,7,8
46,36,8,28,77,20,11
40,27,6,21,94,23,12
34,16,3,13,104,27,17
35,15,2,13,104,30,15
34,16,2,14,108,28,7
37,12,1,11,109,26,7
42,13,1,12,106,24,14
39,10,0,10,102,25,9
44,15,1,14,96,23,7
54,22,2,20,91,22,3
53,17,2,15,86,25,9
53,14,1,13,83,26,8
57,15,1,14,76,21,6
58,16,1,15,72,21,11
59,14,1,13,66,20,10
55,13,1,12,60,21,9
53,12,0,12,55,21,7
51,11,0,11,55,20,8
55,9,0,9,54,19,9
59,8,0,8,49,14,11
58,14,0,14,46,13,12
59,16,1,15,46,9,13
60,21,1,20,45,7,15
59,26,3,23,46,6,14
60,29,6,23,50,7,13
59,28,7,21,60,8,18
58,19,4,15,72,10,24
58,17,3,14,78,11,25
60,15,3,12,85,18,18
60,9,1,8,90,24,20
59,9,1,8,90,26,18
58,8,1,7,90,26,17
63,12,1,11,84,25,19
67,30,3,27,76,17,14
72,56,19,37,68,4,11
78,73,35,38,63,1,20
81,78,42,36,58,1,23
82,92,57,35,54,1,24
85,105,71,34,49,1,30
85,116,85,31,47,1,27
86,107,79,28,44,1,28
87,101,75,26,41,1,28
79,71,38,33,36,1,26
70,37,7,30,34,2,25
77,25,1,24,29,4,40
80,31,4,27,26,1,39
78,29,6,23,28,5,33
81,31,9,22,27,6,33
80,27,8,19,34,4,40
61,22,6,16,68,9,53
46,11,2,9,92,23,42
38,8,1,7,109,28,31
40,7,1,6,109,37,21
40,8,1,7,119,38,24
38,7,0,7,123,41,22
48,8,0,8,112,41,21
50,14,0,14,101,38,9
51,29,1,28,94,31,7
53,55,11,44,91,23,11
59,74,19,55,78,10,21
50,64,13,51,72,5,26
55,21,1,20,60,22,11
52,9,1,8,52,27,4
52,8,0,8,43,26,0
52,9,0,9,37,25,1
56,18.14003239,3.919030864,14.22100153,31,21,0
58,9,0,9,31,14,4
57,8,0,8,31,15,6
57,10,0,10,28,11,9
58,13,0,13,27,6,3
55,18,1,17,30,7,8
62,19,1,18,28,3,8
62,18.13802633,3.917675384,14.22035095,29,4,7
69,16,1,15,29,9,9
81,14,1,13,22,23.99039169,16
87,12,1,11,17,15,12
90,16,2,14,17,15,9
90,14,1,13,13,15,11
92,11,1,10,11,15,10
93,9,1,8,6,20,7
95,12,1,11,2,18,7
96,10,1,9,0,22,9
96,11,1,10,0,23,7
96,9,1,8,0,25,10
97,7,0,7,0,27,4
97,6,0,6,3,28,4
96,5,0,5,5,28,3
95,5,0,5,5,25,6
94,7,0,7,6,23,8
91,12,2,10,7,21,7
91,8,0,8,6,23,4
91,11,0,11,7,14,7
90,17,0,17,7,4,10
89,28,2,26,7,2,10
90,44,13,31,4,1,8
88,86,50,36,8,2,6
85,64,30,34,17,6,11
79,48,17,31,45,7,23
72,46,18,28,76,14,23
61,20,6,14,87,21,20
72,27,8,19,48,18,17
68,40,12,28,57,19,15
69,37,9,28,58,18,13
68,38,7,31,58,15,16
74,44,5,39,47,6,18
60,74,23,51,61,1,14
72,79,27,52,48,2,12
44,46,6,40,46,5,16
37,22,1,21,42,23,2
32,23,1,22,42,25,3
32,26,2,24,38,24,3
36,30,2,28,30,23,2
40,24,1,23,22,20,2
47,25,1,24,13,8,2
47,32,2,30,11,5,4
54,27,1,26,4,2,4
54,32,2,30,5,1,6
60,53,18,35,0,1,7
58,73,33,40,0,1,9
54,64,25,39,0,4,7
49,66,28,38,21,5,8
32,55,23,32,54,14,27
24,17,4,13,70,22,16
23,10,2,8,77,26,9
22,8,1,7,65,29,6
20,7,1,6,70,30,0
28,14,2,12,64,28,3
29,8,1,7,50,32,0
31,9,0,9,39,31,0
38,9,0,9,20,30,0
41,8,0,8,14,29,0
45,10,1,9,6,26,0
45,11,0,11,0,24,1
47,13,1,12,0,21,0
49,12,1,11,0,22,1
46,6,0,6,0,25,1
49,6,0,6,0,23,1
51,5,0,5,0,25,0
50,5,0,5,0,25,1
38,6,0,6,0,23,1
35,6,0,6,0,26,2
32,10,0,10,0,26,3
32,12,1,11,0,24,3
33,15,2,13,0,23,2
29,14,3,11,0,23,4
26,9,2,7,14,27,11
25,6,1,5,23,28,5
22,6,1,5,30,28,5
22,5,1,4,27,30,3
23,6,1,5,36,30,4
21,6,1,5,37,30,5
25,6,1,5,27,30,2
27,7,0,7,19,27,3
30,16,1,15,11,21,1
33,19,1,18,5,21,0
35,16,1,15,0,20,0
38,18,1,17,0,19,2
39,21,1,20,0,17,3
38,28,3,25,0,17,4
40,24,2,22,0,14,4
39,17,1,16,0,13,3
40,15,0,15,0,13,3
38,13,0,13,0,15,4
39,13,0,13,0,13,3
39,16,0,16,0,11,5
39,30,2,28,0,2,5
38,46,9,37,0,4,7
39,41,11,30,0,5,8
35,27,7,20,11,14,8
34,17,4,13,28,21,9
29,10,2,8,39,27,13
27,7,1,6,49,29,10
27,6,1,5,43,31,8
26,5,1,4,41,31,6
26,5,1,4,38,33,5
24,5,0,5,28,34,1
29,6,0,6,19,34,0
27,6,0,6,12,34,0
26,7,0,7,7,32,0
27,6,0,6,5,32,2
29,8,0,8,1,32,3
29,9,0,9,0,30,5
31,10,0,10,0,30,6
33,9,1,8,0,29,4
31,5,0,5,0,30,3
36,6,0,6,0,30,3
36,11,0,11,0,22,4
35,12,0,12,0,28,3
35,10,0,10,0,26,6
36,13,0,13,0,21,3
35,30,3,27,0,10,5
31,49,14,35,1,14,7
29,24,5,19,19,23,8
25,13,3,10,42,27,14
24,7,1,6,53,31,7
22,5,1,4,61,32,6
21,5,1,4,63,34,5
21,4,0,4,67,35,5
22,5,1,4,65,36,6
24,4,0,4,57,35,7
28,5,0,5,44,34,2
34,7,0,7,34,33,0
37,7,0,7,27,31,0
34,7,0,7,24,31,5
34,5,0,5,23,33,10
37,7,0,7,15,32,9
35,8,0,8,13,28,6
32,9,0,9,16,29,8
33,5,0,5,17,34,5
36,3,0,3,15,35,4
39,5,0,5,11,34,5
39,6,0,6,10,34,4
45,4,0,4,0,33,6
49,7,0,7,0,30,6
50,9,0,9,0,26,7
50,12,1,11,0,25,6
48,10,1,9,3,26,10
45,11,2,9,14,27,14
45,11,1,10,20,28,12
44,11,1,10,25,26,13
44,11,1,10,30,22,15
41,13,2,11,41,24,19
42,13,1,12,43,24,21
40,16,1,15,50,20,24
50,17,1,16,34,21,27
53,24,1,23,20,22,25
55,22,1,21,13,21,18
58,37,4,33,11,14,20
61,48,7,41,9,4,21
63,64,18,46,4,2,23
64,41,5,36,0,4,24
66,31,2,29,0,1,22
67,36,2,34,0,1,23
64,18.14151387,3.912696399,14.22881747,0,1,22
64,45,8,37,0,1,25
66,47,12,35,0,1,29
68,41,6,35,0,1,24
69,38,6,32,0,1,15
70,51,17,34,0,1,18
67,63,29,34,0,2,25
62,60,28,32,2,3,26
50,18.15510463,3.917597036,14.2375076,39,6,35
41,40,14,26,68,23.95227952,33
45,16,3,13,91,17,33
49,12,2,10,94,21,16
44,11,2,9,104,24,11
55,8,1,7,89,26,15
58,7,1,6,74,29,0
64,10,1,9,63,27,0
68,13,1,12,53,28,0
71,27,4,23,46,21,0
74,24,2,22,40,21,0
75,24,2,22,39,16,6
85,21,1,20,28,21,6
88,8,0,8,25,28,4
88,7,0,7,18,29,1
91,9,0,9,14,24,6
91,13,0,13,9,14,7
93,12,0,12,2,11,5
92,12,0,12,0,14,10
76,18,1,17,0,9,9
80,16,1,15,0,13,6
80,22,2,20,0,6,14
77,37,9,28,0,6,17
53,27,7,20,16,9,19
46,16,4,12,35,17,21
39,12,3,9,54,22,17
33,11,2,9,55,25,10
31,7,1,6,55,28,2
27,7,1,6,64,30,8
27,6,1,5,76,32,5
29,7,1,6,65,31,8
31,14,1,13,58,25,10
33,22,1,21,57,19,0
34,31,3,28,57,20,0
38,32,2,30,52,17,6
43,32,2,30,39,9,7
45,46,8,38,32,12,12
50,45,8,37,26,9,12
57,51,13,38,15,2,14
57,37,4,33,12,2,14
65,34,3,31,4,1,12
62,31,2,29,0,5,14
64,29,2,27,0,3,14
65,35,4,31,0,1,14
67,48,13,35,0,1,14
68,54,19,35,0,1,14
63,63,29,34,0,2,15
55,55,25,30,4,4,22
41,37,13,24,40,10,28
36,28,9,19,62,12,24
31,26,7,19,81,17,25
33,23,5,18,82,19,23
30,22,4,18,91,21,22
31,20,3,17,94,26,15
38,24,2,22,83,28,12
41,31,1,30,78,23,9
43,48,3,45,70,12,10
47,59,11,48,60,1,15
50,82,30,52,54,1,24
57,116,59,57,45,1,26
58,125,68,57,42,1,30
58,89,37,52,36,1,28
62,50,7,43,31,1,27
63,61,16,45,27,1,27
59,56,13,43,25,1,29
61,49,9,40,21,1,24
62,45,8,37,16,1,20
64,52,16,36,13,1,17
65,58,22,36,10,1,15
68,66,30,36,7,1,16
68,74,38,36,10,1,16
65,65,31,34,22,4,20
60,43,15,28,42,6,21
59,28,7,21,56,7,22
63,12,1,11,57,14,21
74,8,1,7,51,21,13
81,7,1,6,46,23,8
83,8,1,7,42,21,6
81,7,0,7,41,21,11
84,8,1,7,38,16,7
86,12,2,10,34,25,8
86,11,1,10,32,21,7
88,10,1,9,29,26,9
90,10,1,9,24,27,11
93,9,1,8,13,18,10
94,9,0,9,8,7,14
95,13,0,13,7,5,18
95,10,0,10,9,16,18
96,9,0,9,7,24,14
96,7,0,7,7,26,13
96,8,0,8,6,23,14
96,9,0,9,6,22,14
95,11,0,11,6,22,15
96,11,0,11,5,19,14
96,15,1,14,6,18,11
95,19,3,16,8,16,12
95,21,4,17,9,16,12
93,19,4,15,15,17,13
90,16,3,13,18,22,13
90,13,2,11,22,23,11
84,16,3,13,26,21,9
81,16,2,14,32,22,9
78,17,2,15,36,23,11
80,14,1,13,35,21,13
81,18,1,17,34,16,13
82,21,1,20,33,14,11
81,24,2,22,32,11,14
81,24,2,22,32,13,13
82,25,2,23,31,11,12
81,23,1,22,31,10,11
80,19,1,18,30,12,14
80,21,1,20,29,13,14
80,22,1,21,27,9,15
82,24,1,23,26,7,14
84,21,1,20,23,8,12
87,18,1,17,22,4,11
87,19,1,18,18,2,13
89,26,4,22,17,1,14
88,34,11,23,19,2,13
78,40,16,24,31,6,19
62,28,9,19,53,17,24
56,19,5,14,69,21,23
57,15,3,12,70,22,21
59,12,2,10,69,24,15
57,10,1,9,72,25,12
58,12,1,11,72,26,12
59,15,2,13,69,26,14
60,15,1,14,64,25,13
64,23,1,22,55,19,16
67,39,4,35,51,8,12
66,51,9,42,53,4,22
69,51,9,42,54,2,20
69,46,6,40,52,1,22
70,29,1,28,48,3,18
68,32,2,30,43,13,15
67,24,1,23,36,16,15
68,15,1,14,30,20,11
68,12,0,12,29,21,11
66,12,0,12,30,20,12
61,9,0,9,34,26,13
62,8,0,8,31,23,14
60,11,0,11,31,21,13
52,17,2,15,37,22,13
51,14,2,12,39,27,14
47,13,1,12,48,24,13
40,18,3,15,65,24,18
39,11,2,9,96,31,23
35,9,1,8,96,34,26
34,14,2,12,97,35,20
32,12,1,11,101,37,14
34,9,1,8,92,37,12
48,10,0,10,72,36,3
43,7,0,7,64,36,0
42,7,0,7,58,37,0
37,19,1,18,54,27,2
42,18,1,17,43,21,8
40,25,1,24,38,18,5
38,38,4,34,37,15,7
40,36,3,33,29,9,10
45,10,0,10,32,29,4
50,18.22413361,3.930750673,14.29338293,28,33,0
52,5,0,5,24,30,0
51,6,0,6,24,29,2
54,7,0,7,19,27,3
54,11,0,11,16,20,5
55,16,1,15,11,12,4
53,29,5,24,14,13,5
48,22,4,18,23,17,10
40,18.22218599,3.929670085,14.2925159,45,21,11
33,15,3,12,67,22,14
28,13,2,11,84,23.87504906,16
27,13,2,11,79,23.87504906,29
28,12,2,10,86,27,12
28,11,1,10,82,30,12.33989627
31,13,1,12,77,29,12.33989627
32,11,1,10,72,34,6
46,14,1,13,60,23,0
51,22,3,19,52,22,3
56,21,1,20,40,20,2
57,22,1,21,33,21,7
56,23,1,22,32,18,7
62,17,1,16,22,21,9
62,13,1,12,14,24,9
65,17,1,16,9,27,16
69,17,1,16,5,20,13
70,17,0,17,3,16,13
68,25,1,24,2,10,14
62,31,2,29,0,9,14
53,28,2,26,0,2,12
52,42,5,37,0,2,8
44,44,11,33,5,5,11
33,27,7,20,23,13,11
27,23,6,17,48,20,19
23,17,4,13,62,21,15
18,14,3,11,69,24,11
16,10,2,8,75,25,6
17,8,1,7,78,27,10
15,8,1,7,78,27,5
17,10,1,9,73,25,9
19,16,1,15,60,27,8
28,24,1,23,49,23,0
32,72,24,48,45,14,0
30,81,28,53,40,4,1
34,78,27,51,33,2,6
30,59,18,41,28,7,8
31,31,3,28,23,20,3
34,21,2,19,14,16,1
33,18,1,17,13,20,3
34,16,0,16,8,22,3
37,18,0,18,3,20,3
38,18,0,18,2,17,6
40,23,1,22,0,12,6
41,30,1,29,0,8,7
44,43,6,37,0,2,6
40,49,14,35,0,4,10
30,52,19,33,17,9,13
22,17,4,13,54,21,19
14,11,2,9,73,26,13
14,11,2,9,79,25,17
13,11,2,9,76,28,9
13,7,1,6,83,30,2
12,7,1,6,88,32,13
13,5,0,5,84,32,17
14,10,0,10,67,30,5
22,25,1,24,62,19,0
31,22,1,21,50,22,0
34,13,1,12,41,26,0
36,19,1,18,34,22,0
42,18,1,17,28,18,0
46,22,1,21,21,6,3
43,26,1,25,16,8,7
46,13,0,13,10,20,3
48,7,0,7,7,26,2
50,8,0,8,5,24,1
52,10,0,10,0,21,3
54,13,0,13,0,8,4
55,20,1,19,0,3,7
58,30,3,27,0,2,4
55,32,7,25,0,6,5
46,25,7,18,16,10,10
37,22,6,16,41,18,19
28,19,5,14,68,21,11
24,12,3,9,85,24,16
24,7,1,6,81,27,15
23,9,1,8,86,29,16
21,10,1,9,94,30,10
21,11,1,10,83,30,9
22,13,1,12,73,28,4
28,18,1,17,65,26,0
24,27,1,26,58,18,0
25,20,1,19,48,20,0
30,24,2,22,39,18,6
34,23,1,22,29,18,9
38,23,1,22,23,11,12
41,31,1,30,17,15,15
42,27,1,26,12,21,14
45,29,1,28,9,22,13
47,38,4,34,5,21,13
48,29,1,28,6,10,16
53,32,2,30,0,1,17
56,50,13,37,0,1,17
56,81,35,46,0,1,20
56,104,58,46,0,2,23
41,35,9,26,14,10,24
32,21,4,17,47,19,33
30,18,3,15,62,22,31
24,17,3,14,82,27,30
22,15,2,13,89,28,31
25,21,3,18,94,27,26
26,19,2,17,98,29,22
34,17,1,16,89,34,21
41,15,1,14,83,37,13
43,16,0,16,76,34,14
46,54,7,47,68,16,10
53,65,12,53,59,3,17
54,82,24,58,52,6,24
57,72,17,55,43,5,24
59,64,13,51,37,6,24
61,62,15,47,33,10,30
65,64,17,47,28,2,31
64,69,19,50,21,2,31
57,57,12,45,12,1,33
56,52,10,42,10,1,37
59,45,6,39,8,1,31
59,59,19,40,8,1,29
57,62,22,40,11,1,26
53,51,15,36,17,3,27
48,51,17,34,28,7,35
39,35,10,25,65,13,38
37,35,9,26,78,18,45
35,29,5,24,90,22,44
33,33,6,27,105,22,38
37,42,7,35,112,23,36
41,47,8,39,117,26,29
46,31,3,28,117,31,33
55,34,1,33,113,29,28
58,19,1,18,117,39,15
50,21,1,20,117,43,17
53,23,1,22,115,46,16
63,20,1,19,109,44,19
72,15,1,14,102,46,16
78,10,1,9,94,43,16
74,9,0,9,95,41,14
73,8,0,8,83,36,17
66,16,1,15,71,18,27
66,20,1,19,66,18,34
73,14,0,14,59,25,33
68,15,1,14,57,18,28
69,18,1,17,58,14,34
67,16,1,15,62,14,38
68,20,2,18,68,21,35
64,19,3,16,78,20,24
53,16,2,14,109,25,30
44,12,1,11,130,32,37
38,11,1,10,134,35,30
38,9,1,8,132,38,16
39,12,1,11,130,38,5
44,16,1,15,130,40,3
45,18,1,17,128,39,7
27,15,1,14,123,36,11
28,7,0,7,102,38,2
28,5,0,5,82,38,0
25,5,0,5,71,38,0
25,4,0,4,60,38,0
27,3,0,3,52,38,0
27,3,0,3,47,37,0
27,3,0,3,42,37,3
28,3,0,3,37,37,3
31,18.29211527,3.935545976,14.35656929,31,36,3
33,3,0,3,28,36,3
36,3,0,3,20,34,4
38,4,0,4,13,30,3
41,6,0,6,8,23,4
40,9,0,9,7,16,5
35,18,2,16,24,18,4
26,16,3,13,45,26,12
20,9,1,8,63,32,18
19,6,1,5,78,33,16
18,6,1,5,78,35,16
19,4,0,4,78,36,14
19,5,0,5,75,38,8
19,11,1,10,87,36,7
22,11,1,10,83,36,10
18,13,1,12,76,35,12
23,12,1,11,67,36,0
22,8,0,8,56,33,0
26,11,0,11,48,32,0
29,17,1,16,39,29,0
30,35,3,32,37,25,2
32,30,2,28,33,26,2
36,24,1,23,25,20,6
38,31,2,29,19,19,5
40,31,2,29,16,14,6
43,29,2,27,12,10,5
43,33,4,29,8,3,7
41,26,2,24,6,11,12
40,24,1,23,7,7,9
40,42,6,36,9,5,8
38,69,28,41,16,9,8
34,38,11,27,29,23.84738844,12.3488267
25,30,8,22,63,17,10
22,30,8,22,81,20,20
17,41,13,28,97,17,20
18,26,6,20,82,23,16
19,17,2,15,85,24,1
15,14,2,12,95,32,1
20,12,1,11,99,31,8
23,12,1,11,78,32,9
28,10,0,10,63,28,0
27,24,2,22,57,22,0
29,43,5,38,50,18,0
31,33,2,31,43,18,2
33,44,5,39,38,14,2
37,60,14,46,32,5,8
40,52,10,42,25,2,9
42,59,18,41,20,1,9
46,55,16,39,16,1,10
44,55,18,37,16,1,10
46,58,18,40,14,3,7
45,48,8,40,13,10,4
47,51,13,38,8,7,9
47,57,17,40,10,1,9
44,64,24,40,19,4,10
36,56,20,36,41,7,17
27,18.32431823,3.94111949,14.38319874,77,16,21
25,18.32431823,3.94111949,14.38319874,96,23,22
38,18.32431823,3.94111949,14.38319874,90,25,19
35,25,4,21,91,28,13
36,32,6,26,98,25,6
42,30,5,25,99,26,17
39,24,3,21,110,27,12
35,22,1,21,102,24,13
34,23,1,22,98,29,4
37,21,0,21,91,31,0
37,22,0,22,88,28,0
37,24,1,23,87,25,8
37,24,0,24,86,25,10
37,22,0,22,83,22,10
37,26,1,25,82,20,12
38,20,0,20,81,24,13
40,20,0,20,78,25,14
42,24,0,24,73,15,14
40,28,1,27,87,18,14
40,24,0,24,95,23,13
43,30,1,29,73,16,16
47,54,8,46,67,4,16
47,85,33,52,75,4,16
41,46,10,36,95,9,19
39,32,5,27,111,18,18
33,18,2,16,133,24,16
31,12,1,11,146,33,20
32,11,1,10,146,35,20
31,13,1,12,151,40,23
38,15,1,14,152,38,13
44,15,1,14,140,38,20
49,15,0,15,127,35,9
60,15,1,14,97,36,2
61,17,1,16,85,38,0
59,21,2,19,80,35,3
60,20,1,19,74,29,9
57,19,1,18,77,31,13
59,19,1,18,73,28,17
39,13,0,13,67,25,13
43,13,0,13,57,27,12
39,13,0,13,50,24,8
42,14,0,14,42,30,4
43,13,0,13,39,27,2
44,12,0,12,36,27,8
44,13,0,13,37,28,6
42,17,1,16,38,26,8
43,34,4,30,42,18,10
40,18,2,16,50,24,13
33,15,2,13,74,28,18
29,11,1,10,89,29,18
28,10,1,9,93,32,18
32,11,1,10,88,31,16
37,13,1,12,90,27,4
51,9,0,9,86,30,7
51,8,0,8,83,33,7
54,9,0,9,75,32,3
56,13,1,12,69,33,2
55,22,2,20,64,30,2
57,15,1,14,64,31,6
60,14,1,13,63,32,6
61,14,1,13,62,30,9
62,13,1,12,61,28,9
62,10,0,10,59,28,8
61,10,0,10,57,27,8
62,11,0,11,55,27,8
63,9,0,9,54,28,8
63,9,0,9,53,27,9
64,11,0,11,51,25,11
65,12,0,12,51,23,10
67,15,1,14,46,21,10
66,23,3,20,50,15,12
63,16,2,14,64,25,18
55,11,1,10,87,29,22
47,10,1,9,104,29,23
38,15,2,13,117,28,25
37,15,2,13,124,30,22
35,21,2,19,108,34,19
31,7,0,7,84,40,0
26,6,0,6,83,37,0
27,7,0,7,74,36,0
29,6,0,6,57,36,2
31,6,0,6,45,34,1
33,5,0,5,36,34,1
40,4,0,4,26,33,0
42,4,0,4,16,34,0
43,4,0,4,11,35,0
44,4,0,4,7,34,1
42,4,0,4,3,35,0
41,4,0,4,1,35,1
42,4,0,4,0,35,4
44,4,0,4,0,35,6
48,5,0,5,0,34,7
47,7,0,7,0,28,7
41,14,0,14,0,27,7
29,14,1,13,10,27,11
26,9,1,8,26,31,15
22,5,0,5,52,34,12
20,4,0,4,71,35,12
19,4,0,4,72,35,12
17,3,0,3,79,37,9
18,3,0,3,82,38,8
20,3,0,3,78,38,27
20,3,0,3,69,38,16
22,3,0,3,58,38,5
25,5,0,5,47,37,0
29,9,0,9,38,35,0
30,8,0,8,35,33,1
31,8,0,8,34,33,3
35,10,1,9,28,33,3
36,9,0,9,25,32,1
37,7,0,7,21,31,4
39,8,0,8,20,32,4
42,18.30107637,3.923064098,14.37801227,18,30,3
42,9,0,9,18,28,6
44,6,0,6,18,28,7
43,7,0,7,17,29,7
44,13,0,13,13,25,4
45,42,7,35,9,15,6
45,52,16,36,10,15,6
40,27,6,21,21,17,9
32,20,4,16,58,20,22
28,17,3,14,73,19,23
22,16,3,13,94,23.8672882,17
23,14,2,12,99,27,16
28,18.30238691,3.922933957,14.37945296,96,28,13
33,18.30238691,3.922933957,14.37945296,97,34,9
37,18.30238691,3.922933957,14.37945296,88,32,4
41,15,1,14,83,31,3
47,17,0,17,82,30,0
50,33,3,30,83,26,3
46,25,1,24,76,21,7
49,25,1,24,72,22,9
50,22,1,21,67,23,12
49,17,0,17,64,24,10
51,14,0,14,61,26,13
55,15,0,15,59,23,13
57,13,0,13,56,15,14
58,16,1,15,47,15,18
57,15,0,15,44,18,16
56,12,0,12,40,18,8
57,18,1,17,32,12,10
57,27,2,25,29,6,9
55,37,8,29,37,7,10
54,21,4,17,58,17,19
38,14,2,12,88,27,24
34,13,2,11,105,28,20
26,13,2,11,117,32,20
24,10,1,9,120,34,20
22,10,1,9,123,37,16
21,10,1,9,127,40,11
24,10,0,10,124,39,14
21,19,1,18,111,39,12
52,14,1,13,94,36,0
58,13,1,12,82,37,0
60,15,1,14,78,36,1
60,22,1,21,77,31,3
61,29,1,28,71,26,7
67,36,2,34,61,14,9
69,28,1,27,52,8,13
69,27,1,26,43,11,17
69,14,1,13,38,17,18
69,14,0,14,35,15,14
68,17,1,16,35,12,12
66,15,0,15,34,12,15
58,20,1,19,34,17,15
57,25,1,24,34,17,10
54,39,7,32,37,10,10
45,26,4,22,46,17,9
41,14,2,12,59,18,13
37,9,1,8,68,22,12
30,8,1,7,77,28,11
29,8,1,7,80,23.86544258,12.3200233
28,7,0,7,83,23.86544258,12.3200233
29,7,0,7,80,31,12.3200233
28,7,0,7,80,32,12.3200233
44,10,0,10,78,30,12.3200233
48,9,0,9,67,32,12.3200233
48,12,1,11,63,34,12.3200233
52,12,1,11,57,34,12.3200233
51,12,1,11,57,35,12.3200233
52,9,0,9,57,35,12.3200233
52,9,0,9,57,36,12.3200233
53,9,0,9,55,36,12.3200233
56,6,0,6,52,36,12.3200233
67,5,0,5,44,36,12.3200233
77,5,0,5,35,39,12.3200233
84,4,0,4,30,37,12.3200233
82,7,0,7,23,32,12.3200233
88,7,0,7,17,27,12.3200233
91,14,1,13,14,24,12.3200233
91,14,1,13,15,24,12.3200233
91,16,2,14,16,15,12.3200233
89,16,2,14,17,17,12.3200233
89,14,2,12,19,17,12.3200233
88,14,3,11,26,20,12.3200233
88,12,2,10,27,20,12.3200233
85,14,2,12,28,16,7
85,14,1,13,29,17,13
86,15,1,14,28,20,13
88,14,1,13,27,20,9
88,16,1,15,27,22,6
88,18,2,16,28,23,9
88,13,1,12,29,26,10
88,12,1,11,30,27,11
88,13,1,12,29,24,12
89,16,1,15,26,23,11
91,15,1,14,22,22,10
92,13,1,12,18,21,11
92,10,0,10,18,19,12
93,10,0,10,18,19,14
92,9,0,9,20,22,13
91,8,0,8,20,23,14
92,11,0,11,19,19,14
92,15,1,14,18,13,14
93,21,2,19,19,9,17
92,28,5,23,22,8,14
90,31,7,24,27,11,14
90,23,5,18,37,19,15
82,19,4,15,51,23,11
76,17,3,14,59,23,20
71,15,2,13,69,22,19
65,12,2,10,83,27,22
56,8,1,7,88,31,29
59,10,0,10,80,35,23
66,26,3,23,72,23,13
71,47,7,40,60,8,3
75,76,31,45,53,3,10
79,89,44,45,47,2,16
77,78,34,44,50,4,20
80,87,45,42,41,2,16
82,89,49,40,38,1,21
80,82,45,37,38,1,22
73,89,52,37,37,1,27
68,90,54,36,33,2,23
66,74,43,31,29,8,20
64,86,57,29,27,5,17
65,81,51,30,21,2,18
69,100,60,40,20,2,16
68,80,41,39,23,2,21
63,53,20,33,38,5,25
44,38,11,27,77,9,35
38,41,11,30,98,18,35
42,34,8,26,115,21,23
45,30,6,24,117,28,26
44,19,2,17,129,33,26
34,18,2,16,136,38,28
29,21,1,20,142,37,32
33,27,1,26,132,35,32
39,36,1,35,117,27,20
35,48,3,45,108,25,15
38,17,1,16,96,37,7
42,12,0,12,84,35,6
40,16,0,16,75,28,8
43,18,1,17,67,31,4
50,22,1,21,56,32,5
52,22,1,21,47,28,6
50,24,1,23,39,29,8
53,25,1,24,36,28,8
53,20,1,19,34,25,7
52,15,1,14,37,31,8
48,9,0,9,36,35,8
48,9,0,9,36,35,9
44,12,1,11,43,30,9
41,10,1,9,57,32,11
47,9,1,8,61,35,19
49,10,1,9,64,33,16
47,10,1,9,77,32,14
49,9,1,8,72,35,20
49,7,0,7,70,37,17
51,6,0,6,64,37,10
53,6,0,6,63,38,6
55,8,0,8,62,38,7
57,13,1,12,58,35,10
59,12,1,11,55,38,10
59,7,0,7,54,39,10
61,8,0,8,54,36,11
70,8,0,8,53,38,10
75,8,0,8,45,34,8
77,8,0,8,45,32,10
77,7,0,7,45,32,12
73,18.33810884,3.936210886,14.40189795,44,28,10
72,8,0,8,43,24,13
73,8,0,8,42,21,15
72,12,0,12,42,19,15
73,16,1,15,39,15,18
74,19,1,18,36,11,18
72,25,3,22,37,9,16
68,23,4,19,47,23.8664203,22
56,18.33706972,3.935100763,14.40196896,71,18,19
54,8,1,7,81,24,25
44,7,1,6,95,27,25
39,6,1,5,103,30,15
41,5,0,5,103,34,15
40,5,0,5,98,37,8
43,5,0,5,95,35,10
49,5,0,5,77,36,8
55,10,1,9,65,37,2
57,15,2,13,57,35,0
60,17,1,16,51,33,3
62,22,1,21,45,32,5
65,21,1,20,38,31,8
64,16,0,16,43,25,7
63,16,0,16,44,22,11
64,14,0,14,41,20,14
65,17,0,17,40,19,14
66,20,0,20,37,17,14
66,18,0,18,34,14,13
68,26,1,25,31,12,14
68,31,2,29,30,5,14
66,35,3,32,33,4,18
58,44,8,36,42,6,23
52,24,4,20,55,14,17
46,17,3,14,81,23,21
41,13,2,11,99,29,26
37,13,2,11,106,32,25
38,14,2,12,117,36,23
45,16,2,14,114,39,22
45,14,1,13,123,43,13
48,13,1,12,122,44,13
54,14,1,13,115,46,12
60,15,0,15,111,42,8
62,28,2,26,107,36,5
63,28,2,26,95,22,12
67,36,2,34,84,13,19
71,22,1,21,74,17,17
74,22,1,21,66,17,16
76,19,1,18,59,13,15
77,22,1,21,55,7,18
77,20,1,19,50,12,18
78,20,1,19,47,21,17
78,24,1,23,46,10,19
78,33,3,30,43,3,21
78,49,11,38,41,1,22
75,72,31,41,41,1,28
63,74,30,44,54,2,30
53,53,16,37,75,6,34
42,42,10,32,97,14,43
34,28,5,23,123,25,34
28,19,2,17,146,34,34
28,15,1,14,138,38,38
26,13,1,12,142,37,28
28,10,0,10,144,42,22
45,10,0,10,134,45,25
53,8,0,8,121,46,20
51,10,0,10,111,47,10
49,16,2,14,99,43,12
51,13,1,12,95,42,13
57,12,1,11,91,40,16
66,8,0,8,93,41,13
70,10,1,9,94,38,17
84,8,0,8,90,38,17
89,7,0,7,88,33,12
92,8,0,8,88,28,16
95,10,0,10,93,31,16
96,7,0,7,101,37,13
95,5,0,5,110,36,8
95,8,0,8,119,28,7
90,5,0,5,121,31,8
88,12,1,11,121,32,2
79,17,2,15,138,29,7
86,34,11,23,103,12,17
76,20,5,15,126,18,4
64,16,4,12,155,22,7
49,14,2,12,177,27,19
52,16,2,14,187,32,21
31,13,1,12,200,38,20
22,8,0,8,192,44,0
25,9,0,9,180,45,0
20,13,0,13,174,46,13
23,9,0,9,166,51,0
40,13,0,13,142,43,3
44,15,0,15,133,38,8
26,16,0,16,126,40,8
25,6,0,6,117,53,3
28,6,0,6,108,50,3
31,5,0,5,97,47,3
28,4,0,4,90,47,4
30,4,0,4,83,46,3
32,5,0,5,79,45,5
33,8,0,8,73,41,7
33,12,0,12,69,29,9
32,16,1,15,65,23,8
23,11,1,10,84,31,12
22,8,1,7,95,39,12
21,7,1,6,113,40,7
23,7,1,6,124,39,8
24,7,1,6,113,40,8
21,7,1,6,129,39,3
20,6,0,6,140,40,7
19,7,1,6,137,41,10
19,6,0,6,139,40,9
22,8,0,8,125,40,9
26,8,0,8,106,37,0
28,10,0,10,93,35,0
32,9,0,9,82,31,0
33,13,0,13,76,26,1
35,12,0,12,72,32,6
39,11,0,11,63,30,1
39,20,1,19,58,27,6
41,27,1,26,56,28,6
44,24,1,23,52,22,7
43,17,1,16,49,26,9
47,26,1,25,44,23,10
49,23,1,22,40,13,12
52,27,3,24,38,9,13
56,41,8,33,37,2,14
49,44,13,31,49,4,16
43,35,10,25,69,11,25
35,42,14,28,98,15,26
34,28,7,21,123,20,28
34,21,4,17,142,24,28
36,14,2,12,152,33,21
35,13,1,12,159,37,23
36,13,1,12,157,39,8
38,17,1,16,151,37,13
34,24,1,23,144,36,5
36,25,0,25,137,32,6
42,28,1,27,130,24,7
48,33,1,32,128,27,10
52,28,1,27,124,26,9
60,22,1,21,122,25,15
63,27,1,26,120,17,15
57,32,2,30,113,11,21
58,36,2,34,106,5,18
65,44,4,40,94,3,25
60,46,4,42,83,6,20
57,30,1,29,75,10,19
57,16,0,16,70,17,18
58,17,1,16,65,18,19
59,21,2,19,66,16,20
55,22,4,18,76,15,23
50,20,4,16,97,17,31
46,26,5,21,147,21,39
60,26,5,21,171,26,43
58,12,2,10,179,33,32
50,8,1,7,190,36,18
44,8,1,7,191,39,21
51,7,1,6,183,43,2
52,8,1,7,180,42,12
62,8,0,8,164,43,8
69,14,1,13,154,38,2
69,18,1,17,150,34,0
66,13,0,13,150,37,2
66,12,0,12,148,32,5
68,11,0,11,147,29,7
72,9,0,9,147,26,10
73,13,0,13,147,29,8
77,9,0,9,147,29,7
74,18.33276734,3.917161984,14.41560536,147,30,4
80,11,0,11,143,28,7
80,11,0,11,147,29,9
81,13,0,13,149,28,6
77,20,1,19,124,7,11
79,37,10,27,112,2,17
77,49,21,28,120,3,16
76,42,15,27,141,4,24
78,18,3,15,183,23.90714308,26
80,18.33598603,3.918267464,14.41771856,181,18,28
79,11,1,10,178,19,20
92,12,2,10,164,23,9
93,12,1,11,167,24,3
93,8,1,7,168,23,5
92,8,1,7,171,21,10
91,8,1,7,172,20,15
93,9,1,8,169,18,18
94,7,0,7,171,17,10
90,12,1,11,183,16,10
81,18,1,17,150,13,14
77,17,1,16,128,22,24
89,6,0,6,106,26,0
90,4,0,4,93,29,0
90,3,0,3,81,33,0
91,3,0,3,78,36,0
91,4,0,4,75,35,1
89,4,0,4,74,32,3
82,4,0,4,72,32,2
81,7,0,7,71,30,2
79,8,0,8,72,29,0
73,9,1,8,75,28,3
69,8,1,7,80,24,1
58,7,1,6,84,24,4
49,7,1,6,104,24,7
45,7,1,6,111,26,15
45,6,1,5,120,28,18
41,5,1,4,119,32,11
41,4,0,4,118,37,6
43,4,0,4,112,40,10
46,5,0,5,95,41,0
51,7,0,7,84,41,1
52,14,2,12,80,39,3
45,7,0,7,72,39,5
45,7,0,7,63,40,6
44,6,0,6,56,40,8
46,7,0,7,48,37,7
48,9,0,9,42,32,10
49,9,0,9,35,34,12
52,6,0,6,29,37,8
53,4,0,4,24,37,7
50,5,0,5,22,36,8
47,7,0,7,26,33,9
48,9,0,9,26,32,12
47,15,1,14,27,26,12
48,13,2,11,34,26,12
47,8,1,7,54,28,17
45,8,1,7,70,32,15
41,5,1,4,76,31,11
45,4,0,4,77,32,16
48,3,0,3,72,36,10
48,4,0,4,74,35,1
45,4,0,4,72,34,6
44,4,0,4,69,37,4
47,4,0,4,66,34,5
48,7,1,6,62,35,5
50,7,0,7,59,35,5
55,7,0,7,57,38,7
60,8,0,8,54,38,5
62,9,0,9,53,36,5
62,8,0,8,54,32,8
71,7,0,7,52,32,5
74,7,0,7,46,29,6
77,7,0,7,43,29,4
74,8,0,8,42,27,8
74,8,0,8,41,28,9
74,10,0,10,42,24,9
73,14,0,14,44,21,10
75,17,1,16,44,19,10
81,19,1,18,44,25,7
92,20,2,18,39,18,12
93,21,3,18,43,18,11
94,22,3,19,48,21,8
95,22,3,19,54,18,8
95,16,2,14,58,17,8
95,23,3,20,63,18,6
95,20,2,18,69,18,8
95,14,1,13,71,12,6
95,26,2,24,72,9,6
95,30,2,28,75,7,7
95,31,1,30,77,5,4
95,38,3,35,77,3,4
95,45,6,39,77,5,5
95,40,4,36,79,4,5
95,45,8,37,82,1,6
95,43,10,33,85,1,4
97,7,0,7,153,16,4
89,4,0,4,109,17,12
94,15,1,14,96,6,6
97,10,0,10,146,10,0
95,6,0,6,165,22,3
94,9,1,8,168,22,10
94,8,0,8,167,21,6
93,8,1,7,168,20,4
92,10,1,9,164,22,5
87,13,1,12,134,12,5
88,35,9,26,130,4,3
82,27,6,21,128,7,0
78,17,2,15,121,18,2
74,15,1,14,116,23,0
74,13,1,12,115,22,0
69,13,1,12,113,23,0
61,15,1,14,112,23,0
62,17,1,16,107,26,1
82,9,1,8,97,27,2
83,10,1,9,90,30,0
79,9,1,8,87,30,0
84,10,1,9,85,29,0
88,6,0,6,81,26,0
81,6,0,6,68,32,0
86,4,0,4,65,34,0
88,3,0,3,57,33,0
85,3,0,3,50,33,0
85,4,0,4,47,37,0
86,4,0,4,46,35,0
83,6,0,6,47,29,0
86,11,1,10,50,26,3
75,12,1,11,59,25,2
55,10,2,8,72,27,4
51,8,1,7,83,32,10
52,8,1,7,87,32,4
47,8,1,7,88,34,8
49,8,1,7,95,35,4
50,7,1,6,106,33,6
45,6,1,5,114,37,13
45,5,0,5,117,38,14
48,5,0,5,107,40,5
53,8,0,8,94,39,0
57,12,0,12,85,34,0
61,13,0,13,78,32,0
61,18,1,17,72,26,2
63,23,1,22,71,20,7
64,20,1,19,68,22,10
65,16,1,15,62,28,10
71,12,0,12,54,29,6
68,7,0,7,52,30,5
66,7,0,7,51,31,8
62,5,0,5,52,31,8
56,5,0,5,51,33,6
62,5,0,5,52,30,9
68,8,0,8,53,22,9
63,10,1,9,59,22,10
61,10,1,9,66,22,13
58,11,2,9,80,22,17
55,9,1,8,97,23,18
54,8,1,7,112,31,22
53,11,1,10,127,31,18
54,10,1,9,133,38,23
56,11,1,10,123,35,14
57,9,1,8,133,36,8
57,6,0,6,127,44,12
61,12,0,12,113,36,7
64,13,1,12,102,35,11
65,14,1,13,94,32,11
67,16,1,15,90,27,13
67,19,1,18,85,27,15
69,21,1,20,80,25,13
63,17,1,16,74,21,14
47,14,0,14,70,33,12
47,18.27037451,3.890447133,14.37992738,64,38,2
49,7,0,7,58,39,0
46,7,0,7,56,40,4
45,7,0,7,55,40,7
43,8,0,8,55,35,8
41,9,0,9,60,34,8
36,9,1,8,73,34,10
31,8,1,7,90,23.93983984,15
24,18.26609904,3.888967097,14.37713194,110,23.93983984,14
17,18.26609904,3.888967097,14.37713194,127,35,13
17,5,0,5,138,35,13
20,4,0,4,143,35,15
20,5,0,5,151,38,21
21,9,1,8,155,42,21
25,16,0,16,151,46,25
28,20,1,19,138,40,1
40,22,0,22,125,39,8
50,28,1,27,119,26,5
58,23,1,22,110,21,9
64,21,0,21,107,28,13
61,29,1,28,100,28,13
60,30,1,29,92,18,13
63,27,1,26,83,15,14
67,25,1,24,80,18,16
69,22,1,21,78,16,15
73,24,1,23,67,12,18
73,26,1,25,57,8,16
67,28,1,27,53,6,17
64,30,2,28,49,7,15
68,41,9,32,49,7,14
60,40,12,28,64,10,19
53,40,13,27,89,14,24
50,32,9,23,118,22,30
48,26,5,21,139,28,31
44,20,3,17,152,34,35
38,28,4,24,159,36,31
43,41,6,35,161,31,25
46,23,2,21,162,44,7
47,22,2,20,160,43,22
46,14,1,13,160,48,14
53,17,0,17,151,45,11
60,22,1,21,145,39,8
63,23,1,22,139,30,8
64,25,1,24,138,30,15
65,30,1,29,134,19,19
64,31,1,30,132,14,22
66,34,1,33,127,18,21
68,37,2,35,117,6,24
66,47,4,43,106,2,27
64,57,8,49,97,3,23
61,53,7,46,92,3,26
59,50,9,41,87,7,27
62,54,17,37,84,5,27
62,51,15,36,83,7,25
59,37,8,29,93,10,28
53,43,12,31,118,14,36
47,46,11,35,153,18,47
40,44,8,36,180,23,54
33,57,11,46,210,31,53
24,31,3,28,208,35,37
27,16,1,15,211,49,28
28,16,1,15,211,52,16
31,19,1,18,208,55,17
39,22,1,21,194,56,18
49,35,1,34,181,48,9
63,31,1,30,167,31,22
67,33,1,32,156,32,25
70,29,1,28,151,31,24
74,33,1,32,146,23,26
74,37,1,36,144,22,27
76,39,2,37,139,16,28
77,38,2,36,133,8,33
81,33,2,31,123,6,34
80,25,1,24,119,9,30
83,23,1,22,111,3,30
83,32,3,29,103,2,32
78,46,11,35,98,2,35
75,57,22,35,101,3,37
66,57,21,36,110,5,39
56,38,10,28,137,11,47
51,43,10,33,167,17,54
44,51,10,41,190,28,54
47,34,5,29,196,34,48
52,19,2,17,197,37,17
55,12,1,11,196,43,31
57,15,2,13,193,41,20
57,12,1,11,189,43,27
60,11,1,10,177,46,7
59,9,0,9,173,43,12
57,11,0,11,171,37,13
59,12,0,12,166,37,16
59,10,0,10,166,37,12
61,10,0,10,164,39,10
61,9,0,9,164,39,12
60,10,0,10,170,40,7
59,8,0,8,173,41,5
59,8,0,8,174,41,3
59,7,0,7,175,41,3
60,5,0,5,176,41,6
60,7,0,7,176,39,3
58,9,0,9,177,39,4
63,17,1,16,173,32,6
63,20,1,19,168,29,4
67,17,1,16,160,31,3
69,26,2,24,159,24,9
69,29,4,25,168,23,27
68,21,3,18,173,27,8
71,21,2,19,171,26,11
84,10,1,9,129,32,9
84,8,1,7,117,34,0
86,8,0,8,111,30,0
85,7,0,7,102,33,0
83,7,0,7,94,36,0
79,10,1,9,89,38,0
77,8,1,7,84,38,0
80,6,0,6,72,38,0
78,6,0,6,68,38,2
75,5,0,5,63,38,0
75,5,0,5,60,39,3
71,5,0,5,60,39,0
53,4,0,4,57,38,2
52,4,0,4,47,39,4
56,4,0,4,39,37,3
57,5,0,5,33,33,4
65,8,0,8,29,29,3
59,12,1,11,29,20,4
52,8,1,7,36,25,10
43,7,1,6,60,29,18
35,6,1,5,84,33,18
35,4,0,4,102,33,16
31,4,0,4,102,35,13
28,4,0,4,108,38,10
28,4,0,4,124,40,8
29,4,0,4,123,42,13
33,5,0,5,123,43,9
37,7,0,7,105,41,6
44,16,2,14,91,39,0
47,8,0,8,80,40,0
50,8,0,8,73,38,0
51,12,0,12,69,33,2
53,14,0,14,66,34,3
55,17,1,16,64,32,5
55,12,0,12,67,28,7
55,10,0,10,69,26,8
55,9,0,9,70,29,7
57,10,0,10,71,29,6
63,10,0,10,69,28,8
65,13,0,13,59,18,8
65,15,0,15,53,23,7
66,12,1,11,54,20,8
60,11,1,10,65,20,12
56,12,2,10,82,25,25
51,12,2,10,108,29,19
50,13,2,11,114,32,23
48,14,1,13,120,34,20
49,19,2,17,133,35,15
53,10,1,9,148,41,18
57,9,1,8,149,43,9
53,8,0,8,151,44,3
53,8,0,8,149,45,3
57,9,0,9,146,44,1
56,11,0,11,144,36,5
52,13,0,13,143,40,6
54,12,0,12,141,42,6
58,9,0,9,139,42,5
57,10,0,10,129,37,6
60,17,0,17,118,29,17
60,18,0,18,112,28,17
59,18.28364546,3.873948397,14.40969706,111,30,17
59,17,0,17,109,27,15
62,20,1,19,104,15,17
62,24,1,23,103,3,20
65,34,4,30,101,1,21
64,54,16,38,104,4,19
59,34,5,29,112,10,24
58,62,21,41,114,4,0
57,42,9,33,115,23.98601784,8
53,18.29181893,3.875458934,14.41636,125,12,25
54,53,15,38,132,13,30
52,52,15,37,155,14,30
51,44,8,36,165,16,35
52,40,5,35,168,15,25
56,23,2,21,173,21,18
57,25,1,24,171,27,5
59,30,1,29,165,26,3
59,41,2,39,158,5,11
61,59,4,55,153,2,18
70,65,8,57,148,2,21
76,44,3,41,137,6,20
83,24,1,23,126,12,17
85,10,0,10,120,17,17
88,9,0,9,111,24,9
87,5,0,5,110,24,10
88,5,0,5,106,33,8
88,4,0,4,102,35,3
87,3,0,3,93,41,4
88,4,0,4,87,42,2
84,5,0,5,83,41,5
84,5,0,5,80,40,4
84,6,0,6,79,37,8
87,9,1,8,79,30,7
86,7,1,6,83,30,7
83,7,1,6,85,29,11
82,7,1,6,85,30,11
79,6,1,5,88,33,10
73,5,0,5,91,36,10
65,5,0,5,93,38,9
65,5,0,5,89,37,8
66,6,0,6,86,40,6
65,10,1,9,83,41,7
63,5,0,5,78,43,6
63,5,0,5,75,43,6
58,5,0,5,73,42,7
56,7,0,7,68,38,7
57,6,0,6,64,39,9
57,5,0,5,62,39,7
58,4,0,4,61,40,7
61,3,0,3,57,37,5
62,4,0,4,52,35,7
62,5,0,5,50,34,7
62,5,0,5,49,34,7
62,6,0,6,49,33,7
70,6,0,6,51,31,7
74,6,0,6,52,29,9
76,7,0,7,54,31,8
82,7,0,7,51,33,8
84,6,0,6,47,34,4
87,5,0,5,35,34,6
92,7,1,6,31,35,2
91,7,1,6,31,34,1
92,8,1,7,30,32,5
93,8,0,8,32,30,7
93,8,0,8,33,31,7
94,11,1,10,35,31,9
94,10,1,9,38,30,7
94,8,0,8,37,29,7
94,7,0,7,39,29,5
95,8,0,8,41,30,5
96,6,0,6,44,30,7
96,6,0,6,46,29,4
96,6,0,6,49,29,2
97,4,0,4,52,29,3
97,4,0,4,56,31,3
97,5,0,5,60,30,3
96,7,0,7,59,22,1
94,13,1,12,66,25,1
93,14,1,13,67,21,5
90,14,2,12,76,23,4
90,19,3,16,83,20,6
85,16,3,13,94,21,7
85,17,2,15,97,20,10
82,27,4,23,103,17,9
74,29,7,22,126,19,10
65,22,5,17,145,23,20
63,17,3,14,149,31,20
65,15,1,14,144,30,6
68,22,1,21,137,26,3
74,32,2,30,125,15,0
78,52,7,45,119,2,1
79,63,16,47,120,2,5
61,57,12,45,122,4,10
55,24,1,23,119,18,3
55,18,1,17,115,25,0
55,9,0,9,110,27,0
56,10,0,10,106,25,1
56,9,0,9,102,27,0
58,9,0,9,100,27,0
60,13,0,13,97,21,0
69,21,1,20,98,16,3
72,14,1,13,101,9,3
70,12,2,10,109,26,6
66,8,1,7,113,28,4
61,8,1,7,121,27,2
54,7,1,6,133,26,5
43,6,1,5,150,28,10
37,6,1,5,156,33,17
39,6,1,5,159,36,17
40,6,0,6,171,37,4
47,6,0,6,150,38,12
57,7,0,7,140,35,0
75,11,0,11,117,35,0
71,13,0,13,113,31,0
73,13,0,13,108,31,0
78,15,1,14,103,29,4
80,15,1,14,101,30,1
77,12,1,11,99,31,2
79,11,0,11,98,34,3
80,12,0,12,97,30,3
81,13,0,13,96,23,2
81,13,0,13,92,23,3
82,14,0,14,91,24,2
84,15,0,15,88,20,4
82,20,1,19,84,17,7
71,22,3,19,83,16,3
65,16,3,13,94,25,8
54,10,2,8,118,29,12
49,7,1,6,135,33,19
47,6,1,5,147,36,16
46,7,1,6,145,39,13
44,8,1,7,151,42,10
45,8,1,7,149,46,0
42,6,0,6,157,48,5
47,8,0,8,150,48,8
53,7,0,7,144,42,6
63,8,1,7,131,42,2
69,10,1,9,124,40,0
73,10,1,9,122,38,0
75,13,1,12,122,33,2
75,13,1,12,120,29,5
76,15,1,14,120,28,6
78,20,1,19,115,32,4
83,19,1,18,104,23,6
80,8,0,8,96,24,5
76,7,0,7,86,30,6
82,7,0,7,79,34,4
83,6,0,6,74,31,5
86,10,0,10,71,26,5
86,11,1,10,72,22,8
78,14,3,11,85,21,14
55,8,1,7,117,27,17
35,6,1,5,146,38,24
22,5,0,5,165,47,24
17,4,0,4,180,48,20
17,4,0,4,188,47,20
21,4,0,4,200,50,27
24,9,0,9,188,55,21
24,12,0,12,185,57,19
28,10,0,10,169,53,14
44,15,0,15,155,52,8
51,22,1,21,146,43,11
59,14,0,14,144,50,9
66,19,0,19,139,52,15
64,20,1,19,132,43,15
65,22,1,21,127,42,19
65,23,1,22,123,35,17
67,25,1,24,119,31,18
71,18.24882489,3.851385589,14.3974393,111,21,19
74,27,1,26,104,17,21
74,26,1,25,99,8,22
70,31,4,27,88,4,21
73,37,4,33,79,2,20
67,44,14,30,78,7,21
59,40,13,27,95,11,26
52,34,10,24,118,24.03723281,30
43,18.25522456,3.852538324,14.40268624,151,26,33
35,23,3,20,166,31,41
32,34,5,29,181,34,42
32,50,9,41,191,26,30
36,38,4,34,191,42,40
35,30,2,28,207,51,29
49,22,1,21,191,59,29
53,20,1,19,181,61,20
56,22,0,22,175,62,32
65,29,1,28,164,51,29
67,29,1,28,158,45,36
69,29,1,28,153,41,37
70,32,1,31,150,35,37
73,34,1,33,145,21,40
75,38,2,36,139,19,47
78,43,3,40,131,5,47
81,35,2,33,123,3,47
84,29,1,28,113,6,50
84,22,1,21,104,4,48
83,33,2,31,100,2,50
81,50,13,37,95,2,47
77,58,23,35,97,3,37
67,55,22,33,115,5,44
57,51,17,34,147,13,51
47,35,7,28,172,19,55
41,18,2,16,194,38,52
39,12,1,11,207,56,48
38,12,1,11,221,63,36
40,11,0,11,221,73,39
42,13,0,13,216,76,37
48,19,0,19,197,78,39
52,22,0,22,183,72,26
60,37,1,36,178,71,42
64,42,1,41,172,57,51
70,38,1,37,167,41,49
70,37,1,36,165,35,50
71,39,1,38,160,30,46
71,32,1,31,157,37,47
68,28,1,27,153,30,41
72,23,1,22,152,25,36
72,24,1,23,150,15,38
73,33,1,32,145,4,42
77,62,6,56,136,2,58
82,60,10,50,127,2,62
83,39,4,35,122,2,69
78,50,14,36,125,3,61
59,29,5,24,138,9,50
47,26,4,22,164,23,46
41,25,3,22,189,37,47
37,17,1,16,210,49,51
32,18.29505788,3.852264485,14.4427934,223,64,40
38,18,1,17,225,74,42
33,17,0,17,229,79,46
34,20,1,19,230,74,38
31,22,1,21,224,69,26
39,23,1,22,211,71,26
59,21,0,21,191,58,22
65,28,1,27,181,51,17
70,23,1,22,175,45,29
71,22,1,21,172,45,33
70,23,1,22,169,42,37
77,24,1,23,160,35,35
79,21,1,20,156,31,36
76,23,1,22,156,30,32
76,23,1,22,153,21,37
77,24,1,23,148,12,38
83,33,2,31,136,3,40
85,35,2,33,130,2,41
82,34,3,31,124,3,42
69,38,8,30,125,5,41
57,42,11,31,141,16,44
44,31,6,25,170,27,45
38,20,2,18,201,41,46
33,17,1,16,219,51,55
37,29,2,27,229,57,42
30,32,2,30,234,51,43
23,21,1,20,236,71,35
25,16,0,16,235,71,26
39,17,0,17,222,71,27
44,22,1,21,207,66,27
54,25,1,24,197,69,18
60,29,1,28,192,63,25
60,36,1,35,189,49,37
61,43,1,42,182,32,34
63,46,2,44,175,21,35
66,42,1,41,170,19,36
64,29,1,28,168,20,39
61,20,1,19,167,39,39
36,13,0,13,162,42,32
31,7,0,7,151,50,20
29,6,0,6,142,48,14
38,8,0,8,131,44,16
35,8,0,8,118,45,17
31,6,0,6,113,41,12
27,5,0,5,117,37,10
20,5,0,5,136,36,17
19,5,0,5,154,37,19
18,4,0,4,155,35,20
17,4,0,4,159,35,16
15,4,0,4,171,36,13
14,4,0,4,185,39,16
12,5,0,5,184,44,8
19,6,0,6,185,46,12
25,6,0,6,162,47,0
33,9,0,9,141,46,1
39,13,1,12,127,46,0
41,13,1,12,122,45,0
44,9,0,9,118,43,5
46,14,0,14,116,41,7
47,13,0,13,115,38,9
48,14,0,14,115,37,12
48,21,1,20,111,34,11
50,21,1,20,104,30,11
46,15,0,15,91,33,11
42,10,0,10,87,33,8
42,10,0,10,82,31,8
43,15,0,15,80,28,9
43,18,1,17,87,21,11
42,15,2,13,101,26,18
36,12,2,10,128,29,25
32,7,1,6,144,36,23
32,8,1,7,157,35,16
35,9,1,8,155,39,16
32,8,0,8,165,43,5
33,9,1,8,172,48,19
33,11,1,10,170,52,5
39,11,1,10,173,54,20
47,9,0,9,159,55,4
53,10,0,10,154,52,6
57,10,0,10,152,50,2
57,12,0,12,151,48,4
60,15,0,15,146,47,8
63,15,0,15,144,45,10
67,9,0,9,146,41,10
61,9,0,9,149,41,8
61,13,0,13,148,47,12
62,11,0,11,145,43,12
64,9,0,9,134,37,13
68,18,0,18,122,24,14
68,20,1,19,116,18,13
67,15,0,15,110,19,14
61,16,1,15,113,18,16
56,20,3,17,129,24,22
51,18,3,15,161,27,32
49,18,2,16,176,37,31
48,12,1,11,188,41,28
46,8,1,7,192,46,9
47,9,1,8,200,49,18
48,8,1,7,198,51,11
52,7,0,7,190,53,19
57,7,0,7,186,52,7
62,8,0,8,175,52,2
65,10,0,10,169,51,8
68,11,0,11,166,47,3
70,9,0,9,164,45,8
71,7,0,7,162,44,10
72,8,0,8,163,44,11
70,8,0,8,164,39,13
72,8,0,8,162,42,16
76,9,0,9,160,37,16
76,18.28091361,3.833575581,14.44733803,157,33,16
78,13,0,13,154,25,13
78,13,0,13,150,18,14
81,19,1,18,144,9,13
81,30,4,26,138,2,14
82,52,20,32,138,3,17
78,54,22,32,149,4,22
67,27,6,21,174,10,27
56,21,4,17,195,18,34
45,15,2,13,217,31,37
38,12,1,11,228,45,34
37,10,0,10,239,54,28
36,9,0,9,242,61,35
38,9,0,9,239,62,29
51,10,0,10,222,24.169958,21
57,11,0,11,199,55,0
69,14,1,13,179,53,19
71,11,1,10,165,54,15
72,7,0,7,160,55,15
75,8,0,8,155,54,20
73,5,0,5,153,54,22
73,4,0,4,152,55,22
72,4,0,4,153,55,23
72,4,0,4,151,56,19
72,5,0,5,150,52,20
72,5,0,5,147,48,20
72,5,0,5,147,50,19
72,6,0,6,147,49,22
73,9,0,9,144,38,20
71,12,0,12,147,30,23
69,13,1,12,151,35,24
63,14,1,13,169,35,31
58,18.27319282,3.830455547,14.44273727,190,38,39
52,12,1,11,204,44,49
51,21,2,19,215,41,12.45759755
48,25,2,23,219,41,63
50,17,1,16,223,57,36
56,16,1,15,217,59,43
56,12,1,11,228,53,35
67,12,1,11,206,54,33
73,14,1,13,198,51,20
77,14,1,13,191,42,18
79,14,0,14,187,40,27
79,17,1,16,185,36,31
79,18,1,17,182,30,36
80,23,1,22,178,26,35
79,26,1,25,174,20,35
78,22,1,21,170,20,41
82,22,1,21,166,14,43
84,25,1,24,164,4,37
86,30,2,28,158,2,36
88,26,1,25,154,3,33
89,25,3,22,153,3,35
87,38,15,23,159,5,37
81,39,12,27,170,9,46
63,31,8,23,196,14,57
48,39,7,32,218,26,62
48,39,5,34,234,39,48
44,41,4,37,238,57,52
52,22,1,21,235,68,47
47,15,1,14,236,54,39
47,15,1,14,237,52,36
49,16,1,15,238,48,33
51,19,1,18,229,40,22
50,25,1,24,228,38,26
49,30,1,29,228,36,26
52,29,1,28,222,32,34
56,31,1,30,216,25,40
74,9,1,8,164,40,29
72,5,0,5,152,43,6
72,4,0,4,146,41,6
72,3,0,3,144,41,7
72,3,0,3,142,39,8
67,3,0,3,138,39,5
64,4,0,4,141,37,4
63,5,0,5,141,37,5
65,7,0,7,137,36,4
62,8,0,8,137,35,3
48,6,0,6,131,36,3
49,6,0,6,133,33,0
49,7,1,6,140,32,1
48,9,1,8,144,33,5
46,8,1,7,145,37,10
45,5,0,5,150,41,14
48,5,0,5,146,43,13
53,5,0,5,137,44,8
56,5,0,5,136,43,2
60,5,0,5,131,43,3
62,5,0,5,131,43,6
64,11,1,10,132,41,8
67,8,0,8,132,41,10
84,7,0,7,121,41,12
88,7,0,7,121,37,8
89,7,0,7,121,33,6
90,7,0,7,115,28,9
90,6,0,6,117,22,8
90,6,0,6,116,22,11
91,8,0,8,113,27,6
91,9,0,9,112,27,6
91,7,0,7,113,23,6
92,9,0,9,117,14,9
92,21,3,18,124,7,14
85,19,4,15,178,17,15
71,11,2,9,201,22,30
63,9,2,7,211,26,37
67,8,1,7,205,29,33
59,9,1,8,211,30,25
58,7,1,6,211,32,23
55,7,1,6,211,34,26
60,7,1,6,209,31,9
67,5,0,5,203,31,10
77,6,0,6,196,30,15
90,6,0,6,182,28,9
83,5,0,5,187,28,2
82,4,0,4,189,29,14
79,3,0,3,193,29,16
79,4,0,4,197,30,19
79,3,0,3,201,30,18
86,2,0,2,195,30,21
87,2,0,2,195,28,14
85,2,0,2,197,27,13
82,2,0,2,195,27,13
74,5,0,5,188,23,11
73,7,0,7,172,23,10
76,12,1,11,166,18,2
77,16,2,14,166,12,2
76,18,4,14,176,13,5
60,19,5,14,199,19,18
52,16,3,13,207,25,19
30,13,1,12,203,36,10
56,18,2,16,193,26,0
33,13,1,12,190,35,21
35,11,0,11,176,46,7
37,11,0,11,171,48,10
34,10,0,10,170,50,12
34,9,0,9,171,50,14
56,9,0,9,146,41,15
65,8,0,8,114,34,5
60,6,0,6,115,35,0
62,5,0,5,113,35,0
66,8,1,7,109,34,5
66,6,0,6,106,36,4
52,6,0,6,107,34,3
45,6,0,6,104,39,7
42,7,0,7,99,41,9
42,8,0,8,95,40,11
48,9,0,9,93,37,13
46,11,0,11,89,32,15
49,14,1,13,90,27,13
41,14,2,12,96,22,16
37,10,1,9,108,28,23
33,8,1,7,132,30,25
26,7,1,6,144,32,24
21,4,0,4,153,34,17
23,4,0,4,155,35,5
19,4,0,4,158,33,4
16,4,0,4,161,37,7
15,4,0,4,159,41,11
16,4,0,4,158,45,12
15,4,0,4,153,46,4
17,4,0,4,146,48,1
40,12,1,11,138,47,2
44,9,0,9,128,52,8
46,11,0,11,124,51,7
51,10,0,10,116,46,12
56,9,0,9,109,42,11
58,8,0,8,106,43,11
60,8,0,8,103,40,10
59,18.22368788,3.808713803,14.41497407,96,33,11
55,9,0,9,80,25,10
53,9,0,9,76,23,11
51,13,0,13,72,18,9
51,18,1,17,74,13,9
46,34,7,27,88,11,11
42,25,5,20,113,16,20
38,22,4,18,137,25,25
27,16,2,14,159,31,22
25,11,1,10,170,35,17
28,18.22329216,3.80790816,14.41538401,184,37,15
30,10,1,9,193,38,19
28,9,1,8,197,24.26891184,22
28,10,1,9,200,44,16
32,12,1,11,188,49,21
31,13,1,12,187,51,0
25,11,0,11,178,51,15
31,8,0,8,162,52,0
33,9,0,9,153,49,0
32,12,0,12,146,47,4
35,16,0,16,136,39,6
35,11,0,11,131,45,6
37,8,0,8,124,47,11
38,8,0,8,118,46,14
41,9,0,9,113,41,14
41,11,0,11,109,39,17
45,13,0,13,104,35,14
46,17,1,16,99,27,17
48,22,1,21,98,17,14
43,32,6,26,104,9,16
34,12,1,11,123,30,24
30,9,1,8,146,38,23
25,5,0,5,160,39,22
25,5,0,5,166,37,27
31,9,1,8,177,40,31
36,9,0,9,177,43,9
37,7,0,7,180,47,21
38,9,1,8,173,51,9
40,8,0,8,166,50,19
43,7,0,7,159,48,8
49,7,0,7,153,50,6
51,11,1,10,150,49,0
52,10,0,10,145,42,4
55,15,1,14,145,40,10
59,19,1,18,143,35,6
63,18,1,17,135,30,14
68,18,1,17,132,25,13
67,19,1,18,138,33,12
70,13,0,13,140,39,14
65,10,0,10,141,44,13
60,11,0,11,145,52,15
56,9,0,9,148,50,14
62,16,0,16,150,49,17
66,21,1,20,157,43,20
72,18,1,17,160,38,26
57,20,2,18,184,34,26
50,15,1,14,187,49,31
62,12,1,11,186,50,27
63,10,1,9,187,37,20
55,7,1,6,203,34,13
52,6,1,5,205,32,16
54,7,1,6,207,35,21
46,9,1,8,207,35,1
50,9,1,8,199,37,18
55,8,0,8,193,37,1
57,8,0,8,190,36,6
64,9,0,9,184,35,5
66,7,0,7,186,31,8
70,6,0,6,184,34,11
72,5,0,5,181,34,10
72,4,0,4,182,35,12
75,4,0,4,181,35,12
75,5,0,5,183,31,13
74,9,0,9,165,31,14
77,10,0,10,162,26,16
78,15,0,15,158,17,19
78,19,1,18,155,10,14
76,26,5,21,159,8,14
75,30,7,23,168,7,19
71,24,5,19,179,11,21
64,22,4,18,196,16,26
54,22,4,18,217,25,35
50,20,3,17,227,32,24
44,16,1,15,239,39,21
40,22,2,20,249,42,26
41,15,1,14,242,43,24
38,19,1,18,243,52,20
41,31,2,29,237,42,18
43,10,1,9,189,45,13
42,9,1,8,178,47,0
43,8,0,8,172,46,2
46,9,0,9,167,42,5
50,12,1,11,163,41,7
53,14,0,14,159,33,9
49,13,0,13,156,31,10
34,12,0,12,154,39,8
32,17,1,16,149,41,7
29,9,0,9,143,41,9
30,6,0,6,138,45,7
33,7,0,7,133,47,6
29,7,0,7,125,43,6
21,7,0,7,131,36,7
17,6,0,6,142,37,14
15,5,0,5,156,39,16
14,4,0,4,169,40,16
14,4,0,4,179,38,25
14,4,0,4,187,39,26
14,4,0,4,196,40,22
15,4,0,4,197,41,17
16,4,0,4,194,44,20
16,5,0,5,195,45,12
18,5,0,5,185,44,1
20,6,0,6,178,45,3
34,11,1,10,157,44,1
38,11,1,10,145,43,3
40,11,1,10,139,42,0
47,8,0,8,134,42,2
50,7,0,7,131,41,3
51,7,0,7,125,38,4
51,8,0,8,120,36,2
52,8,0,8,117,35,3
53,7,0,7,113,37,8
54,7,0,7,112,37,5
52,7,0,7,114,36,4
55,13,0,13,115,33,5
58,13,1,12,114,24,9
55,13,1,12,114,14,14
53,13,1,12,122,15,12
54,13,2,11,141,22,12
53,14,2,12,157,25,21
52,17,2,15,169,37,24
52,13,1,12,176,43,10
56,10,1,9,180,48,6
58,7,0,7,180,47,7
65,8,0,8,173,45,9
75,8,0,8,167,45,9
77,11,0,11,166,45,7
85,13,0,13,161,41,4
83,8,0,8,168,38,10
76,8,0,8,171,39,13
65,9,0,9,173,46,12
66,10,0,10,173,48,15
67,9,0,9,173,51,9
70,10,0,10,171,52,12
61,6,0,6,171,55,13
89,3,0,3,152,53,9
93,3,0,3,170,48,6
93,2,0,2,178,39,8
88,2,0,2,189,36,13
90,2,0,2,188,31,11
93,2,0,2,190,27,10
88,2,0,2,198,22,6
79,5,1,4,155,21,10
80,10,1,9,163,22,12
68,9,1,8,183,25,11
68,5,0,5,180,33,19
70,7,0,7,179,36,15
71,10,1,9,180,33,2
71,9,1,8,182,32,13
74,8,0,8,184,32,11
77,8,1,7,181,30,0
71,9,1,8,174,32,7
56,6,0,6,172,34,2
32,5,0,5,162,41,0
37,6,0,6,149,43,0
39,5,0,5,142,43,0
40,4,0,4,139,46,0
41,3,0,3,133,46,0
42,18.15394163,3.779842527,14.37409911,127,45,1
44,3,0,3,123,44,4
46,4,0,4,118,40,3
47,6,0,6,116,39,4
49,8,0,8,114,35,4
47,11,1,10,118,30,7
44,9,1,8,132,26,14
38,7,1,6,150,24.39119697,20
32,18.14952117,3.778531168,14.37099001,162,27,22
28,6,1,5,173,27,24
28,5,0,5,176,31,31
28,5,0,5,179,36,19
28,5,0,5,184,40,9
28,6,0,6,185,47,12
28,6,0,6,186,48,21
44,6,0,6,166,44,12
47,9,1,8,156,43,15
51,9,1,8,146,41,9
53,8,0,8,140,38,5
57,12,1,11,136,36,12
59,9,0,9,134,39,10
64,6,0,6,132,41,6
63,6,0,6,132,43,3
63,5,0,5,131,43,3
66,5,0,5,128,41,2
70,5,0,5,127,39,3
70,5,0,5,127,36,4
71,6,0,6,125,36,4
71,11,0,11,123,28,3
67,14,1,13,124,26,4
65,13,1,12,129,25,8
64,13,2,11,135,28,11
64,10,1,9,139,27,11
60,9,1,8,155,25,10
61,9,1,8,155,28,13
62,10,1,9,154,27,7
65,15,1,14,147,28,6
67,14,1,13,144,27,6
83,11,1,10,139,26,9
89,9,0,9,132,32,8
91,12,0,12,130,27,6
90,18,1,17,123,16,6
90,15,0,15,124,19,10
90,18,1,17,122,17,11
91,22,1,21,123,12,13
91,21,1,20,124,12,13
92,19,1,18,123,14,12
92,18,1,17,126,10,14
92,13,0,13,127,11,15
93,12,0,12,128,12,16
92,8,0,8,126,23,13
92,5,0,5,125,32,14
92,6,0,6,123,38,14
92,10,0,10,125,32,14
93,9,0,9,125,32,14
93,9,0,9,127,31,11
91,6,0,6,125,31,9
92,4,0,4,125,38,9
91,8,1,7,125,39,9
87,7,1,6,139,34,5
81,7,1,6,145,35,15
71,7,1,6,157,34,13
66,6,0,6,164,37,14
65,8,1,7,163,40,13
75,9,1,8,150,37,10
79,16,2,14,143,38,0
79,12,0,12,137,35,0
80,20,1,19,132,31,1
83,23,1,22,127,29,4
84,28,2,26,126,30,4
85,19,1,18,124,22,6
85,18,1,17,124,22,9
85,16,1,15,122,23,8
87,18,1,17,120,4,11
87,26,10,16,116,1,12
88,33,16,17,112,1,10
88,32,17,15,112,2,13
84,47,24,23,126,2,15
82,43,14,29,136,4,23
77,39,13,26,152,8,19
63,39,12,27,177,15,24
56,44,9,35,195,22,35
52,18,2,16,203,32,23
48,11,1,10,209,39,10
46,9,1,8,213,43,11
47,9,1,8,206,46,11
50,10,1,9,205,49,6
59,11,1,10,192,48,2
66,10,0,10,182,49,0
69,11,1,10,178,50,3
71,9,0,9,175,50,4
72,12,0,12,170,46,6
72,13,0,13,167,43,10
74,13,0,13,163,45,15
72,10,0,10,160,44,16
75,13,0,13,158,40,13
74,11,0,11,157,38,18
72,12,0,12,152,28,18
74,17,0,17,146,13,17
77,37,2,35,140,3,16
85,52,13,39,136,3,14
83,31,7,24,145,9,16
74,20,4,16,166,16,21
65,16,3,13,188,26,31
44,10,1,9,208,27,29
41,9,1,8,223,42,26
32,8,0,8,234,49,19
25,8,0,8,245,57,25
22,7,0,7,250,59,28
23,7,0,7,256,64,31
20,8,0,8,255,64,25
35,12,0,12,240,64,23
38,17,0,17,220,63,18
43,14,0,14,196,63,0
42,11,0,11,185,61,8
46,13,0,13,178,61,18
50,17,0,17,172,56,15
51,19,1,18,168,50,16
50,20,1,19,167,49,22
55,22,1,21,163,44,24
56,24,1,23,159,18,23
61,26,1,25,155,7,23
64,26,1,25,151,3,22
65,28,3,25,147,4,22
62,26,4,22,149,10,24
61,35,8,27,158,14,28
58,40,7,33,176,19,40
52,37,5,32,206,30,48
51,27,3,24,216,41,41
52,13,1,12,227,44,23
50,12,1,11,228,50,22
51,11,1,10,231,52,24
47,10,1,9,236,54,25
43,11,1,10,238,58,25
48,12,1,11,229,61,25
51,14,1,13,221,63,24
52,19,1,18,211,66,18
56,21,1,20,202,64,4
57,20,1,19,196,60,21
59,23,1,22,191,54,12
59,16,0,16,188,51,26
63,14,0,14,184,50,23
67,15,0,15,178,39,24
71,15,0,15,175,43,23
75,14,0,14,172,32,24
76,14,0,14,168,23,27
76,14,1,13,166,16,28
77,15,1,14,161,12,28
77,21,2,19,167,13,30
72,27,4,23,175,13,34
67,38,8,30,187,14,46
54,19,2,17,213,34,48
47,14,1,13,237,48,37
39,12,0,12,254,59,42
30,10,0,10,270,72,44
32,11,0,11,280,79,32
32,9,0,9,282,89,26
37,16,0,16,271,95,33
43,16,1,15,258,80,36
50,17,1,16,237,67,36
54,15,1,14,225,63,29
63,26,1,25,209,52,19
63,22,1,21,205,45,21
60,22,1,21,202,52,33
60,20,1,19,197,49,22
62,20,1,19,193,48,26
68,16,1,15,185,37,27
82,9,0,9,172,43,28
84,18.12709479,3.759982414,14.36711237,163,58,28
80,3,0,3,163,72,28
79,3,0,3,161,71,29
78,2,0,2,159,71,30
79,4,0,4,159,68,32
76,5,0,5,161,63,33
73,4,0,4,166,61,34
71,4,0,4,168,57,39
70,4,0,4,172,24.5131042,12.5388251
65,5,0,5,174,52,13
60,18.11994357,3.758108565,14.361835,186,51,34
60,4,0,4,185,55,33
61,5,0,5,184,56,26
62,4,0,4,177,57,22
64,6,0,6,173,56,16
69,5,0,5,166,54,20
72,7,0,7,161,54,15
76,6,0,6,154,56,14
78,5,0,5,152,54,12
80,4,0,4,152,55,13
81,3,0,3,150,54,9
83,3,0,3,149,52,11
84,2,0,2,149,52,14
85,2,0,2,149,49,17
86,3,0,3,149,46,19
86,3,0,3,150,42,22
86,4,0,4,151,37,21
86,5,0,5,151,37,25
84,8,0,8,150,36,20
86,9,0,9,152,32,21
84,11,1,10,160,26,22
77,16,3,13,183,22,29
69,19,3,16,198,28,38
60,14,2,12,212,29,42
63,9,1,8,212,32,13
65,8,1,7,209,34,9
65,9,1,8,210,34,4
75,12,1,11,197,35,16
71,15,1,14,199,27,0
76,15,1,14,193,32,11
76,16,1,15,192,31,8
65,19,1,18,196,29,8
68,20,1,19,191,33,11
86,14,1,13,178,27,10
85,10,0,10,181,28,9
89,6,0,6,179,30,8
90,9,0,9,179,31,9
90,6,0,6,185,31,7
90,3,0,3,185,32,11
90,3,0,3,184,32,8
88,3,0,3,188,33,9
91,5,0,5,185,30,13
91,5,0,5,187,29,10
92,7,0,7,188,30,12
91,12,1,11,190,30,11
92,14,1,13,189,29,12
93,11,1,10,190,25,11
93,12,1,11,195,26,6
93,10,2,8,189,21,5
90,37,14,23,183,9,7
85,24,6,18,193,15,15
78,17,3,14,206,21,7
72,15,2,13,218,31,25
71,13,1,12,222,38,20
79,37,3,34,211,23,11
80,26,1,25,204,23,3
82,19,1,18,197,34,1
85,14,1,13,188,28,10
85,6,0,6,173,30,4
86,6,0,6,165,32,0
87,6,0,6,160,30,1
88,3,0,3,158,33,1
87,3,0,3,157,31,1
87,3,0,3,156,30,1
86,4,0,4,158,26,1
60,7,0,7,152,24,3
56,10,1,9,148,33,1
45,10,1,9,161,28,0
40,7,1,6,174,33,10
36,6,1,5,188,38,6
32,4,0,4,201,38,1
30,4,0,4,212,36,6
26,4,0,4,224,37,4
23,4,0,4,231,40,14
20,4,0,4,240,41,5
20,4,0,4,245,45,13
19,4,0,4,239,49,16
49,6,0,6,211,42,6
59,17,1,16,196,40,0
57,18,1,17,188,45,0
64,15,0,15,182,42,5
62,16,0,16,178,39,5
66,11,0,11,177,38,2
66,15,0,15,176,26,7
69,16,0,16,175,29,8
70,18,0,18,175,26,8
72,21,0,21,173,22,12
74,18,0,18,169,25,9
78,25,1,24,165,18,6
80,25,1,24,165,10,12
80,22,1,21,165,8,10
74,32,6,26,180,10,12
59,20,3,17,198,19,26
44,20,3,17,209,27,25
45,11,1,10,218,32,10
48,10,1,9,213,35,12
47,10,1,9,215,39,8
50,9,1,8,214,41,5
50,8,1,7,217,42,13
53,8,0,8,211,42,8
56,12,1,11,211,38,2
59,12,1,11,209,34,11
65,9,0,9,204,36,1
69,14,0,14,196,32,10
68,16,0,16,191,37,0
68,20,1,19,189,37,12
70,26,1,25,188,28,17
70,26,1,25,186,18,14
64,24,1,23,181,22,10
64,16,0,16,178,28,12
57,12,0,12,171,34,12
58,9,0,9,163,35,9
54,9,0,9,156,32,8
48,9,0,9,154,36,10
46,11,0,11,159,37,12
43,15,1,14,176,46,19
39,10,1,9,191,41,33
31,6,0,6,213,47,33
28,5,0,5,223,46,12
26,4,0,4,229,42,22
22,5,0,5,235,45,17
21,5,0,5,245,47,20
20,5,0,5,248,54,20
28,8,0,8,245,64,15
34,11,0,11,234,61,12
36,11,0,11,225,58,14
42,14,0,14,217,59,8
54,12,0,12,199,61,2
59,13,0,13,193,64,22
62,12,0,12,188,64,20
65,13,0,13,186,64,14
67,15,0,15,186,63,19
72,8,0,8,184,61,17
77,6,0,6,186,58,17
69,8,0,8,184,51,19
66,13,0,13,182,57,20
67,11,0,11,171,47,21
69,14,0,14,164,35,20
71,18,1,17,162,26,15
71,17,2,15,166,24,22
66,16,2,14,184,26,27
53,18,2,16,206,40,43
43,17,1,16,220,54,38
40,10,1,9,237,55,30
43,6,0,6,241,50,21
46,5,0,5,237,49,16
49,4,0,4,237,49,15
48,3,0,3,241,47,15
55,3,0,3,232,48,15
62,4,0,4,222,49,15
68,6,0,6,217,54,3
72,10,0,10,210,54,8
74,5,0,5,205,53,10
62,8,0,8,203,51,11
63,6,0,6,203,52,19
60,9,0,9,203,52,19
57,12,0,12,201,55,17
62,10,0,10,198,54,16
65,18.0575935,3.731209348,14.32638415,196,51,17
70,9,0,9,190,49,16
73,7,0,7,187,42,18
74,6,0,6,185,45,18
72,8,0,8,189,42,18
64,11,1,10,205,37,24
57,11,1,10,217,35,33
51,9,1,8,229,39,34
50,6,1,5,234,39,14
46,7,1,6,239,37,22
51,6,1,5,233,39,20
47,8,1,7,244,37,12
47,5,0,5,243,38,12
50,5,0,5,235,42,17
43,6,0,6,232,43,7
59,5,0,5,220,44,4
65,7,0,7,213,42,9
66,9,0,9,211,43,5
67,11,0,11,208,41,17
69,12,0,12,206,40,16
66,18,0,18,204,37,15
65,16,0,16,200,36,18
70,12,0,12,197,33,16
72,12,0,12,193,28,18
74,10,0,10,188,25,20
81,8,0,8,184,17,20
83,6,0,6,179,19,7
85,8,0,8,175,12,14
85,17,2,15,177,7,11
76,19,4,15,191,11,16
55,12,2,10,210,17,26
43,10,1,9,233,26,35
33,8,1,7,253,24.65218015,24
29,18.04258841,3.72559846,14.31698995,263,39,27
26,4,0,4,272,51,28
25,5,0,5,283,59,18
25,6,0,6,288,68,18
26,8,0,8,294,77,26
32,13,0,13,270,80,21
40,15,0,15,251,72,25
45,16,0,16,242,56,26
47,22,0,22,234,49,14
50,31,1,30,224,36,10
62,17,0,17,214,38,24
70,20,1,19,209,42,13
73,16,0,16,207,49,24
71,16,0,16,204,43,21
74,11,0,11,200,46,23
75,14,0,14,199,40,20
73,16,0,16,188,26,27
72,11,0,11,184,23,21
76,9,0,9,182,26,23
77,13,1,12,183,25,21
67,17,2,15,198,21,25
65,15,2,13,214,27,47
59,17,2,15,230,35,39
55,20,1,19,234,43,40
52,14,1,13,238,48,21
58,17,1,16,237,50,26
57,16,1,15,240,50,21
43,13,1,12,246,55,27
45,9,0,9,243,51,24
49,9,0,9,236,54,23
68,8,0,8,224,55,14
73,10,0,10,212,56,14
80,11,0,11,202,44,21
76,8,0,8,189,45,18
80,11,0,11,192,39,14
80,11,0,11,192,37,14
90,13,0,13,183,35,18
92,8,0,8,186,30,16
93,6,0,6,199,24,12
90,5,0,5,207,23,8
90,2,0,2,209,22,9
88,2,0,2,209,22,8
91,3,0,3,207,22,2
92,5,0,5,206,20,9
92,4,0,4,207,20,6
90,3,0,3,212,19,9
88,4,1,3,220,19,12
79,4,1,3,242,15,19
75,4,1,3,242,18,34
69,5,1,4,234,28,20
60,6,1,5,254,33,9
57,7,1,6,256,34,24
64,7,1,6,240,40,27
67,7,1,6,229,50,13
64,6,0,6,225,51,2
60,6,0,6,219,52,29
61,7,0,7,216,55,9
55,6,0,6,220,47,23
68,7,0,7,187,40,26
67,6,0,6,184,34,0
69,7,0,7,181,34,3
66,4,0,4,170,42,2
65,3,0,3,162,45,0
67,2,0,2,156,45,0
69,2,0,2,153,47,3
71,2,0,2,152,46,2
65,2,0,2,149,47,4
68,3,0,3,146,47,5
65,4,0,4,160,39,5
49,7,1,6,184,32,12
25,4,0,4,205,44,29
48,4,0,4,198,43,21
40,5,0,5,209,41,1
26,6,0,6,214,42,20
29,6,0,6,219,43,5
28,6,0,6,220,45,15
28,6,0,6,217,50,13
31,6,0,6,215,51,9
34,6,0,6,204,53,9
54,5,0,5,175,52,0
60,4,0,4,168,50,4
59,5,0,5,160,48,2
53,4,0,4,156,50,0
56,4,0,4,153,49,5
56,4,0,4,149,49,10
64,4,0,4,144,40,12
65,7,0,7,141,37,11
66,7,0,7,138,40,11
67,7,0,7,136,32,11
69,8,0,8,133,28,12
67,7,0,7,134,28,12
71,9,0,9,132,25,12
65,12,2,10,145,21,19
58,14,2,12,166,23,22
46,17,2,15,190,31,30
40,18,2,16,201,36,36
33,17,2,15,215,39,25
30,10,1,9,220,47,15
23,6,0,6,224,51,12
27,6,0,6,227,55,13
31,7,0,7,234,59,18
33,7,0,7,225,61,18
35,7,0,7,220,61,15
36,7,0,7,214,64,8
43,7,0,7,205,65,2
46,8,0,8,200,60,14
55,9,0,9,195,58,9
57,11,0,11,192,52,15
60,11,0,11,190,51,13
63,9,0,9,188,51,17
63,11,0,11,188,42,15
59,15,0,15,184,33,19
60,17,0,17,179,29,17
66,14,0,14,171,23,18
68,16,1,15,163,18,16
64,18,2,16,164,18,17
58,19,3,16,172,20,25
55,20,3,17,196,27,31
46,18,2,16,215,34,38
40,18,2,16,232,42,27
35,19,1,18,243,49,27
36,13,1,12,243,61,29
38,11,0,11,242,60,22
41,7,0,7,244,60,17
46,5,0,5,247,56,12
54,6,1,5,236,54,14
52,6,0,6,229,51,17
53,7,0,7,223,49,7
50,7,0,7,220,51,29
50,7,0,7,215,57,12
51,6,0,6,216,57,26
56,7,0,7,214,58,19
71,6,0,6,201,54,25
72,4,0,4,200,50,15
75,3,0,3,195,50,20
52,17.9777145,3.701163856,14.27655064,207,49,19
55,3,0,3,194,54,16
61,5,0,5,192,53,9
60,5,0,5,187,54,3
62,7,0,7,186,52,2
59,11,1,10,194,45,4
56,10,1,9,207,41,10
55,13,1,12,210,24.79394779,21
54,13,1,12,215,38,0
57,17.97353804,3.699771592,14.27376645,220,34,10
64,12,1,11,212,35,6
72,9,1,8,204,41,6
77,8,0,8,202,43,2
86,11,0,11,196,45,5
88,11,0,11,196,39,9
88,6,0,6,166,48,11
90,5,0,5,160,57,0
90,4,0,4,150,58,4
90,4,0,4,152,58,4
89,3,0,3,151,55,4
89,3,0,3,150,55,10
90,2,0,2,145,53,7
90,2,0,2,142,53,7
89,2,0,2,141,52,3
85,2,0,2,136,50,3
88,2,0,2,135,44,0
86,2,0,2,133,38,2
85,2,0,2,131,38,0
87,4,0,4,128,30,1
85,5,0,5,130,26,1
81,5,0,5,131,30,1
80,5,0,5,133,27,4
81,6,0,6,133,26,4
76,6,0,6,137,29,6
73,5,0,5,141,33,7
72,4,0,4,144,37,10
70,4,0,4,146,36,10
70,4,0,4,149,37,9
67,4,0,4,148,39,10
68,4,0,4,146,41,5
79,4,0,4,138,42,5
85,8,1,7,131,41,3
86,9,1,8,128,39,3
88,6,0,6,127,38,7
89,5,0,5,126,36,7
88,2,0,2,122,40,8
90,2,0,2,121,42,8
91,2,0,2,120,39,7
91,2,0,2,118,39,6
91,2,0,2,117,40,3
91,2,0,2,112,38,2
92,2,0,2,111,36,0
92,5,0,5,107,30,0
92,7,0,7,105,30,2
93,8,1,7,106,30,1
92,8,1,7,111,29,2
93,9,1,8,112,28,4
92,8,1,7,115,29,2
90,7,1,6,122,29,0
87,6,1,5,126,30,6
81,3,0,3,133,30,4
72,3,0,3,139,34,9
69,3,0,3,143,38,10
68,4,0,4,142,39,3
67,4,0,4,139,41,2
67,7,0,7,137,42,0
70,8,0,8,137,36,1
73,9,0,9,135,29,1
73,8,0,8,132,28,2
74,6,0,6,128,29,2
74,7,0,7,126,27,2
74,7,0,7,124,28,3
75,7,0,7,122,26,2
75,6,0,6,120,28,4
76,8,0,8,118,24,4
78,9,0,9,118,21,5
73,13,1,12,120,19,6
75,11,1,10,124,27,4
83,10,1,9,120,20,7
87,12,1,11,115,19,2
88,14,1,13,113,29,2
89,13,1,12,117,29,3
90,12,1,11,115,30,5
86,9,1,8,121,30,4
79,8,1,7,129,31,6
69,8,1,7,146,32,13
63,8,1,7,155,37,19
63,7,1,6,155,39,16
62,12,2,10,154,41,5
65,15,1,14,147,33,0
67,26,1,25,142,24,0
66,35,2,33,141,20,4
58,36,3,33,137,18,5
53,33,2,31,131,25,5
55,29,2,27,125,30,5
59,20,1,19,117,25,5
61,14,0,14,112,23,4
65,10,0,10,107,23,2
68,11,0,11,102,23,2
71,12,0,12,98,16,4
71,18,2,16,101,12,10
63,24,6,18,117,7,12
53,23,7,16,141,10,16
45,31,10,21,164,17,22
45,29,6,23,185,30,24
44,30,3,27,196,34,23
43,11,1,10,203,39,9
45,9,1,8,209,47,16
47,8,1,7,208,50,5
48,6,0,6,205,52,4
47,5,0,5,208,50,9
53,7,0,7,198,53,2
62,8,0,8,193,50,4
66,9,0,9,187,46,5
61,12,0,12,184,50,6
70,10,0,10,178,52,8
69,13,0,13,177,42,11
64,17,0,17,174,37,13
64,12,0,12,169,34,17
67,14,0,14,166,33,15
71,16,0,16,161,17,14
73,19,1,18,156,11,15
70,15,1,14,156,11,12
76,26,2,24,149,6,15
81,40,10,30,148,4,14
77,26,5,21,163,9,20
62,29,6,23,186,17,30
56,26,4,22,206,26,30
46,16,2,14,219,43,21
45,23,2,21,225,46,23
46,16,1,15,223,58,18
44,14,1,13,225,71,18
50,15,1,14,221,67,20
42,15,1,14,233,65,15
44,12,0,12,229,69,23
49,16,1,15,217,65,21
57,19,1,18,213,61,0
65,23,1,22,201,53,15
73,17,0,17,194,49,8
74,12,0,12,190,45,15
75,12,0,12,186,44,14
72,12,0,12,186,41,13
72,6,0,6,183,45,12
73,7,0,7,180,39,10
74,8,0,8,178,39,12
73,6,0,6,177,46,6
72,5,0,5,176,46,9
70,4,0,4,178,50,11
70,5,0,5,182,47,9
67,6,0,6,188,42,13
61,10,1,9,195,43,14
58,11,1,10,204,43,12
57,10,1,9,212,43,9
58,4,0,4,217,42,25
63,6,0,6,211,42,3
66,11,1,10,211,38,10
75,5,0,5,205,40,10
88,7,0,7,194,38,1
89,12,1,11,190,32,10
91,14,1,13,188,31,0
90,12,0,12,178,35,7
91,9,0,9,163,48,9
93,7,0,7,153,51,7
94,5,0,5,152,53,1
93,5,0,5,153,49,5
93,5,0,5,153,47,11
91,8,0,8,155,43,12
92,10,0,10,156,40,13
92,17.90886823,3.674677865,14.23419036,157,34,17
92,9,0,9,159,29,17
92,9,0,9,160,28,17
91,11,0,11,161,23,17
91,19,1,18,163,20,17
88,23,2,21,166,26,14
87,22,3,19,174,26,16
76,11,2,9,191,26,18
71,11,2,9,207,28,34
63,10,1,9,230,24.89942257,30
45,8,1,7,252,35,18
41,5,0,5,267,45,12
31,5,0,5,278,48,10
26,17.90499521,3.672949106,14.23204611,279,46,3
29,4,0,4,278,49,3
22,4,0,4,272,50,6
31,4,0,4,255,50,7
33,6,0,6,238,50,4
36,9,0,9,229,48,0
41,14,0,14,218,44,6
46,22,1,21,209,32,7
55,23,1,22,206,34,21
49,21,1,20,207,26,9
49,26,1,25,198,16,17
47,26,0,26,191,27,16
52,19,0,19,185,24,8
54,19,0,19,179,10,14
58,22,2,20,174,4,15
59,32,6,26,173,5,14
57,40,9,31,189,4,17
49,46,12,34,215,8,36
39,52,13,39,242,19,28
35,24,3,21,259,30,21
38,29,3,26,268,32,22
29,24,2,22,276,37,21
32,9,0,9,275,44,88
35,9,0,9,269,48,13
41,9,0,9,269,51,10
43,7,0,7,260,51,12
49,10,0,10,252,50,10
46,12,0,12,240,50,6
53,14,0,14,230,47,0
54,15,0,15,231,39,4
54,22,1,21,229,40,13
55,22,1,21,225,42,16
57,19,0,19,221,42,8
56,16,0,16,219,41,19
58,15,0,15,213,41,5
54,14,0,14,213,39,15
54,18,0,18,213,46,8
57,22,0,22,210,44,9
58,20,0,20,208,42,11
56,21,1,20,210,39,4
55,24,2,22,219,31,20
50,22,2,20,232,36,16
49,21,2,19,245,37,19
49,17,2,15,249,36,18
46,18,1,17,258,38,20
46,18,1,17,265,43,20
45,15,1,14,272,47,22
46,14,1,13,268,49,21
47,14,1,13,267,51,20
53,13,1,12,250,50,15
57,12,1,11,243,47,9
63,13,1,12,230,49,12
68,12,1,11,222,46,0
67,11,0,11,218,45,14
71,9,0,9,215,43,5
71,8,0,8,214,39,14
72,7,0,7,212,38,18
72,7,0,7,212,37,9
67,9,0,9,217,40,20
63,10,0,10,220,39,19
69,8,0,8,215,45,17
71,6,0,6,213,43,8
74,6,0,6,214,42,20
69,9,0,9,220,40,13
63,17,1,16,231,40,24
62,17,2,15,238,38,24
57,15,2,13,246,35,31
56,17,2,15,251,37,23
57,16,2,14,255,35,30
54,16,2,14,263,35,28
56,13,1,12,261,40,36
58,12,1,11,256,48,29
59,12,1,11,259,50,25
59,13,1,12,262,50,33
61,17,1,16,254,52,37
64,20,1,19,248,45,24
68,28,1,27,240,34,28
72,24,1,23,234,29,27
74,21,1,20,229,28,34
75,21,1,20,227,29,30
78,22,1,21,222,26,40
80,26,1,25,219,17,28
80,25,1,24,219,21,33
81,18,1,17,217,16,36
81,17,1,16,215,19,32
82,17,1,16,214,14,39
82,18,1,17,213,10,28
82,21,3,18,216,9,44
80,15,2,13,220,19,36
74,5,0,5,215,31,40
71,6,1,5,226,36,15
69,6,1,5,228,37,20
66,6,1,5,238,37,24
61,6,1,5,257,43,26
61,7,0,7,266,65,39
65,7,1,6,244,55,53
70,8,1,7,223,46,19
73,6,0,6,217,46,0
76,6,0,6,211,45,24
79,7,0,7,206,39,17
80,11,1,10,203,29,35
84,11,0,11,220,21,25
84,14,0,14,219,20,27
84,14,1,13,218,23,31
84,13,1,12,217,27,9
82,11,0,11,221,23,25
81,9,0,9,225,20,16
83,7,0,7,225,22,29
86,7,0,7,219,22,22
85,5,0,5,217,25,12
88,4,0,4,216,24,25
85,6,0,6,221,24,20
84,11,1,10,205,17,23
85,13,2,11,205,13,12
82,12,3,9,214,13,20
73,11,3,8,232,16,26
63,10,2,8,250,23,11
65,8,2,6,246,23,24
65,7,1,6,246,27,9
62,5,1,4,244,31,4
59,7,1,6,246,33,5
59,6,1,5,228,36,7
58,7,1,6,217,38,0
59,4,0,4,205,40,0
62,7,0,7,192,40,0
63,9,0,9,183,38,0
38,8,0,8,181,38,1
37,8,0,8,173,41,0
37,4,0,4,168,43,0
40,4,0,4,162,44,0
40,3,0,3,161,42,0
42,3,0,3,157,43,0
52,3,0,3,151,38,0
54,2,0,2,146,41,0
62,2,0,2,140,40,1
61,2,0,2,138,37,0
55,3,0,3,142,34,0
54,3,0,3,149,29,2
51,2,0,2,161,31,12
42,2,0,2,170,29,12
35,2,0,2,187,28,11
36,2,0,2,194,28,0
32,3,0,3,197,30,11
30,2,0,2,205,33,2
27,2,0,2,213,36,8
26,3,0,3,219,40,9
27,3,0,3,216,40,6
29,3,0,3,211,41,7
32,10,1,9,196,39,0
39,7,0,7,180,34,0
44,9,0,9,172,31,4
44,12,0,12,170,32,5
43,10,0,10,170,27,5
43,12,0,12,168,24,7
43,12,0,12,166,27,6
41,17.86138807,3.649946373,14.2114417,167,26,4
42,13,0,13,166,25,8
48,12,0,12,166,17,8
53,15,1,14,167,8,8
55,30,5,25,167,10,10
52,33,9,24,174,9,7
46,25,7,18,188,14,16
39,19,5,14,209,24.98082984,19
32,17.86256114,3.650023813,14.21253732,225,17,32
18,11,2,9,244,21,17
21,5,0,5,250,27,14
20,5,0,5,257,33,13
19,3,0,3,265,38,13
17,4,0,4,270,39,7
18,5,1,4,270,44,1
20,4,0,4,263,46,10
31,10,0,10,245,52,13
45,27,1,26,223,39,8
45,18,0,18,217,44,0
50,13,0,13,214,32,20
48,17,0,17,208,24,11
44,23,0,23,204,26,22
44,24,0,24,201,25,13
46,24,1,23,199,21,16
61,29,1,28,192,22,15
67,25,1,24,188,20,15
67,21,1,20,186,18,8
67,25,2,23,183,11,12
68,30,6,24,182,5,15
63,43,11,32,194,9,24
54,32,6,26,218,18,38
42,25,3,22,234,33,22
33,21,1,20,248,44,20
28,15,1,14,260,57,22
30,19,1,18,262,51,17
24,7,0,7,272,58,18
23,4,0,4,278,48,8
20,3,0,3,271,46,6
29,4,0,4,259,49,7
33,8,0,8,249,52,14
38,12,0,12,239,54,13
49,12,0,12,228,41,3
51,9,1,8,215,39,0
58,8,0,8,204,37,3
61,8,0,8,198,37,2
58,9,0,9,195,34,6
59,6,0,6,193,38,7
61,6,0,6,190,34,6
63,11,0,11,190,30,8
64,12,0,12,188,30,8
65,10,0,10,186,23,7
67,13,0,13,185,21,9
69,17,1,16,184,19,12
64,17,2,15,192,21,27
57,13,2,11,206,22,17
50,7,1,6,215,29,28
48,6,1,5,220,34,15
52,10,1,9,219,38,8
61,7,0,7,213,40,3
72,9,1,8,198,36,7
81,7,1,6,197,35,7
77,4,0,4,198,35,2
80,7,0,7,199,34,11
83,8,1,7,199,32,0
83,9,1,8,198,31,12
87,10,1,9,196,29,0
89,8,0,8,195,26,8
90,9,0,9,195,22,6
90,8,0,8,194,24,4
90,8,0,8,183,27,0
91,6,0,6,176,35,2
91,6,0,6,175,35,2
91,6,0,6,170,31,4
91,6,0,6,170,31,7
90,6,0,6,169,28,10
89,8,0,8,171,26,12
90,12,1,11,172,20,12
88,9,1,8,184,20,14
79,6,1,5,199,26,24
73,5,1,4,213,30,10
69,5,1,4,221,33,4
63,4,1,3,230,33,6
59,5,1,4,239,31,7
57,3,0,3,248,34,12
54,3,0,3,254,36,9
54,3,0,3,256,40,7
50,5,0,5,256,47,8
58,8,0,8,252,51,6
66,15,1,14,242,54,8
67,24,1,23,237,46,12
68,24,1,23,230,45,5
65,21,1,20,223,33,9
70,14,0,14,215,30,2
73,15,0,15,209,27,10
75,14,0,14,205,26,0
79,11,0,11,203,28,9
83,11,0,11,200,27,2
86,10,0,10,199,24,1
87,11,0,11,200,21,6
88,11,0,11,200,15,7
87,14,1,13,208,16,6
69,17,3,14,207,15,14
63,18,3,15,213,6,11
70,16,3,13,238,16,19
65,9,1,8,247,32,20
61,6,1,5,249,37,11
61,7,1,6,251,38,13
55,8,1,7,253,41,14
57,8,1,7,254,47,11
56,6,0,6,252,53,13
60,6,0,6,249,59,15
60,7,0,7,244,57,13
63,10,0,10,242,57,16
62,15,1,14,236,58,11
58,17,0,17,231,56,21
53,17,0,17,231,50,13
57,14,0,14,228,46,20
59,16,0,16,224,38,21
62,19,1,18,220,35,16
62,25,1,24,220,30,27
65,29,1,28,214,20,12
68,21,1,20,210,16,30
73,13,0,13,204,21,12
78,9,0,9,200,27,22
66,8,0,8,200,39,11
62,7,0,7,203,51,28
57,6,0,6,214,54,26
48,5,0,5,232,56,29
44,4,0,4,239,59,40
45,4,0,4,240,62,29
47,4,0,4,246,61,20
43,3,0,3,243,60,27
42,4,0,4,242,59,17
49,3,0,3,237,59,17
52,3,0,3,229,59,16
56,3,0,3,222,57,15
51,4,0,4,211,54,14
50,5,0,5,206,55,4
53,5,0,5,201,55,13
57,6,0,6,197,55,5
58,6,0,6,194,54,11
60,6,0,6,190,54,9
62,5,0,5,188,52,7
65,5,0,5,186,50,9
70,5,0,5,184,49,9
72,4,0,4,179,49,7
78,4,0,4,177,46,12
80,4,0,4,174,42,10
81,4,0,4,177,41,8
76,3,0,3,187,41,15
68,4,0,4,202,40,26
60,3,0,3,220,43,32
59,3,0,3,226,44,20
51,4,0,4,242,47,23
51,4,0,4,255,52,29
46,7,0,7,258,65,26
43,8,0,8,264,75,27
41,7,0,7,267,75,23
47,7,0,7,256,77,29
51,8,0,8,249,63,20
59,7,0,7,244,63,11
65,5,0,5,236,62,10
63,5,0,5,220,54,5
68,6,0,6,208,44,7
71,9,1,8,201,44,14
75,7,0,7,197,39,13
76,6,0,6,195,40,13
78,5,0,5,193,39,14
78,17.79812431,3.623799355,14.17432495,192,39,13
79,4,0,4,192,38,13
79,4,0,4,192,37,7
80,5,0,5,191,34,14
80,7,0,7,193,31,11
79,9,1,8,198,30,13
77,9,1,8,204,26,17
76,10,1,9,210,25.10028376,12.57626501
70,17.79407145,3.62261575,14.1714557,225,25,12
68,16,2,14,230,30,29
66,21,2,19,234,30,22
62,19,2,17,241,30,11
59,18,2,16,241,41,13
57,13,1,12,249,39,9
58,13,1,12,242,42,8
59,14,1,13,241,42,9
64,13,1,12,231,42,6
67,13,0,13,227,41,3
72,9,0,9,222,42,7
77,12,0,12,220,39,1
80,12,0,12,217,36,13
80,10,0,10,215,38,1
78,9,0,9,214,37,10
78,7,0,7,212,33,3
77,10,0,10,211,26,13
74,14,0,14,211,23,9
74,16,0,16,208,18,15
73,17,0,17,211,15,7
73,24,2,22,215,15,11
70,29,4,25,221,15,11
67,29,5,24,229,17,19
63,18,3,15,238,24,17
59,29,5,24,251,30,19
54,29,5,24,263,31,20
53,25,3,22,262,34,22
40,17,1,16,270,46,14
36,5,0,5,277,48,10
42,5,0,5,271,45,12
49,5,0,5,260,39,14
55,6,0,6,253,38,4
56,9,0,9,250,36,3
65,17,1,16,239,33,7
72,19,1,18,232,31,2
77,15,0,15,226,32,12
80,16,1,15,223,28,7
81,12,0,12,220,25,21
81,10,0,10,218,29,8
80,9,0,9,216,30,22
80,9,0,9,216,32,9
81,9,0,9,217,25,22
80,9,0,9,216,20,10
81,11,0,11,215,23,21
81,15,1,14,215,20,8
77,23,3,20,221,20,11
68,17,2,15,228,29,26
65,8,1,7,233,28,12
59,7,1,6,241,32,15
59,8,1,7,243,38,16
62,10,1,9,242,40,13
60,8,1,7,248,36,12
54,6,0,6,252,41,17
53,7,0,7,250,45,16
54,7,0,7,246,44,14
73,5,0,5,222,37,10
86,7,0,7,202,40,0
88,9,0,9,196,42,6
88,9,0,9,189,43,10
89,9,0,9,189,39,2
89,9,0,9,186,35,9
90,7,0,7,185,41,7
90,5,0,5,182,49,10
89,4,0,4,180,46,11
89,4,0,4,179,46,10
88,4,0,4,180,42,10
87,5,0,5,178,37,11
88,7,0,7,178,29,10
87,13,1,12,181,19,10
80,21,4,17,191,16,15
67,18,3,15,208,26,26
63,14,1,13,215,38,21
63,13,1,12,216,42,14
64,23,2,21,218,28,6
71,42,7,35,214,17,12
70,28,4,24,216,20,15
70,17,2,15,219,25,22
70,17,2,15,219,31,18
72,25,2,23,219,26,17
73,32,3,29,218,16,18
70,37,3,34,216,13,12
71,31,2,29,214,18,19
69,30,1,29,213,18,4
71,19,1,18,210,25,20
72,24,1,23,208,17,1
74,27,1,26,205,16,19
67,11,0,11,199,32,0
66,6,0,6,191,43,6
64,6,0,6,188,42,0
66,6,0,6,186,47,0
65,6,0,6,181,44,0
65,9,0,9,176,42,2
65,12,1,11,177,34,0
55,12,1,11,198,37,9
45,8,1,7,215,45,22
43,5,0,5,225,49,0
42,5,0,5,234,47,18
38,5,0,5,242,51,14
35,5,0,5,252,54,8
34,4,0,4,259,56,11
31,4,0,4,266,61,10
31,4,0,4,271,61,7
49,5,0,5,242,58,10
50,6,0,6,239,55,0
52,7,0,7,235,55,0
55,7,0,7,225,52,0
56,10,0,10,217,51,0
63,9,0,9,210,50,4
63,8,0,8,205,47,8
64,7,0,7,202,45,4
66,5,0,5,198,45,12
68,6,0,6,196,47,5
68,6,0,6,196,44,5
71,5,0,5,196,40,12
73,3,0,3,195,44,0
74,3,0,3,193,49,6
74,4,0,4,194,45,0
71,5,0,5,200,39,10
62,6,1,5,215,36,24
52,6,1,5,231,42,13
48,5,0,5,240,46,16
47,5,0,5,243,54,18
47,4,0,4,245,61,18
40,6,0,6,257,61,12
39,6,0,6,264,68,15
37,7,0,7,269,76,13
42,10,0,10,262,91,14
50,12,0,12,253,81,20
51,12,0,12,243,63,20
55,11,0,11,235,61,5
59,13,0,13,229,48,0
62,14,0,14,222,47,8
68,8,0,8,219,41,2
71,7,0,7,214,31,16
69,7,0,7,210,37,3
70,10,0,10,208,36,11
73,11,0,11,205,33,9
75,11,0,11,204,30,3
77,15,1,14,201,29,12
78,16,1,15,198,27,2
78,18,3,15,201,21,12
72,14,2,12,213,27,16
63,10,1,9,231,34,23
53,9,1,8,248,41,16
46,9,1,8,260,47,21
40,6,0,6,273,53,19
38,6,0,6,278,64,11
33,5,0,5,283,67,12
32,3,0,3,285,65,11
34,3,0,3,284,61,15
37,3,0,3,281,50,7
42,2,0,2,267,48,10
46,4,0,4,253,47,12
51,3,0,3,242,48,0
60,4,0,4,231,47,0
54,4,0,4,226,43,0
60,6,0,6,223,44,0
65,10,0,10,220,41,11
67,11,0,11,218,36,0
69,10,0,10,214,32,6
70,17.74000956,3.598163008,14.14184656,210,28,2
71,7,0,7,209,23,0
72,8,0,8,204,22,13
73,18,2,16,203,19,0
74,14,1,13,204,17,10
70,15,2,13,216,23,15
58,9,1,8,239,33,14
45,6,1,5,255,40,18
33,5,0,5,268,25.21668305,18
32,4,0,4,275,44,17
28,3,0,3,283,46,1
26,4,0,4,291,51,7
28,17.73465322,3.596454487,14.13819874,295,56,6
36,17.73465322,3.596454487,14.13819874,294,60,7
38,5,0,5,292,67,8
44,4,0,4,277,59,15
46,4,0,4,264,48,8
48,5,0,5,253,48,2
49,5,0,5,243,43,0
56,8,1,7,232,39,0
66,8,0,8,222,37,7
71,8,0,8,219,34,0
71,8,0,8,217,30,11
78,6,0,6,210,32,4
81,4,0,4,206,31,3
82,4,0,4,202,30,3
83,5,0,5,199,27,7
83,7,0,7,197,26,6
82,10,1,9,198,21,6
78,11,2,9,206,19,13
66,10,2,8,233,22,22
59,8,1,7,245,28,20
54,7,1,6,252,34,19
49,5,0,5,260,42,6
46,4,0,4,266,50,15
44,4,0,4,273,54,12
30,6,0,6,279,57,8
36,6,0,6,283,51,3
41,7,0,7,276,63,8
46,8,0,8,269,71,13
44,14,0,14,263,68,11
47,20,1,19,257,46,6
48,13,0,13,249,41,6
60,15,1,14,242,40,1
71,15,0,15,236,29,8
73,17,1,16,232,24,3
77,18,1,17,229,28,10
79,9,0,9,227,25,4
80,11,0,11,226,20,9
80,12,0,12,228,19,10
82,13,0,13,228,17,9
71,18,1,17,223,19,14
73,21,2,19,220,27,3
74,17,1,16,223,25,18
72,22,3,19,228,23,3
63,24,3,21,233,33,14
62,21,2,19,231,42,15
62,15,1,14,230,48,4
73,14,1,13,227,46,15
80,28,2,26,217,35,10
84,26,1,25,212,28,5
87,18,1,17,207,31,13
88,19,1,18,205,36,14
86,20,1,19,205,42,0
87,11,0,11,199,52,17
89,13,0,13,199,55,0
89,12,0,12,196,56,14
88,8,0,8,196,50,14
89,7,0,7,196,46,12
89,6,0,6,195,43,15
90,5,0,5,193,47,9
90,4,0,4,193,44,7
90,5,0,5,193,41,11
91,5,0,5,194,40,15
90,5,0,5,193,36,3
89,7,0,7,194,33,11
89,11,0,11,195,26,11
87,15,1,14,199,20,16
86,19,2,17,205,16,23
82,24,3,21,211,24,18
72,27,4,23,227,34,19
58,13,1,12,246,49,15
57,14,1,13,261,52,15
49,11,1,10,264,57,13
48,12,1,11,267,59,8
52,12,1,11,270,67,11
54,10,1,9,271,61,8
57,12,1,11,263,53,10
57,9,0,9,258,51,9
60,10,0,10,245,51,1
63,11,0,11,235,56,0
69,9,0,9,230,56,0
77,9,0,9,224,51,7
82,11,0,11,219,45,4
84,8,0,8,216,44,7
85,7,0,7,214,45,6
86,6,0,6,213,42,6
86,8,0,8,212,39,0
86,9,0,9,210,37,10
85,9,0,9,211,33,0
85,12,1,11,214,28,11
80,14,1,13,224,28,15
71,16,2,14,241,33,16
64,14,2,12,250,36,18
58,8,1,7,260,39,8
59,7,1,6,262,39,5
59,6,1,5,266,38,9
57,4,0,4,269,37,2
59,4,0,4,267,40,7
64,7,1,6,256,45,9
64,8,1,7,255,43,7
69,10,1,9,248,45,11
72,12,1,11,244,44,9
73,11,0,11,241,39,3
80,12,0,12,238,31,15
80,14,0,14,236,23,10
75,17,1,16,241,26,23
73,11,0,11,242,24,12
82,11,0,11,235,32,29
83,8,0,8,237,28,5
84,7,0,7,235,26,14
86,9,0,9,232,20,10
87,10,0,10,228,17,3
87,11,1,10,230,13,9
86,15,2,13,233,10,1
82,20,4,16,240,16,17
70,15,2,13,251,26,27
60,10,1,9,267,32,25
57,8,1,7,284,39,27
44,6,0,6,296,51,27
35,6,0,6,314,53,17
31,5,0,5,322,59,17
31,4,0,4,324,59,19
32,4,0,4,321,63,26
46,5,0,5,299,66,16
47,5,0,5,292,60,15
53,4,0,4,285,46,11
59,7,1,6,270,42,6
64,6,0,6,261,48,3
72,6,0,6,253,52,8
73,4,0,4,240,47,11
74,2,0,2,229,54,19
74,1,0,1,222,56,10
74,1,0,1,221,54,15
73,1,0,1,217,54,17
74,1,0,1,216,52,19
74,1,0,1,213,49,6
73,1,0,1,212,48,16
72,1,0,1,210,47,11
71,1,0,1,210,44,8
72,2,0,2,212,43,13
73,3,0,3,212,42,2
70,2,0,2,212,42,12
70,3,0,3,213,42,4
75,3,0,3,210,42,2
77,3,0,3,211,41,14
86,2,0,2,202,39,1
89,2,0,2,195,35,0
91,2,0,2,197,34,0
91,3,0,3,200,36,6
91,4,0,4,203,34,0
91,9,1,8,204,32,8
91,5,0,5,204,36,6
91,5,0,5,205,34,5
91,3,0,3,204,36,8
92,2,0,2,204,37,4
92,3,0,3,203,36,6
92,3,0,3,203,36,8
92,17.66556939,3.571598622,14.09397077,196,30,1
93,3,0,3,195,31,0
93,2,0,2,198,29,0
93,2,0,2,202,32,0
93,3,0,3,205,34,3
91,4,0,4,199,32,0
92,5,0,5,195,25,3
92,4,0,4,197,24,0
92,5,1,4,197,21,4
92,6,1,5,198,22,4
91,6,1,5,197,22,5
92,7,1,6,199,24,3
93,17.65791117,3.569764262,14.08814691,200,25,0
93,5,0,5,200,25.34220184,5
93,4,0,4,200,19,1
93,5,0,5,197,20,1
93,7,0,7,194,21,1
93,6,0,6,190,23,1
90,5,0,5,190,24,0
85,5,0,5,191,25,0
84,5,0,5,193,26,2
80,4,0,4,194,25,1
80,3,0,3,194,27,3
82,3,0,3,191,25,2
84,6,0,6,189,24,2
84,4,0,4,189,21,2
84,6,0,6,190,15,1
84,8,0,8,190,11,6
85,10,1,9,192,12,0
85,11,1,10,196,12,6
85,9,1,8,198,14,7
84,9,2,7,203,15,0
82,9,2,7,209,15,22
80,7,1,6,214,19,6
77,7,1,6,220,20,21
74,8,1,7,228,23,11
74,6,1,5,231,28,14
75,7,1,6,233,26,8
76,5,0,5,228,25,5
79,5,0,5,207,25,8
85,4,0,4,198,27,0
86,8,1,7,194,28,12
87,5,0,5,194,28,9
88,4,0,4,193,28,9
88,3,0,3,191,28,9
88,3,0,3,190,28,6
89,3,0,3,190,26,4
89,2,0,2,189,28,5
89,2,0,2,187,26,2
90,2,0,2,186,26,6
88,2,0,2,183,27,7
87,4,0,4,179,23,5
87,7,1,6,182,18,5
86,6,1,5,189,18,11
79,6,1,5,200,16,20
73,6,1,5,213,19,16
73,6,1,5,213,23,20
65,6,1,5,226,24,8
60,5,1,4,242,28,20
52,4,0,4,253,37,18
56,4,0,4,256,43,13
55,6,0,6,258,42,17
53,9,1,8,250,44,14
56,13,1,12,245,46,13
63,15,1,14,238,35,7
65,21,1,20,238,34,7
66,17,0,17,231,27,4
70,14,0,14,224,25,8
72,11,0,11,221,21,6
45,16,0,16,219,24,14
50,9,0,9,210,33,0
52,8,0,8,202,30,7
56,10,0,10,197,27,0
68,10,0,10,194,23,3
62,10,0,10,194,21,0
60,9,0,9,191,22,4
63,9,0,9,192,17,5
72,11,1,10,199,17,8
68,9,1,8,200,25,15
66,8,1,7,205,23,5
64,8,1,7,214,22,14
62,7,1,6,222,23,13
58,6,1,5,233,28,17
58,4,0,4,238,32,16
59,4,0,4,235,33,12
61,4,0,4,231,32,3
62,4,0,4,222,29,0
64,4,0,4,213,30,8
66,6,1,5,207,31,0
68,7,1,6,203,33,7
71,5,0,5,198,33,0
71,5,0,5,198,33,3
73,4,0,4,194,33,5
74,7,0,7,191,31,5
75,6,0,6,189,29,4
76,5,0,5,190,31,1
83,4,0,4,189,33,2
87,6,0,6,186,31,4
86,5,0,5,187,28,1
85,4,0,4,188,32,4
86,5,0,5,188,31,6
86,5,0,5,189,30,0
85,5,0,5,189,26,5
83,7,1,6,186,24,0
90,7,0,7,173,26,3
90,7,0,7,172,26,0
90,9,1,8,169,24,0
89,10,1,9,169,22,4
91,9,1,8,169,25,2
88,7,1,6,172,25,3
87,5,0,5,173,28,4
86,5,0,5,172,27,6
84,4,0,4,169,28,5
83,5,0,5,168,28,3
81,5,0,5,169,28,2
82,4,0,4,168,28,2
84,3,0,3,165,29,4
85,2,0,2,161,29,2
86,2,0,2,158,30,0
87,1,0,1,153,31,2
85,2,0,2,151,31,0
87,3,0,3,150,29,1
89,2,0,2,147,28,0
89,2,0,2,146,26,0
91,3,0,3,144,26,0
90,5,0,5,145,23,1
87,5,0,5,146,21,4
86,6,1,5,148,22,6
84,6,1,5,151,21,6
79,5,1,4,161,21,6
70,4,1,3,176,22,9
68,3,1,2,179,23,11
69,2,0,2,177,25,12
65,2,0,2,179,25,0
68,2,0,2,178,25,2
69,2,0,2,173,26,4
70,3,0,3,169,27,2
73,7,1,6,166,26,0
74,4,0,4,164,26,2
76,4,0,4,162,25,3
76,3,0,3,160,24,1
77,3,0,3,161,23,4
78,3,0,3,159,22,0
79,3,0,3,158,22,1
80,3,0,3,155,21,2
80,3,0,3,156,20,0
80,3,0,3,155,20,1
80,5,0,5,153,17,3
78,6,1,5,155,16,2
77,5,1,4,159,18,4
76,6,1,5,163,18,6
73,5,1,4,173,17,5
68,4,1,3,185,19,11
62,4,1,3,200,21,18
61,5,1,4,206,27,21
54,3,0,3,214,31,6
54,4,0,4,217,38,9
53,4,0,4,220,43,11
55,5,0,5,220,41,8
59,7,0,7,214,33,10
62,9,1,8,212,29,0
65,7,1,6,207,27,6
68,4,0,4,202,25,0
71,6,0,6,200,23,2
72,8,0,8,196,20,6
71,8,0,8,195,17,8
73,8,0,8,194,19,0
76,8,0,8,192,17,4
78,17.56329062,3.543914035,14.01937659,191,12,2
78,10,0,10,192,9,7
79,12,1,11,191,5,6
79,14,1,13,190,3,8
80,20,5,15,192,4,5
78,20,5,15,198,5,8
78,24,6,18,203,6,15
77,21,5,16,207,6,11
76,17.56319047,3.543820875,14.0193696,208,5,11
79,25,5,20,206,25.33535827,7
82,8,1,7,202,4,11
85,26,6,20,203,5,8
86,24,5,19,203,5,14
87,5,0,5,203,6,0
85,8,2,6,207,7,13
77,6,0,6,211,19,12
76,5,0,5,211,21,5
76,9,1,8,209,23,2
81,6,0,6,206,21,7
81,6,0,6,204,21,0
85,9,0,9,201,14,12
88,8,0,8,198,9,0
89,10,0,10,194,11,9
89,14,1,13,193,9,6
88,13,1,12,191,8,6
88,9,0,9,191,8,7
88,9,0,9,189,7,5
88,12,1,11,188,5,2
87,15,3,12,192,5,11
83,9,2,7,202,8,9
73,6,1,5,220,15,26
68,5,1,4,227,18,13
65,5,1,4,237,22,3
56,5,1,4,251,24,6
51,3,0,3,264,28,16
50,3,0,3,270,33,12
48,2,0,2,275,33,5
47,3,0,3,282,33,1
50,3,0,3,277,34,2
49,3,0,3,273,33,8
52,5,1,4,265,34,7
63,9,1,8,245,35,1
68,13,0,13,233,47,5
68,11,0,11,230,41,0
70,8,0,8,226,22,12
72,5,0,5,223,22,0
75,4,0,4,220,21,11
78,4,0,4,218,21,4
81,4,0,4,214,21,1
83,4,0,4,211,19,8
87,5,0,5,209,16,0
90,5,0,5,208,15,5
91,8,1,7,208,13,7
91,9,1,8,209,13,3
91,8,1,7,212,17,8
91,7,1,6,215,19,0
90,7,1,6,215,21,13
91,6,0,6,215,18,1
91,9,1,8,216,20,12
91,5,1,4,217,25,0
90,4,0,4,220,26,10
91,8,1,7,219,22,0
91,7,1,6,218,24,6
91,6,0,6,215,24,0
90,4,0,4,208,31,2
90,5,0,5,205,32,0
90,5,0,5,203,34,2
91,8,1,7,202,32,0
91,6,0,6,200,30,3
91,6,0,6,199,30,0
92,6,0,6,197,28,5
92,3,0,3,197,32,0
92,3,0,3,196,31,7
92,4,0,4,194,30,5
92,5,0,5,194,24,0
92,5,0,5,195,20,6
92,7,0,7,198,14,5
91,11,1,10,202,12,0
90,13,2,11,204,9,15
86,14,3,11,211,12,8
83,27,8,19,217,13,9
79,24,7,17,224,12,10
73,21,4,17,234,19,8
72,24,4,20,239,23,15
76,19,3,16,234,26,13
80,22,3,19,230,23,10
81,23,2,21,231,26,11
78,23,2,21,235,24,6
76,24,2,22,238,26,19
77,23,1,22,234,24,11
78,25,1,24,233,19,15
80,28,1,27,230,12,13
80,30,1,29,225,7,20
84,29,2,27,220,5,14
87,17,1,16,214,5,14
88,14,1,13,210,4,12
89,13,1,12,207,6,7
89,14,1,13,205,2,12
90,21,3,18,202,2,10
90,24,7,17,201,2,10
91,26,10,16,205,2,15
89,29,9,20,211,5,14
81,21,5,16,231,14,27
72,14,3,11,245,25,32
66,9,1,8,254,33,28
61,5,0,5,259,44,21
59,6,0,6,265,47,17
55,5,0,5,270,48,18
48,5,0,5,273,47,19
50,5,0,5,274,44,13
56,5,0,5,263,49,11
63,11,1,10,258,48,19
67,17,1,16,256,64,23
68,19,1,18,248,76,30
68,20,0,20,243,63,22
65,16,0,16,238,72,14
70,16,0,16,232,53,26
74,15,0,15,228,40,19
81,10,0,10,220,26,27
83,8,0,8,214,23,16
83,9,0,9,213,20,26
84,10,0,10,210,21,22
83,11,0,11,207,20,35
85,12,1,11,203,15,19
86,9,1,8,203,18,13
84,12,1,11,208,21,25
84,13,1,12,211,19,19
82,11,1,10,216,30,18
79,12,1,11,221,24,22
77,12,1,11,225,30,27
76,11,1,10,228,36,30
76,12,1,11,229,40,28
75,14,1,13,230,40,23
81,22,2,20,228,35,35
85,24,1,23,213,35,29
84,18,1,17,208,37,15
86,15,0,15,198,51,16
88,15,0,15,193,52,8
88,12,0,12,194,48,9
88,12,0,12,194,46,11
89,12,0,12,195,41,18
90,12,0,12,196,33,10
90,23,0,23,199,21,19
90,23,0,23,199,12,21
90,16,0,16,199,15,20
89,13,0,13,199,19,20
90,13,0,13,201,20,18
90,12,0,12,204,22,18
88,14,1,13,205,29,11
89,9,0,9,205,24,10
89,14,2,12,207,19,9
88,12,1,11,207,20,12
89,11,1,10,208,20,22
87,10,1,9,212,22,17
85,9,1,8,220,28,30
75,7,1,6,235,37,21
64,5,0,5,253,46,33
63,4,0,4,260,50,16
65,4,0,4,259,51,15
65,7,0,7,259,58,16
65,6,0,6,256,60,17
68,16,1,15,247,70,17
73,22,0,22,240,60,29
70,24,1,23,232,33,16
78,21,1,20,226,21,12
83,19,1,18,225,17,10
83,20,1,19,225,14,19
85,21,1,20,222,11,6
86,17.51715258,3.523399244,13.99375333,221,14,18
86,15,1,14,220,12,9
86,20,1,19,218,3,23
87,25,2,23,217,2,22
86,26,5,21,220,3,19
75,36,10,26,227,5,30
62,24,6,18,250,12,24
52,19,3,16,273,18,25
44,17.51931824,3.523569728,13.99574852,292,30,27
40,10,1,9,304,25.33167892,23
33,6,0,6,320,61,25
30,6,0,6,333,74,29
30,6,0,6,340,75,29
32,11,0,11,336,87,30
35,15,0,15,327,99,22
39,15,0,15,316,89,21
47,17,1,16,300,52,13
51,11,0,11,289,48,12
61,14,1,13,268,63,20
69,8,0,8,255,54,15
78,6,0,6,246,57,15
78,5,0,5,239,58,17
77,4,0,4,236,55,26
71,3,0,3,231,52,25
73,4,0,4,230,49,17
71,3,0,3,227,44,17
71,4,0,4,227,39,10
70,5,0,5,227,39,24
70,7,0,7,227,37,10
68,9,1,8,234,28,24
67,10,1,9,241,26,16
62,16,2,14,259,36,26
56,12,1,11,275,42,44
50,14,1,13,289,54,29
50,22,1,21,292,54,23
48,14,0,14,299,80,26
55,8,0,8,292,63,27
63,9,1,8,283,54,26
65,8,1,7,277,40,24
68,7,1,6,273,37,9
73,10,1,9,261,32,5
79,11,1,10,252,29,0
80,8,0,8,249,26,2
79,8,0,8,250,22,3
74,10,0,10,256,19,5
72,12,0,12,259,23,16
73,13,0,13,259,22,5
72,12,0,12,262,22,11
79,9,0,9,252,18,5
64,8,0,8,264,21,5
68,6,0,6,256,29,9
64,8,0,8,258,32,1
68,8,0,8,251,27,8
77,9,1,8,250,25,0
73,8,2,6,261,18,15
74,8,3,5,263,11,9
66,8,3,5,276,9,11
64,8,3,5,281,8,12
55,10,4,6,298,8,16
50,10,4,6,312,9,11
50,9,3,6,316,10,7
51,10,4,6,314,12,8
53,9,3,6,312,13,3
53,9,3,6,309,13,7
57,9,2,7,299,12,9
62,19,5,14,288,10,11
68,14,2,12,276,7,4
67,13,2,11,278,7,5
67,12,1,11,277,8,7
68,9,1,8,274,5,10
68,10,1,9,274,8,10
73,12,3,9,267,6,7
76,11,2,9,263,3,13
73,11,2,9,270,6,9
78,9,1,8,259,3,13
77,10,2,8,261,3,10
83,11,3,8,253,3,14
77,16,8,8,265,3,9
84,18,10,8,251,3,24
78,13,7,6,264,4,14
74,14,8,6,272,4,23
69,15,8,7,277,5,19
60,19,10,9,301,7,19
54,16,7,9,317,14,18
53,14,5,9,316,15,19
56,14,4,10,315,15,15
59,13,5,8,300,11,13
66,13,5,8,285,8,10
69,15,5,10,274,6,16
68,18,6,12,272,3,10
68,23,10,13,273,2,10
68,18,6,12,271,3,11
76,14,4,10,257,3,13
76,10,2,8,253,2,7
76,7,1,6,255,1,6
76,9,2,7,255,2,11
76,9,2,7,255,2,14
75,7,1,6,255,2,3
77,9,2,7,250,1,15
74,13,5,8,257,2,0
79,13,6,7,255,3,11
80,12,6,6,257,4,11
72,17,10,7,276,5,12
66,12,7,5,290,7,15
63,8,4,4,296,8,18
61,8,4,4,298,8,9
59,7,3,4,307,8,3
60,7,3,4,308,9,9
63,8,4,4,300,8,5
62,8,4,4,302,7,5
66,8,4,4,294,7,0
68,10,5,5,290,6,4
75,13,6,7,277,5,12
80,11,3,8,267,5,4
82,7,1,6,261,2,2
84,9,2,7,257,2,1
85,6,1,5,256,1,7
86,8,2,6,255,1,9
85,8,2,6,256,1,11
85,5,1,4,257,1,4
86,6,1,5,253,1,12
86,6,1,5,252,1,3
87,6,1,5,249,2,8
87,7,2,5,249,2,4
84,10,6,4,254,2,3
81,9,6,3,262,3,12
72,13,9,4,281,4,15
68,13,8,5,291,5,16
63,12,7,5,302,6,12
62,11,6,5,301,6,6
61,7,3,4,303,9,5
60,7,3,4,304,8,6
60,7,3,4,306,9,0
60,7,3,4,310,8,2
60,7,3,4,303,9,3
61,7,3,4,295,7,3
64,11,4,7,287,5,6
67,15,4,11,281,3,5
74,12,2,10,273,2,3
79,10,1,9,269,2,4
80,6,1,5,266,3,8
82,5,1,4,264,3,3
85,7,1,6,260,1,7
85,7,1,6,259,1,5
86,7,1,6,258,1,7
87,6,1,5,254,1,7
88,7,2,5,252,1,6
89,8,3,5,251,1,18
87,7,3,4,256,1,10
86,11,7,4,257,2,26
78,15,11,4,272,2,23
71,8,5,3,286,3,19
68,4,2,2,289,5,21
63,4,2,2,299,6,17
61,4,2,2,300,7,11
59,4,1,3,302,7,13
58,5,2,3,309,8,10
59,5,2,3,303,8,5
61,4,2,2,296,9,8
68,5,2,3,283,10,12
70,6,2,4,280,10,14
72,8,2,6,270,7,9
74,6,1,5,264,4,5
76,7,1,6,262,2,6
76,9,1,8,261,2,7
74,12,2,10,263,2,15
73,10,1,9,261,1,10
69,14,3,11,264,3,10
68,17.45648832,3.516308965,13.94017935,263,5,13
71,13,2,11,261,4,7
71,13,3,10,259,2,7
71,16,6,10,257,1,11
73,20,11,9,259,2,7
65,24,14,10,270,4,15
60,25,15,10,291,4,22
55,33,18,15,307,6,19
53,22,8,14,314,25.25207925,12.4684947
55,18,7,11,312,13,13
56,15,5,10,320,15,7
59,17.45772617,3.519036266,13.9386899,314,18,10
56,9,2,7,319,18,8
56,9,3,6,317,16,15
57,9,3,6,313,15,7
60,10,3,7,305,13,10
66,11,3,8,290,12,13
71,16,4,12,279,6,12
74,12,2,10,273,4,12
75,10,1,9,270,3,9
78,13,2,11,265,2,14
77,13,3,10,263,2,15
76,17,6,11,263,1,16
76,17,6,11,263,2,15
75,23,12,11,265,2,19
77,20,9,11,262,2,17
78,17,6,11,259,1,15
78,13,3,10,257,2,12
76,15,7,8,262,3,13
72,21,12,9,270,3,16
65,28,16,12,288,4,23
58,27,15,12,302,6,20
56,19,9,10,307,9,15
56,15,3,12,309,24,13
58,10,2,8,300,15,13
54,9,3,6,300,13,12
53,7,2,5,307,14,8
54,8,3,5,303,14,4
58,9,3,6,292,14,7
64,9,3,6,281,12,13
68,9,2,7,273,11,7
70,9,2,7,266,9,4
73,8,1,7,262,7,5
69,10,1,9,264,6,1
72,5,0,5,261,5,18
67,4,0,4,263,6,6
68,4,0,4,260,5,15
63,6,0,6,263,5,7
64,7,0,7,262,6,15
66,5,0,5,261,5,8
66,5,0,5,262,4,12
72,5,0,5,261,4,8
77,7,1,6,261,5,12
80,10,3,7,263,6,8
79,16,7,9,266,4,15
74,11,5,6,274,5,10
75,8,3,5,273,9,13
70,8,4,4,288,9,10
68,6,3,3,292,7,17
66,6,3,3,296,9,16
66,7,3,4,295,10,15
69,6,2,4,289,10,15
68,8,3,5,290,11,9
73,7,2,5,280,10,9
73,6,2,4,277,10,7
77,5,1,4,272,7,10
77,5,1,4,270,7,10
77,4,1,3,270,6,13
77,3,0,3,269,6,12
68,3,0,3,275,8,14
73,4,0,4,268,9,10
73,3,0,3,270,6,13
68,4,0,4,268,15,7
71,4,0,4,267,15,8
71,4,0,4,267,15,5
69,4,0,4,268,14,9
72,7,1,6,268,16,5
73,8,1,7,263,13,9
69,12,3,9,273,12,0
67,12,4,8,282,11,17
62,15,6,9,289,10,10
74,12,4,8,280,10,16
77,12,4,8,274,9,15
79,9,3,6,270,9,11
75,7,2,5,274,9,10
69,9,3,6,279,8,12
66,11,3,8,281,7,9
63,14,5,9,282,7,12
63,13,3,10,281,7,11
65,12,2,10,280,6,9
67,9,1,8,274,4,9
71,8,1,7,273,3,8
77,6,1,5,267,2,10
83,5,1,4,262,2,12
84,5,0,5,258,2,6
86,5,0,5,257,2,10
89,3,0,3,254,5,8
89,3,0,3,255,3,4
90,4,0,4,253,2,17
88,8,1,7,235,10,3
90,12,1,11,232,12,2
89,14,1,13,229,11,0
90,12,1,11,228,17,0
91,10,1,9,231,15,11
89,9,2,7,230,13,0
88,7,1,6,222,15,1
88,6,1,5,214,16,0
88,5,1,4,209,16,0
88,5,1,4,203,18,2
88,5,1,4,199,18,0
87,5,1,4,197,19,0
87,4,1,3,196,17,2
88,4,0,4,194,20,2
89,6,1,5,194,19,3
90,3,0,3,193,19,7
91,4,0,4,192,19,5
92,5,0,5,193,19,0
92,6,0,6,192,18,3
92,4,0,4,194,19,4
92,3,0,3,195,18,5
92,4,0,4,197,17,3
92,6,0,6,199,14,4
92,4,0,4,200,12,1
93,5,0,5,205,6,5
93,9,2,7,217,3,8
91,16,8,8,241,4,14
84,16,10,6,258,3,24
79,7,4,3,268,5,16
74,6,3,3,273,7,12
69,6,3,3,282,7,12
69,5,2,3,287,9,11
70,5,2,3,282,9,4
67,5,2,3,284,8,1
69,5,2,3,281,8,3
72,8,3,5,275,8,3
72,8,3,5,270,6,1
74,8,3,5,266,4,2
77,8,2,6,263,3,0
79,12,2,10,259,2,0
81,12,2,10,257,1,2
83,12,2,10,255,1,7
84,11,3,8,254,4,5
85,8,1,7,253,4,2
85,6,1,5,251,1,2
85,6,1,5,251,2,3
86,8,2,6,251,2,5
87,9,3,6,250,4,3
87,8,2,6,251,4,6
86,6,2,4,254,4,5
82,6,3,3,261,5,7
75,6,3,3,267,5,13
71,12,7,5,280,6,13
62,7,3,4,295,6,16
59,5,2,3,303,9,6
56,3,1,2,307,10,6
51,5,2,3,314,10,3
50,3,1,2,319,12,7
51,4,1,3,320,18,8
54,4,1,3,308,17,10
54,4,1,3,302,12,0
55,5,1,4,299,9,4
56,9,1,8,294,6,12
62,10,1,9,285,5,10
73,14,2,12,279,4,0
75,12,1,11,275,2,1
77,15,5,10,272,6,2
78,13,3,10,269,4,6
79,12,2,10,267,2,3
79,17.38809731,3.51004146,13.87805585,266,2,3
81,10,2,8,263,1,5
81,12,4,8,262,1,4
82,16,9,7,262,1,4
84,18,12,6,263,2,4
80,17,10,7,269,3,13
76,11,5,6,272,4,21
67,6,2,4,290,25.11156252,8
63,17.38650391,3.511017582,13.87548633,289,15,9
62,12,3,9,291,17,2
63,12,1,11,302,35,7
55,11,2,9,314,18,13
55,7,2,5,317,13,7
56,7,2,5,314,15,4
60,7,2,5,302,19,5
63,9,3,6,296,17,0
62,7,1,6,294,16,0
64,8,1,7,287,15,4
75,8,1,7,278,15,0
77,9,1,8,276,14,0
77,12,1,11,276,12,4
80,11,1,10,270,9,4
80,10,1,9,268,8,4
82,15,3,12,266,8,3
83,9,1,8,265,8,5
83,7,1,6,264,8,6
84,7,1,6,263,7,5
85,5,0,5,262,5,4
84,10,3,7,264,4,5
73,18,8,10,276,5,13
66,22,11,11,292,7,26
60,21,10,11,304,9,11
62,27,11,16,309,8,9
55,18,5,13,316,13,13
51,11,2,9,322,26,14
48,8,1,7,326,25,12
46,6,1,5,331,27,7
44,7,2,5,328,20,12
44,8,2,6,322,15,8
50,7,2,5,312,9,0
55,7,2,5,301,9,0
60,8,1,7,287,12,7
69,8,1,7,281,12,1
71,10,1,9,278,11,0
72,12,1,11,278,10,3
77,9,1,8,274,7,4
80,8,1,7,272,4,9
81,11,1,10,269,1,8
82,17,4,13,269,2,6
80,23,10,13,271,1,10
79,28,15,13,271,6,14
79,27,14,13,268,2,11
79,30,18,12,269,2,9
75,26,13,13,274,10,9
68,16,4,12,284,21,21
63,9,1,8,295,27,14
56,10,1,9,316,33,6
52,11,1,10,325,45,19
49,10,1,9,337,57,22
52,14,1,13,335,62,25
51,18,1,17,339,66,19
52,17,1,16,333,77,17
52,16,0,16,325,66,11
54,18,1,17,324,73,14
58,30,2,28,311,31,14
62,18,1,17,298,23,14
64,17,1,16,293,17,14
69,15,1,14,290,17,13
70,19,1,18,290,7,15
75,21,1,20,287,5,23
75,14,1,13,265,17,21
77,5,0,5,260,31,5
79,5,0,5,260,30,2
80,4,0,4,257,34,8
86,3,0,3,252,33,15
85,5,0,5,249,28,15
84,6,1,5,246,18,11
81,5,1,4,249,17,8
74,8,2,6,257,14,12
66,11,3,8,274,11,17
64,8,2,6,283,15,18
68,8,1,7,280,17,13
64,8,1,7,286,21,12
59,8,1,7,297,26,15
59,6,1,5,300,30,9
57,6,1,5,306,27,9
61,6,1,5,300,27,13
61,9,2,7,297,32,17
64,19,5,14,290,27,15
67,13,1,12,286,19,14
68,13,1,12,281,18,6
74,13,1,12,278,12,5
78,12,1,11,273,10,7
79,13,1,12,272,12,9
80,14,1,13,268,15,10
83,13,1,12,266,11,12
84,21,1,20,265,6,15
79,25,1,24,267,8,18
79,20,1,19,268,17,16
79,14,1,13,267,16,12
79,16,2,14,269,12,16
77,24,7,17,276,12,21
72,20,5,15,287,15,28
66,20,4,16,293,20,20
59,18,3,15,308,25,17
56,21,3,18,322,31,28
55,21,3,18,328,34,27
52,17,1,16,328,54,24
47,14,1,13,337,58,20
48,13,1,12,338,63,24
49,16,1,15,331,63,15
51,15,1,14,330,58,8
54,13,0,13,323,49,12
60,27,2,25,308,28,7
61,19,1,18,304,19,14
67,21,1,20,297,12,23
70,24,1,23,293,11,21
71,20,1,19,289,18,24
73,24,1,23,286,17,22
71,27,1,26,287,16,22
75,25,1,24,284,15,24
77,24,1,23,282,16,23
74,19,1,18,282,18,22
68,18,1,17,279,10,24
72,18,3,15,280,5,14
71,21,4,17,286,11,20
70,20,3,17,293,17,31
59,18,2,16,314,32,29
56,13,1,12,327,47,29
52,10,1,9,336,60,32
51,7,0,7,339,66,32
49,7,0,7,350,64,22
52,7,0,7,350,63,28
45,7,0,7,344,73,24
46,6,0,6,341,57,15
45,5,0,5,335,57,30
45,4,0,4,326,42,16
46,5,0,5,319,36,4
60,12,1,11,308,28,7
63,25,2,23,303,24,15
68,16,1,15,297,25,19
69,15,1,14,294,25,18
71,10,1,9,291,22,18
77,6,0,6,288,15,19
79,5,0,5,282,15,15
80,5,0,5,281,16,14
82,5,0,5,278,14,16
83,6,1,5,273,14,14
82,7,1,6,276,13,14
77,11,2,9,284,22,28
69,9,1,8,299,29,32
68,9,1,8,304,30,29
63,15,2,13,315,33,32
56,9,1,8,328,48,37
45,6,0,6,337,59,39
43,6,0,6,344,53,34
34,5,0,5,350,33,20
44,4,0,4,344,34,10
43,5,1,4,334,37,10
55,4,0,4,320,40,5
66,5,0,5,306,35,13
73,10,1,9,292,27,13
77,6,1,5,290,30,16
77,6,1,5,285,30,19
79,5,0,5,284,30,22
82,4,0,4,281,28,22
82,4,0,4,280,24,23
83,6,0,6,279,21,25
84,17.34835519,3.498096984,13.8502582,277,19,25
84,5,0,5,275,22,26
84,8,0,8,276,18,26
84,8,0,8,276,16,26
82,11,1,10,280,16,27
78,16,2,14,288,19,30
70,17,3,14,304,20,34
65,19,3,16,318,25,34
60,20,3,17,329,33,38
60,14,1,13,327,48,38
62,11,1,10,321,56,31
59,10,1,9,327,51,26
57,7,1,6,334,46,33
58,7,1,6,326,45,33
59,7,1,6,321,39,26
60,8,1,7,313,37,23
68,10,1,9,300,33,18
72,14,1,13,295,33,30
75,9,1,8,289,32,27
77,6,0,6,286,27,27
77,8,0,8,285,21,28
79,7,0,7,284,18,33
81,6,0,6,280,19,33
83,6,0,6,278,18,28
84,6,0,6,276,16,28
85,7,0,7,276,12,30
83,11,1,10,276,10,30
84,13,1,12,275,10,32
80,17,2,15,280,8,30
75,23,5,18,289,9,31
70,23,6,17,302,12,36
63,22,5,17,314,19,37
61,21,5,16,317,25.10661551,42
58,17.33949125,3.494865861,13.84462539,327,28,36
58,14,2,12,334,35,35
58,10,1,9,330,35,32
57,9,1,8,335,34,31
61,9,1,8,326,31,29
63,10,2,8,320,30,17
70,13,2,11,305,27,18
73,13,2,11,298,21,20
76,7,1,6,292,19,21
79,5,0,5,286,18,17
81,5,0,5,282,15,16
82,5,0,5,280,11,16
83,6,0,6,279,9,19
83,9,0,9,277,9,18
82,9,0,9,277,8,20
83,10,0,10,276,9,22
83,8,0,8,275,9,18
83,13,1,12,275,7,17
82,18,1,17,277,4,17
81,25,7,18,281,4,21
78,29,10,19,286,5,25
71,30,12,18,298,8,30
61,17,4,13,321,20,29
55,14,2,12,337,34,44
55,11,1,10,344,47,45
50,15,1,14,352,50,38
48,11,1,10,352,57,39
53,16,1,15,346,63,35
54,14,1,13,343,75,27
55,11,1,10,340,62,32
60,11,1,10,330,49,21
65,15,1,14,319,33,17
68,19,2,17,307,21,9
70,12,1,11,299,20,14
71,12,1,11,295,16,17
76,12,1,11,288,12,17
81,6,0,6,282,15,12
82,6,0,6,280,7,9
82,7,0,7,280,5,12
81,11,1,10,281,4,15
83,9,0,9,278,4,15
82,13,1,12,278,2,10
82,15,2,13,277,3,10
83,17,4,13,279,4,13
79,29,12,17,288,5,16
74,31,13,18,298,8,24
68,32,13,19,307,11,20
61,23,7,16,318,18,28
57,14,3,11,329,24,33
54,11,2,9,334,33,29
54,8,1,7,335,43,25
53,8,1,7,339,48,21
51,9,1,8,332,41,19
51,9,1,8,331,35,17
50,8,1,7,322,25,9
64,9,2,7,311,16,3
72,13,2,11,295,7,1
78,8,1,7,287,4,2
79,8,1,7,285,8,0
79,8,1,7,285,9,0
81,4,0,4,282,9,1
81,3,0,3,280,7,5
82,4,0,4,279,5,4
83,6,0,6,276,3,7
84,9,1,8,275,2,3
84,10,1,9,274,2,6
84,11,1,10,274,2,6
81,19,8,11,278,3,5
78,21,11,10,288,3,10
69,28,16,12,301,5,17
62,23,11,12,316,7,10
58,18,7,11,325,10,14
57,12,4,8,327,14,16
56,10,3,7,329,16,13
55,8,2,6,330,17,5
57,7,2,5,328,16,8
57,7,2,5,331,15,5
60,7,2,5,317,13,8
63,7,2,5,311,14,0
67,7,2,5,302,11,0
75,10,2,8,292,10,0
75,6,1,5,287,6,2
76,5,0,5,285,5,1
80,6,1,5,281,4,6
80,7,1,6,280,4,5
80,8,1,7,280,3,3
79,9,1,8,280,2,6
79,9,1,8,280,1,5
79,11,2,9,278,1,5
78,10,1,9,277,2,6
78,14,4,10,278,2,6
75,17,8,9,282,3,5
71,19,10,9,290,4,12
64,20,10,10,307,8,15
59,22,10,12,320,15,15
56,26,9,17,332,21,20
56,22,5,17,330,25,21
56,16,3,13,333,30,10
56,11,2,9,331,32,6
56,8,1,7,335,29,11
57,7,1,6,330,25,7
59,10,2,8,324,19,0
64,12,3,9,312,15,2
67,14,3,11,306,10,0
69,17,3,14,298,6,8
71,11,1,10,293,6,10
72,13,1,12,292,2,4
72,12,1,11,290,1,6
72,12,2,10,289,2,8
74,12,1,11,286,2,6
75,13,1,12,286,1,8
74,13,1,12,286,1,9
76,18,4,14,284,1,11
77,17,3,14,284,1,10
79,16,3,13,282,2,8
78,19,7,12,284,4,10
74,16,6,10,293,6,11
65,15,5,10,310,12,17
58,13,2,11,330,28,24
53,10,1,9,340,50,26
49,10,1,9,352,62,23
52,14,1,13,349,67,31
51,10,0,10,351,83,25
51,11,0,11,348,89,17
52,9,0,9,347,95,22
53,11,0,11,344,74,21
56,13,1,12,333,65,17
58,11,1,10,325,47,13
61,18,1,17,318,34,23
64,21,1,20,314,23,25
68,19,1,18,308,16,37
75,24,1,23,301,11,41
78,23,1,22,297,7,30
77,21,1,20,297,9,22
77,22,1,21,296,5,17
78,17.3108009,3.488622989,13.82217791,295,4,19
66,27,2,25,299,7,17
71,20,1,19,297,10,20
75,27,3,24,292,3,23
74,30,7,23,292,3,24
61,23,4,19,297,7,33
54,15,3,12,309,10,28
48,9,2,7,324,13,21
44,6,1,5,335,25.05932308,17
41,17.31171552,3.488380475,13.82333504,346,25,19
37,6,1,5,359,38,22
33,4,0,4,371,40,21
30,6,1,5,383,39,22
39,6,0,6,369,51,23
43,5,0,5,355,66,1
46,13,1,12,345,72,10
49,11,0,11,339,67,15
57,17,1,16,328,67,10
59,24,1,23,320,60,18
58,24,1,23,317,52,26
61,20,1,19,313,43,32
67,7,0,7,298,36,27
76,3,0,3,283,32,19
78,2,0,2,277,27,11
79,4,0,4,273,27,13
79,3,0,3,270,25,16
81,4,0,4,267,25,21
81,5,0,5,266,21,23
81,8,0,8,266,21,25
81,10,1,9,268,15,28
77,8,1,7,274,17,31
71,8,1,7,286,23,30
66,7,1,6,297,25,30
61,7,1,6,312,36,32
55,6,0,6,330,48,37
49,6,0,6,339,60,43
43,5,0,5,351,57,38
39,5,0,5,357,56,30
49,5,0,5,351,51,25
51,4,0,4,343,44,17
55,6,1,5,326,32,10
58,8,1,7,319,30,0
66,8,1,7,314,27,5
69,8,1,7,309,21,15
73,5,0,5,302,16,14
78,4,0,4,293,16,11
79,5,0,5,290,16,3
82,5,0,5,279,14,9
81,3,0,3,278,17,12
80,3,0,3,273,19,14
80,4,0,4,271,19,9
81,4,0,4,269,20,8
81,8,1,7,271,15,12
80,7,1,6,270,15,20
76,14,3,11,280,14,21
69,10,3,7,293,13,30
65,7,1,6,301,20,26
61,7,1,6,312,23,18
56,7,1,6,321,29,25
54,7,1,6,333,35,30
53,8,1,7,331,41,26
55,6,0,6,327,47,23
54,6,0,6,325,41,14
55,5,0,5,319,40,11
59,5,0,5,305,34,11
63,8,1,7,290,30,16
65,8,1,7,282,25,7
68,7,1,6,272,24,2
70,3,0,3,268,24,0
69,5,0,5,265,21,3
69,4,0,4,264,22,4
73,7,0,7,260,17,6
72,3,0,3,259,20,4
73,2,0,2,256,23,4
74,2,0,2,254,23,3
74,2,0,2,253,23,3
73,3,0,3,252,23,4
70,5,1,4,254,21,4
67,3,0,3,259,22,6
61,4,1,3,275,21,11
59,3,0,3,277,24,21
55,3,0,3,282,23,10
51,3,0,3,289,24,8
48,3,0,3,299,26,5
48,3,0,3,299,28,6
46,3,0,3,295,29,4
45,3,0,3,298,28,9
46,3,0,3,292,28,5
48,4,0,4,283,31,3
53,11,1,10,272,28,9
58,16,1,15,263,19,9
59,10,1,9,258,21,7
58,5,0,5,253,25,7
62,10,0,10,251,21,7
65,5,0,5,248,20,6
68,3,0,3,245,25,7
69,3,0,3,243,24,7
71,2,0,2,243,24,7
73,2,0,2,239,23,12
73,3,0,3,239,22,8
71,4,0,4,239,19,10
63,6,1,5,248,17,13
59,5,1,4,263,19,27
54,4,1,3,275,22,22
52,4,1,3,282,24,13
52,5,1,4,283,26,11
57,5,1,4,274,25,9
56,5,1,4,274,25,4
51,3,0,3,280,27,9
53,3,0,3,277,27,12
51,3,0,3,276,25,1
51,4,0,4,271,23,8
58,3,0,3,263,24,5
63,3,0,3,256,23,2
68,3,0,3,251,23,1
68,3,0,3,246,22,0
69,2,0,2,243,22,3
67,2,0,2,242,21,4
69,2,0,2,239,21,7
72,2,0,2,235,20,5
85,3,0,3,217,18,2
88,3,0,3,209,20,0
90,3,0,3,206,21,0
90,3,0,3,208,16,3
90,8,1,7,210,12,9
91,7,1,6,210,12,6
91,8,2,6,214,11,5
91,8,2,6,217,10,7
91,8,2,6,225,9,11
92,12,4,8,238,8,3
90,4,1,3,258,11,23
82,3,1,2,272,10,8
75,2,1,1,284,8,19
76,2,1,1,281,8,17
89,2,1,1,260,8,9
91,1,0,1,257,7,0
91,1,0,1,256,7,0
91,3,1,2,262,8,4
88,2,0,2,266,10,8
86,1,0,1,268,12,20
86,0,0,0,269,12,12
90,1,0,1,264,11,18
88,0,0,0,265,11,6
89,0,0,0,263,11,19
88,1,0,1,263,12,6
88,1,0,1,264,12,18
88,0,0,0,263,12,6
91,1,0,1,261,12,15
90,1,0,1,262,13,8
89,1,0,1,266,13,15
83,2,1,1,277,13,16
76,2,1,1,290,14,16
75,2,1,1,284,17,21
77,5,1,4,285,24,11
71,5,1,4,301,23,3
64,5,1,4,311,25,14
57,6,1,5,316,32,10
57,6,1,5,319,36,19
57,4,1,3,317,39,12
58,4,1,3,315,35,12
60,5,1,4,308,33,8
70,3,0,3,297,28,7
75,3,0,3,283,21,15
77,3,0,3,279,19,10
80,5,1,4,275,17,10
82,5,0,5,273,13,13
84,3,0,3,268,12,12
82,3,0,3,268,14,11
84,17.2168059,3.464991223,13.75181468,267,14,10
86,4,0,4,264,9,13
87,5,1,4,263,8,8
87,7,1,6,261,7,10
87,8,2,6,263,6,8
83,6,2,4,268,9,15
78,6,2,4,279,10,15
71,6,2,4,293,10,13
61,17.2129587,3.46429276,13.74866593,311,13,12
59,5,1,4,310,25.0496726,25
58,4,1,3,313,19,12
62,5,1,4,313,19,6
64,6,1,5,301,18,13
63,5,1,4,300,16,9
60,5,1,4,313,12,2
68,7,3,4,296,10,0
70,8,3,5,292,8,5
73,9,2,7,286,7,4
69,7,1,6,283,6,1
75,3,0,3,278,5,2
76,3,0,3,276,6,2
78,4,0,4,273,5,4
80,7,1,6,270,6,6
83,7,1,6,266,4,5
84,7,1,6,264,4,6
84,8,2,6,262,4,4
85,12,5,7,260,3,7
86,13,6,7,257,2,7
85,15,9,6,256,3,6
81,12,7,5,266,4,11
74,11,5,6,282,5,17
72,8,3,5,283,8,13
64,8,2,6,297,11,9
59,6,1,5,306,21,6
56,5,1,4,314,28,10
53,3,0,3,318,34,14
47,3,0,3,335,40,9
47,5,0,5,339,48,24
47,8,0,8,338,57,17
54,15,1,14,325,49,14
60,11,1,10,308,35,2
62,12,1,11,296,21,0
64,13,1,12,290,12,2
68,18,1,17,286,8,4
70,19,4,15,281,3,6
77,13,1,12,277,3,7
80,14,1,13,273,3,8
82,15,1,14,272,2,9
81,24,7,17,272,2,12
81,25,10,15,271,2,14
81,26,11,15,270,2,14
83,23,9,14,269,2,14
81,26,13,13,272,3,13
77,35,17,18,279,4,17
69,36,14,22,292,7,24
60,33,9,24,313,16,18
54,26,4,22,333,36,23
49,21,2,19,342,57,29
50,24,1,23,352,62,30
46,20,1,19,360,82,29
46,17,1,16,357,103,32
43,12,0,12,352,92,21
40,13,0,13,351,73,14
42,12,1,11,346,58,9
54,20,1,19,330,33,7
56,21,1,20,318,25,3
60,25,2,23,308,22,8
68,22,1,21,301,14,16
71,25,2,23,297,11,17
73,19,1,18,293,7,20
74,20,2,18,292,3,21
75,20,2,18,288,2,21
75,30,8,22,286,1,20
78,33,12,21,282,2,21
77,33,13,20,283,1,22
78,32,13,19,282,1,20
78,33,15,18,284,2,24
76,34,15,19,290,3,26
69,27,10,17,302,10,29
60,14,2,12,321,27,20
54,11,1,10,336,51,28
51,9,0,9,350,64,33
46,7,0,7,359,71,35
46,7,0,7,368,67,37
47,6,0,6,366,70,34
50,7,0,7,362,71,20
49,10,0,10,351,75,17
55,17,1,16,342,58,12
59,21,1,20,330,92,21
60,21,1,20,322,80,28
60,20,1,19,319,67,25
55,13,1,12,317,50,33
56,13,1,12,313,44,28
54,13,1,12,307,39,23
61,11,1,10,303,35,30
69,11,1,10,296,33,31
73,6,0,6,291,31,32
76,5,0,5,286,33,26
78,5,0,5,283,32,25
79,6,0,6,282,24,31
81,10,1,9,279,21,30
74,8,1,7,286,23,28
66,9,1,8,298,24,29
56,9,1,8,317,25,19
52,9,1,8,330,39,23
51,8,1,7,343,51,35
52,6,0,6,350,58,33
50,6,0,6,356,61,30
51,5,0,5,360,53,27
49,5,0,5,360,52,23
50,5,0,5,351,50,23
52,10,1,9,339,41,17
56,23,2,21,323,25,15
57,13,1,12,313,31,11
62,10,1,9,302,32,17
59,9,1,8,296,31,17
62,9,0,9,290,27,14
68,5,0,5,285,28,14
70,6,0,6,283,28,14
72,4,0,4,280,28,13
74,4,0,4,279,25,15
75,5,0,5,277,21,16
75,9,0,9,275,18,13
75,11,0,11,274,16,17
68,10,1,9,273,19,16
65,13,2,11,279,21,14
59,11,2,9,289,24,23
54,9,1,8,306,30,18
46,5,0,5,321,36,15
46,5,0,5,328,47,22
50,7,0,7,332,61,23
48,8,0,8,337,66,22
42,8,0,8,344,75,27
45,7,0,7,347,73,30
52,6,0,6,341,86,32
60,4,0,4,326,75,24
66,7,1,6,310,39,9
69,7,1,6,304,30,5
71,4,0,4,299,26,18
73,6,0,6,298,23,19
74,12,1,11,297,23,22
75,12,1,11,294,26,25
73,11,0,11,292,28,28
73,11,0,11,287,31,23
79,5,0,5,284,26,18
80,4,0,4,283,21,20
80,4,0,4,282,20,23
81,6,0,6,281,21,23
81,6,0,6,283,22,28
78,11,1,10,288,23,30
71,11,1,10,300,29,33
67,16,2,14,310,33,30
64,14,2,12,319,35,29
59,10,1,9,328,47,33
55,8,1,7,340,51,36
54,8,1,7,339,53,36
54,7,1,6,341,51,31
58,5,0,5,332,51,26
58,6,0,6,330,53,21
60,7,0,7,325,55,19
64,10,1,9,314,48,20
69,11,1,10,302,45,19
74,6,0,6,296,39,23
76,16,3,13,296,34,23
76,7,0,7,293,31,26
76,7,0,7,290,35,27
80,7,0,7,286,36,27
82,6,0,6,285,34,33
81,17.17217594,3.452973661,13.71920228,285,29,39
82,7,0,7,284,24,41
82,9,0,9,284,20,43
81,12,0,12,284,20,42
81,11,0,11,286,18,42
80,14,1,13,289,19,42
81,9,1,8,286,17,41
77,5,1,4,283,17,29
74,6,1,5,290,19,16
71,17.16904748,3.451825649,13.71722184,295,22,19
69,6,1,5,303,24,17
63,5,1,4,319,37,12.56487602
62,5,1,4,320,25.0957615,29
63,5,1,4,315,32,25
61,5,1,4,314,29,17
65,5,1,4,295,30,20
69,5,1,4,278,31,20
75,2,0,2,262,30,8
74,2,0,2,260,29,3
72,2,0,2,258,26,0
72,2,0,2,258,26,6
72,2,0,2,257,26,0
74,3,0,3,252,22,4
76,4,0,4,251,21,2
79,3,0,3,238,15,0
83,5,0,5,232,13,0
84,6,0,6,228,13,0
89,6,0,6,224,14,2
90,5,0,5,222,11,0
90,5,0,5,223,13,3
89,4,0,4,218,12,4
89,10,1,9,215,12,0
90,11,2,9,216,12,6
90,12,2,10,214,13,0
88,11,2,9,218,14,6
84,13,3,10,224,16,2
82,11,2,9,234,16,11
82,13,2,11,234,18,7
81,14,2,12,235,18,4
78,13,1,12,238,20,3
74,12,1,11,242,21,1
83,9,0,9,227,22,10
86,8,0,8,222,21,0
84,7,0,7,219,18,4
83,7,0,7,217,17,0
84,5,0,5,215,17,0
83,4,0,4,214,17,6
81,4,0,4,215,16,0
80,4,0,4,217,16,7
78,4,0,4,219,17,0
78,4,0,4,218,17,0
79,4,0,4,217,17,5
78,4,0,4,220,17,0
82,6,1,5,224,15,6
88,6,1,5,220,15,0
89,5,1,4,224,16,6
90,5,1,4,232,15,0
91,7,2,5,238,15,12
92,4,1,3,243,13,0
91,4,1,3,245,14,15
91,4,1,3,245,16,0
92,4,1,3,247,14,0
92,4,1,3,254,10,6
91,3,1,2,258,9,0
91,2,0,2,258,9,12
90,1,0,1,259,9,2
90,1,0,1,258,10,11
90,1,0,1,255,12,3
91,1,0,1,254,14,8
90,0,0,0,253,15,6
90,0,0,0,251,17,3
90,0,0,0,246,18,4
89,0,0,0,243,22,0
90,0,0,0,241,24,8
91,1,0,1,239,24,0
91,1,0,1,240,25,7
87,2,0,2,245,24,0
80,2,0,2,255,23,13
72,3,0,3,267,23,0
73,3,0,3,268,22,18
65,8,1,7,283,19,2
69,17,3,14,284,14,7
78,15,3,12,277,14,14
78,14,2,12,281,24,16
70,11,1,10,303,31,15
62,9,1,8,316,32,18
64,9,1,8,309,32,19
67,11,1,10,303,34,8
77,11,1,10,287,33,21
80,7,0,7,279,30,22
82,7,0,7,273,25,20
83,7,0,7,274,25,17
83,9,0,9,276,25,22
81,9,0,9,278,25,27
80,8,0,8,276,24,26
79,10,0,10,277,23,26
76,15,0,15,276,25,22
79,13,0,13,273,24,22
81,10,0,10,272,21,24
82,10,0,10,271,18,21
82,14,1,13,271,19,22
78,24,4,20,282,14,25
75,29,7,22,294,14,29
66,29,7,22,314,16,25
63,24,5,19,322,21,26
61,20,3,17,325,31,28
64,14,2,12,317,35,27
63,11,1,10,323,39,10
62,11,1,10,320,37,17
64,11,1,10,314,34,20
65,9,1,8,307,33,13
69,10,1,9,298,29,13
74,12,1,11,289,29,24
74,13,1,12,286,23,20
73,13,1,12,284,21,21
74,16,1,15,282,19,21
76,11,0,11,280,19,23
75,9,0,9,279,16,25
76,11,0,11,277,15,25
73,16,1,15,281,15,28
79,17,1,16,276,12,26
77,8,0,8,272,25,20
78,4,0,4,272,34,7
79,4,0,4,271,31,7
80,6,0,6,270,26,7
77,9,1,8,276,23,8
71,8,1,7,286,30,19
64,9,1,8,305,33,12
61,5,0,5,316,41,10
58,7,0,7,322,54,16
55,6,0,6,329,55,19
55,8,1,7,330,45,26
56,8,1,7,331,46,21
62,8,1,7,316,40,19
72,11,1,10,304,29,8
72,13,2,11,302,25,11
74,13,1,12,297,21,12
77,20,2,18,291,14,13
77,15,1,14,289,9,13
78,15,1,14,288,9,14
79,16,1,15,285,6,14
81,15,1,14,284,3,15
81,3,0,3,275,20,17
80,3,0,3,272,29,31
79,3,0,3,270,33,29
78,3,0,3,268,28,25
79,2,0,2,266,28,19
78,2,0,2,264,26,18
78,2,0,2,263,23,14
77,2,0,2,261,22,11
77,3,0,3,263,21,9
76,4,1,3,269,21,11
74,5,1,4,277,21,16
72,4,1,3,287,22,20
73,2,0,2,289,26,16
72,2,0,2,292,25,21
69,2,0,2,303,26,14
68,4,1,3,306,29,17
71,5,1,4,298,30,18
74,3,0,3,292,28,21
76,3,0,3,288,27,16
78,6,1,5,285,24,22
78,4,0,4,284,24,21
80,4,0,4,283,16,23
80,5,0,5,279,15,20
83,5,0,5,276,18,20
83,6,0,6,275,21,26
83,6,0,6,273,14,24
84,17.09494277,3.430974588,13.66396818,268,11,22
85,5,0,5,266,9,20
86,5,0,5,264,8,22
87,4,0,4,260,9,21
87,5,1,4,262,7,25
85,7,2,5,268,7,23
81,9,3,6,278,9,26
79,12,3,9,286,25.06719838,33
71,10,2,8,303,17,14
66,17.09109819,3.43018177,13.66091642,317,30,25
60,14,1,13,327,67,33
58,11,1,10,332,57,26
60,8,1,7,325,58,25
69,14,2,12,311,55,14
74,14,2,12,306,15,12
74,20,3,17,295,25,15
71,17,2,15,284,21,9
67,13,0,13,282,23,0
70,16,0,16,282,21,2
67,19,1,18,283,16,6
72,23,1,22,284,9,10
76,27,3,24,282,3,10
76,22,4,18,281,2,9
77,29,10,19,279,2,13
80,31,13,18,277,2,14
82,22,4,18,273,2,13
82,21,4,17,273,2,13
82,23,5,18,271,2,11
81,24,8,16,270,2,11
76,23,9,14,277,5,10
67,13,5,8,293,9,17
61,9,3,6,311,13,11
60,14,4,10,317,16,10
59,13,4,9,324,18,12
59,11,3,8,329,19,11
57,8,2,6,327,21,13
56,5,1,4,323,17,9
58,4,1,3,319,13,1
59,6,2,4,316,12,0
63,6,2,4,306,9,0
66,10,3,7,301,7,7
73,11,2,9,292,4,13
72,7,1,6,291,3,7
70,11,2,9,288,2,8
72,9,1,8,287,2,11
71,7,1,6,285,2,9
72,4,0,4,286,2,8
71,8,1,7,286,2,9
70,9,1,8,285,5,8
75,7,1,6,280,5,8
74,7,1,6,280,4,9
79,5,0,5,276,3,8
78,7,2,5,279,3,6
72,9,4,5,290,5,10
58,12,6,6,308,6,17
59,10,4,6,315,9,6
59,8,3,5,317,11,7
58,8,3,5,319,12,3
60,6,2,4,315,15,6
60,5,1,4,319,20,8
60,5,1,4,314,17,7
61,6,2,4,312,14,6
63,6,2,4,309,13,3
69,6,2,4,298,11,4
70,10,2,8,293,8,11
68,7,1,6,292,4,6
73,7,1,6,287,3,8
70,6,1,5,287,3,9
73,4,0,4,286,3,13
76,3,0,3,282,4,12
74,4,0,4,283,4,11
74,5,0,5,280,3,12
76,3,0,3,276,5,11
79,2,0,2,276,6,5
80,2,0,2,275,6,6
80,3,0,3,275,7,8
79,4,1,3,275,7,8
74,5,2,3,284,8,11
66,5,2,3,297,8,13
62,5,2,3,306,9,21
60,6,2,4,314,10,12
53,6,2,4,321,11,5
55,7,2,5,315,12,6
54,7,2,5,318,13,5
53,8,2,6,318,13,7
53,8,2,6,317,13,6
57,8,2,6,310,12,7
56,10,2,8,308,12,13
56,14,3,11,309,13,9
57,14,1,13,301,21,5
56,12,1,11,288,15,4
62,8,0,8,278,21,0
63,6,0,6,273,18,0
64,7,0,7,271,19,0
65,10,0,10,268,17,0
58,6,0,6,273,22,0
50,3,0,3,272,25,0
48,3,0,3,266,28,0
46,2,0,2,261,29,0
43,2,0,2,257,28,3
45,3,0,3,249,26,0
40,4,0,4,252,23,5
38,4,1,3,261,23,0
33,4,1,3,266,25,6
27,3,0,3,278,26,2
23,3,0,3,283,26,7
25,3,0,3,290,26,5
23,3,0,3,296,25,8
24,3,0,3,298,25,10
22,3,0,3,297,26,11
25,3,0,3,295,26,7
24,3,0,3,287,26,1
25,3,0,3,277,27,0
31,4,0,4,262,26,0
34,6,0,6,252,20,0
37,6,0,6,246,23,0
40,7,0,7,240,19,5
42,5,0,5,236,21,2
44,5,0,5,227,22,2
46,4,0,4,219,24,4
48,4,0,4,213,22,0
50,4,0,4,210,21,9
52,4,0,4,205,20,0
56,6,0,6,200,19,7
57,8,1,7,199,15,1
54,13,3,10,204,8,0
47,9,2,7,218,14,20
39,6,1,5,238,21,13
38,6,1,5,250,24,8
35,4,0,4,260,26,14
35,3,0,3,261,31,13
34,3,0,3,267,31,4
35,3,0,3,269,33,1
34,3,0,3,274,37,0
39,3,0,3,263,39,2
41,3,0,3,258,36,11
41,3,0,3,248,33,2
35,4,0,4,241,29,0
51,6,0,6,233,26,0
56,7,0,7,228,26,7
61,7,0,7,223,25,0
61,6,0,6,221,23,12
61,7,0,7,220,19,1
62,10,0,10,214,18,6
65,7,0,7,213,18,9
67,7,0,7,210,18,6
72,6,0,6,205,16,7
72,6,0,6,204,15,11
72,7,1,6,201,13,5
70,10,2,8,209,13,15
63,6,1,5,227,18,23
50,6,1,5,251,24,16
44,5,1,4,262,28,15
42,6,1,5,268,37,12
40,4,0,4,273,43,6
40,3,0,3,281,45,2
37,3,0,3,286,43,2
39,2,0,2,287,45,5
39,2,0,2,281,44,9
37,3,0,3,276,37,12
39,3,0,3,267,34,6
48,3,0,3,256,29,0
51,4,0,4,250,24,0
52,5,0,5,247,22,0
54,11,1,10,243,22,3
56,11,1,10,239,22,0
58,11,0,11,237,20,5
59,13,1,12,235,21,0
61,17.02123962,3.413823544,13.60741607,232,16,11
62,8,0,8,230,14,0
62,9,0,9,231,13,17
62,8,0,8,231,12,6
64,10,1,9,229,6,2
65,13,2,11,231,6,9
61,14,3,11,239,7,8
61,9,2,7,244,14,15
57,10,2,8,253,25.01023433,8
55,17.01860168,3.412995841,13.60560584,264,26,9
53,17.01860168,3.412995841,13.60560584,271,31,18
55,5,0,5,276,34,9
58,4,0,4,276,35,7
64,4,0,4,270,35,10
67,5,0,5,264,34,8
68,5,0,5,265,32,3
68,5,0,5,263,27,6
70,5,0,5,259,25,7
74,5,0,5,254,23,4
76,5,0,5,250,21,4
77,5,0,5,245,20,7
77,5,0,5,245,19,5
78,4,0,4,244,18,8
79,4,0,4,243,14,8
80,5,0,5,242,14,13
81,7,0,7,243,11,7
80,9,0,9,247,6,12
79,14,1,13,249,2,13
80,13,2,11,251,3,16
78,19,6,13,255,6,17
77,22,6,16,264,7,19
72,30,11,19,284,8,24
64,19,7,12,308,10,19
56,9,3,6,318,11,13
54,6,2,4,322,11,14
44,6,2,4,331,11,10
43,6,2,4,338,8,9
48,6,2,4,326,10,11
49,6,2,4,319,12,7
54,8,3,5,312,9,0
58,12,4,8,303,10,5
67,14,2,12,290,7,6
70,10,2,8,288,5,9
74,13,4,9,284,4,8
78,8,2,6,282,3,11
82,7,1,6,278,4,13
83,6,1,5,277,5,12
83,3,0,3,276,4,10
83,4,0,4,275,3,12
84,4,0,4,273,2,10
83,3,0,3,273,3,13
84,7,1,6,272,2,11
83,11,4,7,274,2,12
79,13,7,6,283,3,13
73,13,8,5,294,3,21
63,11,6,5,308,4,18
58,11,5,6,318,6,7
55,10,4,6,328,8,11
53,12,4,8,331,13,15
51,11,3,8,336,18,13
54,9,2,7,330,16,8
49,8,3,5,337,14,5
48,11,4,7,337,12,7
53,10,3,7,323,9,6
62,12,3,9,312,7,0
68,16,4,12,298,3,2
71,9,2,7,290,3,10
74,8,2,6,284,2,3
73,10,3,7,285,3,7
73,6,1,5,284,2,8
73,5,0,5,284,2,15
77,6,1,5,281,2,13
78,5,1,4,278,2,9
81,5,1,4,277,3,9
83,6,1,5,274,3,7
83,13,6,7,273,1,11
82,14,8,6,274,2,10
75,21,14,7,284,3,16
71,20,12,8,294,4,22
61,8,3,5,310,6,13
57,10,4,6,322,9,10
53,12,4,8,330,11,14
52,9,2,7,330,12,18
52,10,2,8,333,13,14
59,10,3,7,322,12,8
56,10,3,7,326,9,0
57,8,3,5,320,8,10
61,11,5,6,312,7,7
64,9,3,6,304,6,6
66,7,1,6,300,4,13
70,5,1,4,297,5,14
70,5,1,4,294,6,13
72,3,0,3,292,5,12
73,3,0,3,289,5,14
73,3,0,3,289,5,12
71,8,1,7,290,8,13
70,8,2,6,291,8,15
67,6,1,5,294,9,13
67,4,1,3,294,9,13
71,2,0,2,289,11,18
79,5,0,5,280,11,20
78,5,1,4,283,11,13
80,5,1,4,278,11,16
75,6,2,4,289,10,17
75,6,2,4,289,10,25
78,5,2,3,284,10,25
73,6,2,4,295,9,18
68,6,2,4,302,11,25
64,6,2,4,308,12,20
65,6,2,4,307,12,17
67,6,2,4,305,12,16
70,5,1,4,297,10,18
71,4,1,3,294,8,16
72,4,0,4,289,6,15
72,5,0,5,288,5,15
70,5,0,5,287,5,15
72,5,0,5,283,5,17
72,3,0,3,284,7,17
72,4,0,4,284,5,18
70,5,0,5,285,6,16
71,6,0,6,284,7,13
74,5,0,5,282,6,14
72,6,0,6,283,7,12
71,6,0,6,284,8,12
69,8,1,7,286,8,12
65,12,4,8,295,8,12
60,13,5,8,307,8,17
54,13,5,8,325,11,12
50,10,3,7,338,15,11
49,7,1,6,345,18,14
47,9,2,7,351,24,16
48,11,2,9,351,27,14
50,12,2,10,348,27,15
51,12,2,10,345,27,12
53,13,2,11,337,25,13
58,12,2,10,325,20,8
62,15,2,13,315,15,1
65,17,1,16,310,11,7
64,14,1,13,311,10,21
69,11,0,11,302,10,21
70,15,1,14,299,9,21
70,15,1,14,297,5,21
71,16,1,15,292,10,17
71,9,0,9,285,16,9
69,10,0,10,281,19,6
71,7,0,7,281,17,8
73,8,0,8,280,13,9
74,10,0,10,278,9,10
75,11,1,10,278,9,8
71,10,2,8,287,9,13
65,11,2,9,300,13,22
57,9,1,8,322,24,12
51,8,1,7,342,36,19
45,5,0,5,355,40,21
42,5,0,5,363,41,25
45,7,0,7,364,64,22
44,10,0,10,369,86,28
44,10,0,10,365,86,23
46,11,0,11,357,78,12
49,12,0,12,341,61,8
54,11,0,11,333,42,0
60,17,1,16,322,33,3
64,18,1,17,313,34,15
66,20,0,20,309,32,29
69,28,1,27,307,23,28
67,13,0,13,298,30,26
68,7,0,7,295,46,22
63,8,0,8,288,41,25
65,16.95867094,3.401139895,13.55753104,277,25,15
64,6,0,6,275,24,3
65,7,0,7,275,20,5
65,10,0,10,277,11,9
65,14,1,13,277,5,11
60,15,2,13,289,7,12
55,19,3,16,302,9,16
51,13,1,12,325,20,17
49,11,1,10,337,24.92680806,26
43,6,0,6,348,45,29
43,16.95622214,3.400067455,13.55615468,351,54,27
44,5,0,5,351,62,20
44,4,0,4,348,34,11
46,5,0,5,343,32,3
49,5,0,5,336,34,7
53,7,1,6,320,29,8
63,6,0,6,302,28,7
67,7,0,7,287,33,12
76,6,0,6,274,31,11
84,7,0,7,261,27,11
83,6,0,6,262,25,3
83,6,0,6,264,25,11
82,5,0,5,263,24,16
81,5,0,5,259,25,12
79,5,0,5,257,24,10
79,4,0,4,257,26,6
78,4,0,4,255,28,10
80,3,0,3,251,28,3
77,4,0,4,244,27,5
76,5,0,5,245,26,7
79,5,0,5,242,22,9
78,7,1,6,249,21,5
72,7,1,6,261,20,12
69,9,1,8,271,23,16
65,13,2,11,285,27,18
63,10,1,9,289,40,21
63,7,0,7,294,44,21
60,10,0,10,304,49,16
60,7,0,7,305,52,22
65,7,0,7,296,55,21
70,6,0,6,279,37,19
73,6,0,6,271,33,5
75,6,0,6,268,32,7
76,5,0,5,266,29,13
77,5,0,5,263,25,15
79,4,0,4,258,26,9
79,3,0,3,255,26,6
80,3,0,3,253,24,10
80,3,0,3,252,23,7
80,3,0,3,253,24,14
80,3,0,3,252,23,10
79,3,0,3,252,20,9
78,6,0,6,252,20,9
77,10,1,9,254,15,2
77,8,1,7,256,11,10
78,8,1,7,258,11,15
76,7,1,6,263,13,17
77,7,1,6,262,15,18
74,6,1,5,267,18,21
73,6,1,5,271,21,17
70,5,0,5,280,23,18
69,5,0,5,280,29,14
63,5,0,5,290,34,13
66,5,0,5,290,34,13
69,6,0,6,284,30,17
71,9,0,9,279,30,14
74,8,0,8,273,25,11
78,6,0,6,263,21,8
80,7,0,7,257,18,12
80,12,0,12,257,10,13
81,13,0,13,255,9,28
80,7,0,7,256,15,23
80,5,0,5,255,19,17
82,4,0,4,253,17,9
82,5,0,5,253,16,11
83,6,0,6,251,13,8
82,11,1,10,253,10,11
81,14,3,11,258,8,10
77,17,5,12,272,9,18
70,19,4,15,290,14,30
63,25,5,20,304,19,23
58,18,3,15,321,25,24
54,16,3,13,327,27,33
54,12,2,10,325,24,22
52,14,3,11,326,21,7
54,15,3,12,322,19,13
56,12,2,10,311,18,11
62,14,2,12,303,16,6
65,16,2,14,296,14,14
68,15,1,14,292,12,8
69,15,1,14,290,15,12
74,12,1,11,287,21,17
73,14,0,14,286,20,26
72,13,0,13,286,17,27
72,10,0,10,284,15,22
69,14,0,14,285,13,22
69,15,0,15,284,11,22
70,17,1,16,283,11,20
73,16,1,15,280,3,24
77,21,3,18,273,2,22
77,39,17,22,272,2,18
73,41,19,22,282,4,22
66,25,10,15,296,7,25
57,22,6,16,316,12,20
51,23,5,18,331,16,25
51,23,4,19,333,28,28
49,16,2,14,340,36,22
49,12,1,11,340,44,22
55,13,1,12,331,40,18
55,13,1,12,329,38,11
61,15,1,14,316,32,13
63,14,1,13,278,24,15
70,5,0,5,266,28,6
80,6,0,6,258,29,0
86,7,0,7,249,27,0
85,7,0,7,247,25,0
84,8,0,8,247,21,13
79,8,0,8,249,16,0
80,9,0,9,250,14,5
82,12,1,11,249,11,6
82,10,0,10,247,8,9
84,8,0,8,242,5,4
86,10,0,10,237,8,0
86,18,1,17,238,9,10
86,15,1,14,242,4,3
82,15,3,12,247,7,19
77,11,2,9,254,14,8
73,10,2,8,264,15,16
70,18,4,14,278,17,14
66,20,6,14,298,14,20
67,19,6,13,296,17,17
69,13,1,12,294,29,20
65,12,1,11,299,32,13
71,11,1,10,290,29,12
83,5,0,5,270,37,18
80,7,0,7,250,37,3
86,6,0,6,245,38,0
89,4,0,4,229,39,0
87,4,0,4,220,39,0
86,3,0,3,221,39,4
87,3,0,3,220,37,4
84,3,0,3,219,36,6
82,3,0,3,215,43,0
80,2,0,2,215,44,7
84,2,0,2,217,37,0
84,3,0,3,215,34,5
85,2,0,2,212,36,4
86,3,0,3,213,34,3
86,6,0,6,213,29,9
86,5,0,5,217,26,4
86,5,0,5,219,25,10
88,5,0,5,215,26,1
89,5,0,5,216,27,1
87,5,0,5,220,25,9
88,6,1,5,232,26,7
80,3,0,3,232,35,11
80,3,0,3,235,36,4
79,3,0,3,237,37,5
80,3,0,3,239,34,10
80,3,0,3,240,30,11
82,5,0,5,240,29,5
84,10,1,9,238,27,10
85,6,0,6,238,27,9
85,5,0,5,239,26,11
86,6,0,6,238,23,11
87,6,0,6,234,16,14
87,8,0,8,231,18,9
87,7,0,7,229,19,14
87,16.89797974,3.382421836,13.5155579,226,19,4
86,8,0,8,223,19,6
85,11,0,11,224,19,10
86,13,0,13,223,15,1
86,11,0,11,223,13,17
85,13,1,12,225,11,1
87,16,2,14,227,9,13
88,21,4,17,229,7,7
87,20,4,16,232,24.9199947,9
85,20,5,15,238,11,18
85,16.89708181,3.381742254,13.51533956,239,16,10
85,23,5,18,245,19,18
83,12,1,11,249,17,16
81,13,2,11,255,22,17
77,10,1,9,260,24,17
76,10,1,9,261,26,22
76,9,0,9,261,29,18
82,12,1,11,258,23,13
81,10,0,10,253,15,9
83,12,1,11,249,11,3
84,12,1,11,245,7,3
85,12,1,11,241,5,10
87,9,1,8,240,4,5
88,10,1,9,237,5,2
88,10,1,9,237,3,8
89,13,3,10,235,2,1
88,15,5,10,236,2,14
88,16,6,10,236,2,3
88,18,8,10,239,2,16
88,21,12,9,244,2,1
90,20,11,9,254,2,13
90,26,16,10,256,2,11
87,21,13,8,271,3,1
70,15,9,6,296,4,10
67,8,4,4,301,5,17
64,6,3,3,305,5,12
66,8,4,4,300,5,9
71,9,4,5,293,5,11
69,7,3,4,294,5,7
69,5,2,3,292,5,14
68,4,1,3,291,6,11
72,2,0,2,286,7,12
74,3,0,3,283,8,20
72,3,0,3,283,9,24
69,2,0,2,282,10,25
70,2,0,2,282,12,25
72,2,0,2,281,13,26
73,2,0,2,279,13,23
73,2,0,2,279,14,23
73,1,0,1,279,13,22
82,1,0,1,243,19,22
87,3,0,3,236,45,4
85,3,0,3,238,40,0
83,6,0,6,243,36,9
83,6,0,6,257,37,16
76,7,1,6,276,30,15
67,7,1,6,293,29,31
59,8,1,7,305,29,32
57,8,1,7,312,33,28
57,6,0,6,314,35,22
54,7,0,7,317,38,20
50,8,1,7,317,39,24
47,7,0,7,313,38,17
49,8,0,8,303,38,8
50,11,0,11,294,40,11
52,12,0,12,288,39,12
58,8,0,8,281,36,15
58,8,0,8,279,38,18
59,8,0,8,276,42,15
58,9,0,9,278,45,15
60,9,0,9,275,44,22
61,7,0,7,273,42,24
59,5,0,5,273,42,28
60,7,0,7,272,41,26
63,8,0,8,268,37,28
63,9,0,9,266,35,21
65,16,1,15,264,30,23
62,20,2,18,269,28,26
59,13,1,12,277,29,29
54,13,1,12,288,29,33
50,13,1,12,299,34,25
44,13,1,12,312,37,20
41,11,1,10,315,47,28
40,11,0,11,313,47,19
41,11,0,11,311,48,14
42,12,0,12,309,49,15
41,13,0,13,307,47,20
51,23,1,22,298,42,22
54,20,0,20,291,34,24
52,19,0,19,290,41,21
52,16,0,16,288,44,22
54,18,1,17,287,40,24
56,15,0,15,282,37,29
58,12,0,12,278,40,27
62,11,0,11,272,36,25
59,10,0,10,272,39,24
56,10,0,10,272,45,25
60,9,0,9,272,46,24
63,9,0,9,270,42,24
66,9,0,9,269,35,21
72,9,0,9,266,24,19
76,11,1,10,267,15,14
73,14,6,8,275,5,11
69,11,5,6,281,5,12
69,10,4,6,286,6,13
66,9,4,5,292,6,14
61,12,4,8,297,6,15
62,9,3,6,298,8,8
67,7,2,5,293,10,11
68,8,3,5,291,8,11
68,7,2,5,291,7,8
63,7,2,5,292,6,9
69,7,1,6,284,4,7
71,7,1,6,279,2,6
73,8,1,7,276,2,8
73,6,1,5,274,2,8
73,6,1,5,274,2,8
75,6,1,5,271,2,8
75,4,0,4,271,3,7
75,4,0,4,272,3,7
75,4,0,4,270,3,11
75,4,0,4,270,3,7
78,3,0,3,268,4,5
79,5,0,5,268,4,8
78,7,1,6,271,4,9
75,7,3,4,277,4,12
75,9,5,4,276,4,15
68,8,5,3,292,5,9
62,9,5,4,304,6,15
57,7,3,4,315,7,15
58,8,3,5,319,9,11
58,8,2,6,314,10,9
61,7,2,5,309,10,7
60,9,3,6,307,10,6
64,11,4,7,298,10,11
69,12,4,8,290,8,10
76,14,5,9,280,4,4
77,12,3,9,279,4,5
77,8,1,7,277,4,8
79,8,2,6,272,2,8
80,7,1,6,270,1,7
79,7,1,6,273,1,5
73,12,3,9,273,3,7
77,8,1,7,270,2,5
81,4,0,4,268,2,8
74,6,1,5,267,2,8
78,5,0,5,264,2,8
81,6,0,6,264,3,7
82,9,2,7,265,2,11
79,9,4,5,273,3,9
72,10,6,4,287,4,14
66,8,4,4,297,5,20
64,7,3,4,299,8,14
63,6,2,4,296,10,10
58,4,1,3,305,12,4
55,4,1,3,304,12,2
57,4,1,3,308,12,4
56,4,1,3,306,13,5
57,4,1,3,302,12,4
67,4,1,3,289,11,7
63,10,2,8,281,8,7
70,11,1,10,277,4,0
75,7,1,6,275,4,3
77,10,2,8,274,5,2
79,11,3,8,273,4,7
80,8,1,7,271,3,5
80,6,1,5,270,4,7
80,7,2,5,270,3,5
79,16.83987027,3.36983448,13.47003579,269,3,6
77,10,3,7,265,4,7
77,10,3,7,264,4,3
80,11,3,8,261,3,2
79,10,3,7,260,2,6
80,15,7,8,263,2,4
76,20,11,9,270,3,10
72,21,11,10,280,24.85398242,12.53360634
66,19,10,9,285,5,25
63,16.83899629,3.370956962,13.46803933,294,6,6
63,13,5,8,294,8,8
67,14,4,10,288,10,6
63,16,7,9,289,9,7
63,16,6,10,285,8,7
71,11,3,8,278,6,0
80,25,11,14,267,2,2
73,34,19,15,255,4,2
79,12,1,11,239,17,0
84,10,0,10,235,14,1
89,8,0,8,238,11,0
89,5,0,5,227,19,9
90,3,0,3,222,27,0
89,3,0,3,216,27,5
89,3,0,3,212,27,0
89,2,0,2,210,30,5
87,2,0,2,206,31,0
87,3,0,3,203,31,0
85,3,0,3,201,30,4
83,3,0,3,201,28,1
79,5,0,5,206,25,7
73,7,1,6,212,25,5
75,4,0,4,219,27,7
64,4,0,4,234,26,3
60,5,1,4,240,30,12
58,3,0,3,245,33,10
59,3,0,3,239,35,2
60,3,0,3,238,35,0
58,3,0,3,241,35,0
62,3,0,3,230,38,7
64,4,0,4,225,38,0
67,3,0,3,217,39,6
68,4,0,4,212,40,0
68,4,0,4,208,40,4
66,5,0,5,207,41,3
65,3,0,3,204,42,3
65,4,0,4,199,39,0
67,5,0,5,197,34,6
68,8,0,8,193,32,0
71,8,0,8,189,28,6
72,7,0,7,185,27,7
73,8,0,8,181,25,4
73,7,0,7,180,22,2
73,10,0,10,181,19,3
71,12,1,11,186,19,6
64,10,1,9,200,19,6
56,7,1,6,225,25,19
51,4,0,4,238,31,26
50,4,0,4,243,34,7
46,3,0,3,246,36,5
48,3,0,3,245,36,3
46,3,0,3,242,35,4
49,3,0,3,239,35,2
51,3,0,3,233,34,5
54,4,0,4,226,33,0
57,5,0,5,220,34,4
59,6,0,6,216,33,2
60,6,0,6,214,32,3
61,5,0,5,212,31,4
66,5,0,5,209,31,9
69,5,0,5,206,29,0
68,6,0,6,203,27,7
69,6,0,6,203,24,6
68,7,0,7,199,19,6
68,9,0,9,198,17,7
68,11,0,11,195,14,11
71,13,0,13,191,10,10
74,12,0,12,187,6,7
70,15,2,13,193,7,16
64,13,2,11,205,13,19
55,10,2,8,226,21,22
54,10,1,9,239,25,18
54,8,1,7,246,28,11
52,6,0,6,259,36,13
56,4,0,4,260,42,23
57,4,0,4,262,39,10
55,4,0,4,262,36,3
56,4,0,4,263,36,6
58,7,0,7,260,33,7
62,12,0,12,255,27,7
64,15,1,14,248,25,5
67,16,0,16,245,23,3
74,18,0,18,239,16,12
77,22,1,21,235,15,8
78,21,1,20,235,12,14
79,16,0,16,232,10,6
81,10,0,10,228,12,15
83,9,0,9,228,17,6
84,7,0,7,228,12,9
86,11,0,11,225,6,19
87,15,1,14,219,7,5
88,19,2,17,221,6,20
88,19,3,16,220,4,8
87,14,2,12,219,7,19
88,13,1,12,221,11,9
87,12,2,10,224,14,8
83,9,1,8,230,23,20
76,7,1,6,237,29,12
68,5,0,5,244,34,12
57,9,1,8,251,33,12
51,12,1,11,256,35,7
53,12,1,11,258,41,11
57,9,0,9,254,31,9
58,8,0,8,249,31,6
65,11,0,11,245,28,0
72,13,0,13,241,24,1
72,12,0,12,238,18,3
74,10,0,10,236,24,18
74,12,0,12,225,24,4
79,8,0,8,216,28,3
81,11,0,11,214,28,6
84,14,0,14,211,27,0
84,10,0,10,209,26,9
81,7,0,7,207,25,0
83,5,0,5,208,26,17
81,8,0,8,208,24,0
85,14,0,14,209,20,11
87,18,2,16,211,13,0
88,20,3,17,213,14,12
89,16,2,14,215,13,5
89,11,1,10,217,18,11
88,8,1,7,214,24,6
88,5,0,5,212,29,3
86,4,0,4,216,34,13
83,4,0,4,224,37,2
78,4,0,4,229,40,15
78,3,0,3,228,41,5
77,4,0,4,225,41,0
78,8,0,8,222,42,2
79,8,0,8,219,39,1
78,8,0,8,220,39,3
79,7,0,7,218,36,8
79,5,0,5,218,37,2
79,6,0,6,217,37,6
79,6,0,6,218,34,3
80,7,0,7,218,32,2
81,7,0,7,218,27,8
82,8,0,8,216,26,0
82,7,0,7,215,25,11
83,6,0,6,214,28,0
82,6,0,6,216,26,6
80,7,1,6,221,27,9
75,7,1,6,230,35,6
67,5,0,5,249,35,16
67,4,0,4,250,40,27
67,4,0,4,251,43,10
68,4,0,4,253,42,4
65,3,0,3,258,42,8
66,4,0,4,262,45,16
67,6,0,6,261,48,16
71,14,0,14,256,48,14
77,17,0,17,248,38,16
79,12,0,12,244,32,13
79,8,0,8,241,29,10
81,10,0,10,238,29,12
82,14,0,14,236,21,12
83,14,0,14,237,17,23
86,14,1,13,233,11,11
86,14,0,14,233,10,22
86,16.77802574,3.350907316,13.42711843,233,6,10
86,18,2,16,231,4,24
87,22,3,19,231,3,23
86,22,4,18,231,3,24
87,19,6,13,229,4,23
85,22,6,16,233,8,18
79,16,2,14,244,22,35
72,13,1,12,259,36,37
66,10,1,9,274,41,33
58,8,0,8,288,45,32
54,7,0,7,297,51,14
50,5,0,5,301,54,13
51,4,0,4,302,51,13
54,4,0,4,298,53,11
61,6,0,6,283,49,20
71,11,1,10,269,40,13
80,9,0,9,250,37,10
84,7,0,7,232,36,0
87,5,0,5,223,37,0
87,4,0,4,219,40,3
86,3,0,3,214,40,1
87,3,0,3,214,38,0
87,3,0,3,213,36,7
87,3,0,3,215,35,1
87,3,0,3,215,31,15
88,4,0,4,215,29,0
88,5,0,5,217,23,10
87,5,0,5,217,16,5
87,9,0,9,217,16,11
85,12,1,11,221,11,2
79,11,1,10,228,17,17
68,10,1,9,247,23,16
56,5,0,5,261,24.87133794,20
57,16.76650808,3.347287278,13.4192208,267,33,9
54,5,0,5,275,38,2
56,4,0,4,276,40,2
52,5,0,5,276,50,11
51,5,0,5,281,56,7
53,5,0,5,280,52,10
59,5,0,5,267,43,12
69,5,0,5,257,36,8
79,7,0,7,241,33,2
84,5,0,5,235,30,0
83,8,0,8,231,28,12
84,8,0,8,231,28,2
82,6,0,6,224,26,19
88,3,0,3,212,32,1
87,2,0,2,207,36,0
85,3,0,3,194,37,5
85,3,0,3,190,33,3
84,3,0,3,190,34,5
85,4,0,4,191,33,6
82,6,0,6,193,29,7
76,9,1,8,196,19,7
65,9,1,8,206,22,8
57,8,1,7,219,23,15
51,7,1,6,238,25,10
46,4,0,4,250,30,18
41,4,0,4,257,35,19
38,4,0,4,266,40,11
34,3,0,3,270,42,2
35,4,0,4,272,43,4
35,4,0,4,272,44,7
44,6,0,6,258,46,8
53,11,0,11,246,40,3
57,13,1,12,234,38,0
61,10,0,10,228,32,0
62,10,0,10,222,27,8
63,9,0,9,220,29,6
63,9,0,9,216,29,13
64,9,0,9,211,30,0
68,14,0,14,207,25,12
68,10,0,10,207,21,4
67,9,0,9,208,26,13
69,9,0,9,206,26,2
70,11,0,11,206,22,11
72,14,0,14,206,14,1
70,19,2,17,209,11,12
70,17,2,15,213,15,9
65,14,2,12,220,11,13
62,12,1,11,227,23,17
58,10,1,9,234,26,10
58,9,1,8,238,29,12
58,7,0,7,240,31,8
63,8,0,8,237,31,11
74,11,0,11,228,28,10
78,10,0,10,218,31,0
73,8,0,8,203,32,4
77,8,0,8,193,33,0
83,6,0,6,182,35,4
87,5,0,5,173,33,0
87,6,0,6,171,33,0
88,5,0,5,166,31,2
89,6,0,6,159,32,1
91,4,0,4,158,32,0
91,5,0,5,158,32,2
91,4,0,4,157,31,4
91,4,0,4,159,34,6
91,5,0,5,161,33,6
92,5,0,5,163,31,5
92,6,0,6,166,28,6
92,8,0,8,168,26,3
92,8,0,8,169,27,5
92,8,0,8,171,28,4
92,9,0,9,174,28,2
92,9,0,9,176,27,3
92,8,0,8,179,28,6
92,9,1,8,183,29,6
92,11,1,10,185,28,2
92,12,1,11,189,27,2
92,10,0,10,189,27,5
92,10,0,10,190,27,0
92,9,0,9,189,27,1
92,9,0,9,189,27,1
92,8,0,8,189,25,1
92,6,0,6,190,27,2
92,7,0,7,190,24,3
92,6,0,6,190,26,3
91,6,0,6,190,24,6
91,8,0,8,190,19,5
91,9,0,9,191,16,6
91,11,0,11,192,11,6
90,16,0,16,194,8,6
91,17,0,17,195,8,12
91,17,1,16,196,3,5
90,28,7,21,198,2,15
89,28,5,23,202,4,4
86,22,3,19,206,12,13
84,12,1,11,210,24,1
83,12,1,11,213,21,7
80,19,3,16,220,18,1
76,15,3,12,232,23,12
73,10,1,9,241,32,13
70,7,0,7,252,39,16
67,9,0,9,258,46,13
68,8,0,8,255,46,7
70,12,0,12,249,43,6
75,15,0,15,242,34,0
76,22,1,21,238,25,3
79,35,4,31,234,9,7
80,35,6,29,230,5,12
82,26,3,23,230,5,16
83,19,1,18,230,19,13
84,13,1,12,228,21,18
86,9,0,9,226,20,11
87,5,0,5,226,22,10
88,4,0,4,225,25,10
88,4,0,4,224,24,2
88,4,0,4,224,23,14
88,4,0,4,226,21,4
81,4,0,4,232,23,19
64,5,1,4,249,27,7
57,6,1,5,263,30,13
53,5,0,5,272,34,17
53,4,0,4,278,40,10
50,5,0,5,281,49,9
49,3,0,3,281,46,6
53,5,0,5,280,47,5
51,5,0,5,274,45,10
51,4,0,4,265,39,3
56,6,0,6,255,38,1
57,7,0,7,250,37,0
57,10,0,10,245,35,1
63,14,0,14,242,30,2
68,13,0,13,240,28,6
70,12,0,12,239,26,9
73,6,0,6,236,25,6
74,6,0,6,234,26,12
76,16.71901614,3.329419423,13.38959672,230,20,4
76,5,0,5,225,17,9
77,8,0,8,224,16,9
77,6,0,6,224,16,12
79,6,0,6,223,16,11
81,7,0,7,226,19,5
78,9,1,8,232,19,17
77,8,1,7,234,22,7
74,10,2,8,243,21,12
70,9,1,8,255,23,11
70,5,0,5,263,31,17
69,3,0,3,268,36,22
68,3,0,3,270,37,14
65,2,0,2,277,35,7
67,3,0,3,276,35,6
68,4,1,3,269,35,7
71,4,0,4,261,33,2
76,10,1,9,255,30,0
78,6,0,6,246,30,3
79,4,0,4,239,31,0
81,3,0,3,235,32,8
82,4,0,4,235,31,0
83,4,0,4,232,28,10
85,4,0,4,229,25,1
86,3,0,3,227,25,5
87,3,0,3,226,26,11
86,2,0,2,228,26,0
86,4,0,4,228,26,12
86,7,0,7,229,19,1
81,11,1,10,234,19,8
78,8,1,7,240,23,7
79,5,0,5,246,24,10
75,6,0,6,245,24.89652444,5
78,16.70253123,3.324940526,13.3775907,243,27,2
80,7,1,6,235,27,13
82,4,0,4,216,35,9
87,7,0,7,201,32,7
88,6,0,6,197,30,0
88,6,0,6,194,32,2
89,9,0,9,192,30,2
90,7,0,7,191,34,0
90,6,0,6,193,31,3
90,5,0,5,194,34,4
90,4,0,4,193,38,3
88,4,0,4,194,37,6
88,4,0,4,192,32,5
88,4,0,4,190,31,5
89,4,0,4,190,27,4
89,6,0,6,188,22,0
90,6,0,6,184,20,2
90,5,0,5,181,23,0
90,4,0,4,181,24,1
90,7,0,7,178,28,0
90,6,0,6,177,21,3
89,7,0,7,177,15,2
84,5,0,5,177,22,9
85,7,1,6,181,18,6
73,8,1,7,191,19,4
63,5,0,5,198,25,14
64,6,0,6,200,27,18
67,6,0,6,200,25,0
70,7,0,7,198,24,13
77,6,0,6,195,23,2
83,7,0,7,183,22,10
88,9,0,9,181,22,0
88,8,0,8,180,20,3
86,10,0,10,178,22,3
84,5,0,5,175,29,4
88,4,0,4,167,30,4
90,4,0,4,161,30,0
91,5,0,5,162,28,0
91,3,0,3,158,28,2
91,3,0,3,157,28,4
91,2,0,2,153,29,5
92,3,0,3,153,28,2
91,4,0,4,150,29,1
90,4,0,4,151,27,7
89,5,0,5,154,26,4
88,5,0,5,158,24,1
87,8,1,7,162,20,6
87,9,1,8,164,19,6
88,9,1,8,165,17,8
88,13,2,11,165,17,5
89,12,1,11,167,17,6
88,13,1,12,169,15,6
87,13,1,12,165,16,3
86,10,1,9,171,20,2
83,12,1,11,173,17,7
86,15,0,15,173,10,8
87,21,1,20,172,2,7
87,25,1,24,171,2,6
87,26,1,25,169,2,7
87,31,3,28,168,2,8
88,41,10,31,166,2,11
88,42,13,29,164,2,10
89,40,14,26,164,2,6
89,35,16,19,162,2,8
89,38,22,16,159,2,9
90,41,25,16,156,2,8
90,45,31,14,153,2,6
91,63,45,18,152,2,6
88,31,14,17,156,3,8
85,41,23,18,163,3,13
76,23,10,13,183,8,23
61,15,4,11,213,17,22
51,9,2,7,230,26,10
40,5,0,5,239,32,16
37,5,0,5,246,38,9
36,5,0,5,250,42,9
36,4,0,4,255,45,12
34,4,0,4,256,44,2
47,6,0,6,245,44,0
60,9,0,9,232,41,7
62,9,0,9,222,38,0
62,15,0,15,218,38,0
62,14,0,14,215,30,10
62,21,1,20,211,23,0
68,24,1,23,203,17,10
72,18,1,17,193,11,0
74,11,0,11,188,16,13
74,15,1,14,189,15,8
76,11,0,11,189,15,12
77,9,0,9,188,20,7
78,11,0,11,187,16,8
78,14,1,13,188,13,9
80,18,2,16,188,10,9
79,15,2,13,189,7,12
81,14,2,12,197,8,7
79,19,4,15,201,9,23
78,29,10,19,208,11,14
79,17,3,14,212,17,25
83,24,4,20,208,16,10
86,27,4,23,204,12,16
87,24,3,21,202,15,3
87,19,1,18,197,19,12
88,16,0,16,194,24,10
87,14,0,14,190,25,5
88,13,0,13,187,29,6
89,8,0,8,185,30,3
88,8,0,8,183,31,4
87,6,0,6,181,32,6
87,6,0,6,180,32,4
88,6,0,6,179,30,5
90,5,0,5,176,28,4
90,3,0,3,176,29,5
90,5,0,5,176,26,3
91,7,0,7,176,25,5
92,7,0,7,176,25,3
92,5,0,5,177,24,4
92,5,0,5,179,23,6
92,4,0,4,180,27,5
92,3,0,3,185,27,3
92,5,0,5,191,26,6
89,4,0,4,199,29,6
88,3,0,3,200,29,10
87,4,0,4,204,28,12
83,4,0,4,211,28,9
86,4,0,4,209,32,12
89,6,0,6,208,29,0
90,6,0,6,207,26,11
92,6,0,6,209,24,0
93,12,1,11,219,20,10
92,8,1,7,236,15,2
83,4,0,4,258,7,17
80,2,0,2,265,10,6
83,2,0,2,259,12,19
86,2,0,2,255,14,4
87,2,0,2,245,18,4
79,16.67071727,3.317842364,13.35287491,250,29,5
67,16.67071727,3.317842364,13.35287491,257,28,27
64,2,0,2,257,28,9
64,3,0,3,259,24,16
61,5,0,5,261,21,4
59,9,1,8,264,14,6
61,12,2,10,266,17,9
56,12,2,10,281,20,23
49,12,2,10,297,24.87740109,13
49,16.66790297,3.317102245,13.35080073,293,27,3
46,10,1,9,298,36,6
37,11,1,10,311,35,7
41,6,0,6,297,35,9
39,9,1,8,297,35,5
43,10,1,9,282,38,9
44,14,1,13,268,43,13
47,13,0,13,256,43,18
43,14,0,14,256,45,4
43,14,0,14,251,44,6
46,15,0,15,245,41,13
64,19,0,19,231,28,15
62,15,1,14,218,22,14
60,8,0,8,213,25,3
51,5,0,5,212,31,14
42,5,0,5,208,32,3
39,5,0,5,211,36,9
43,6,0,6,205,35,6
49,7,0,7,197,29,7
55,12,0,12,190,13,8
50,24,4,20,193,6,8
44,26,5,21,209,18,19
42,13,2,11,230,25,14
32,9,1,8,244,32,28
30,6,0,6,250,34,18
27,6,0,6,258,40,15
25,5,0,5,266,42,4
27,5,0,5,270,54,5
24,6,0,6,274,59,8
39,6,0,6,266,59,10
37,5,0,5,255,42,15
43,9,0,9,246,42,8
59,12,1,11,236,39,1
58,9,0,9,231,46,2
59,10,0,10,228,43,14
58,13,0,13,226,35,13
60,21,1,20,223,28,19
64,24,1,23,216,21,8
71,21,1,20,209,14,22
75,17,1,16,204,16,5
76,14,0,14,195,15,17
74,14,0,14,191,13,5
69,13,0,13,191,10,14
68,17,1,16,190,11,11
67,21,3,18,193,10,11
65,23,5,18,200,12,10
64,22,5,17,208,16,15
60,20,4,16,221,21,23
59,14,2,12,228,30,15
59,10,1,9,232,32,19
60,8,0,8,233,39,12
60,6,0,6,234,41,14
62,5,0,5,231,40,8
63,6,0,6,230,41,7
66,6,0,6,228,38,12
70,9,0,9,222,38,10
73,14,1,13,218,34,3
76,8,0,8,214,32,18
76,8,0,8,210,35,0
76,7,0,7,208,35,10
76,6,0,6,206,34,0
75,5,0,5,205,34,13
76,7,0,7,202,29,1
76,9,0,9,199,25,11
75,8,0,8,199,27,1
75,7,0,7,198,29,13
75,7,0,7,196,24,4
66,9,0,9,195,23,9
64,13,1,12,197,24,7
59,12,1,11,202,21,14
59,9,1,8,208,24,14
57,8,1,7,214,25,11
55,7,1,6,216,28,12
58,6,0,6,215,30,10
58,6,0,6,213,33,5
59,6,0,6,216,32,10
54,5,0,5,216,35,5
59,4,0,4,216,35,11
62,5,0,5,214,37,2
67,6,0,6,212,36,7
70,12,1,11,211,34,10
74,8,0,8,207,31,4
73,8,0,8,205,29,16
73,9,0,9,203,23,5
73,9,0,9,199,18,18
72,10,0,10,197,18,9
73,10,0,10,197,18,18
74,10,0,10,195,19,14
74,9,0,9,194,18,13
75,9,0,9,192,18,1
77,10,0,10,190,18,12
86,9,0,9,183,19,10
88,10,0,10,184,22,5
89,8,0,8,183,29,5
89,7,0,7,183,34,2
88,11,1,10,184,32,4
85,9,1,8,190,31,5
78,8,1,7,196,31,11
78,8,0,8,198,32,13
81,8,0,8,198,33,13
81,9,0,9,196,32,9
80,9,0,9,199,30,9
83,10,0,10,196,28,7
88,14,0,14,190,27,10
89,12,0,12,190,26,9
90,12,0,12,189,27,12
91,11,0,11,190,25,8
91,10,0,10,189,20,10
91,8,0,8,190,20,6
91,9,0,9,190,19,8
91,11,0,11,190,17,11
91,10,0,10,189,13,13
91,9,0,9,190,10,12
91,10,0,10,189,10,13
92,10,0,10,188,10,11
91,11,0,11,190,8,14
90,14,1,13,192,6,15
88,13,2,11,199,7,18
84,13,2,11,210,12,32
81,16,3,13,227,14,18
74,21,4,17,254,22,24
69,18,3,15,274,24,21
69,10,1,9,280,31,15
66,8,1,7,286,32,9
67,7,1,6,280,25,6
70,8,1,7,276,24,6
75,9,1,8,265,24,9
79,12,0,12,258,22,4
83,14,1,13,254,14,2
84,7,0,7,254,15,4
85,6,0,6,253,11,10
86,6,0,6,250,11,10
86,5,0,5,251,13,11
86,6,0,6,254,16,5
85,4,0,4,254,15,16
76,6,0,6,256,12,4
70,6,0,6,260,17,14
70,4,0,4,258,20,5
69,4,0,4,259,23,10
69,6,0,6,259,26,8
70,10,1,9,261,23,13
64,9,1,8,272,22,16
57,7,1,6,290,23,23
53,6,1,5,303,27,22
47,4,0,4,315,29,15
41,4,0,4,322,31,15
40,3,0,3,322,33,12
37,3,0,3,326,37,9
34,3,0,3,323,35,6
34,2,0,2,319,34,4
36,3,0,3,306,35,0
40,9,0,9,292,32,0
61,11,1,10,276,37,2
63,5,0,5,262,44,10
67,6,0,6,254,40,5
64,5,0,5,250,35,9
61,4,0,4,245,34,5
64,3,0,3,242,36,6
63,3,0,3,239,34,0
61,16.61679439,3.296989833,13.31980456,236,38,0
62,3,0,3,232,40,3
63,2,0,2,230,38,0
65,3,0,3,227,36,9
65,4,0,4,225,37,0
65,4,0,4,224,37,1
64,3,0,3,224,38,3
74,5,0,5,218,39,10
72,4,0,4,220,38,0
65,5,0,5,226,37,14
59,4,0,4,232,38,5
57,3,0,3,230,40,12
57,3,0,3,233,41,0
55,3,0,3,235,40,8
56,2,0,2,231,41,9
59,3,0,3,226,41,4
61,4,0,4,220,40,0
62,5,0,5,214,37,3
63,15,2,13,210,34,2
63,11,0,11,209,32,7
66,10,0,10,207,28,6
65,7,0,7,206,25,4
68,7,0,7,201,30,12
70,7,0,7,196,27,0
73,9,0,9,192,23,7
73,9,0,9,191,20,4
75,11,0,11,187,15,10
76,18,0,18,184,7,10
77,20,1,19,182,8,11
77,29,7,22,186,4,11
73,20,4,16,204,8,15
66,8,1,7,224,18,23
62,8,1,7,233,24.90477939,19
56,16.60400894,3.292942457,13.31106648,247,28,5
53,4,0,4,254,33,22
54,4,0,4,251,37,33
55,4,0,4,254,37,15
54,3,0,3,257,38,3
53,3,0,3,253,37,9
58,5,0,5,242,36,7
66,11,1,10,232,34,2
71,14,1,13,225,31,0
74,11,0,11,220,25,7
77,12,0,12,215,22,2
78,11,0,11,212,24,10
80,11,0,11,208,23,7
82,10,0,10,205,22,9
82,10,0,10,203,18,7
83,11,0,11,197,12,8
84,15,0,15,194,8,8
84,17,1,16,191,8,11
85,19,1,18,188,4,11
86,25,5,20,187,2,13
86,23,5,18,191,4,15
81,17,4,13,203,11,17
68,9,2,7,228,21,28
57,5,1,4,242,28,12
52,4,0,4,246,32,14
49,4,0,4,254,35,12
49,4,0,4,261,38,18
48,5,0,5,266,43,13
46,7,0,7,264,48,9
53,8,0,8,261,46,7
59,9,0,9,249,36,12
65,13,1,12,236,31,0
70,12,1,11,228,28,0
72,9,0,9,225,27,7
74,8,0,8,221,25,4
76,6,0,6,219,27,16
78,6,0,6,218,27,0
85,4,0,4,212,27,14
87,5,0,5,211,24,0
87,4,0,4,209,22,12
87,4,0,4,207,18,0
87,6,0,6,206,14,4
88,9,0,9,203,11,10
87,13,1,12,203,8,7
87,16,2,14,206,8,11
85,15,2,13,205,7,12
84,19,4,15,207,10,5
84,17,4,13,212,11,14
83,14,3,11,218,11,17
83,9,1,8,221,14,13
84,7,1,6,222,17,13
83,7,1,6,225,19,11
83,7,1,6,227,19,8
83,6,1,5,229,19,20
83,9,1,8,225,21,4
84,9,1,8,221,22,5
85,9,1,8,216,24,6
85,6,0,6,215,24,1
86,7,0,7,215,20,16
87,6,0,6,216,14,3
87,8,0,8,215,12,12
87,9,0,9,217,11,10
86,8,0,8,213,14,17
84,5,0,5,199,14,5
85,9,0,9,195,13,9
86,9,0,9,194,14,0
88,8,0,8,191,16,6
88,9,0,9,193,14,4
86,11,0,11,193,16,6
85,15,2,13,197,15,7
82,14,2,12,199,12,9
77,16,3,13,198,16,3
74,15,3,12,208,18,0
71,14,2,12,212,20,9
66,7,1,6,209,24,13
61,5,0,5,207,25,0
62,5,0,5,207,26,0
61,7,0,7,205,25,4
67,7,0,7,205,24,0
64,8,0,8,199,24,2
61,11,1,10,194,28,0
61,7,0,7,194,29,3
63,8,0,8,191,28,0
63,6,0,6,189,28,4
55,7,0,7,181,22,4
55,6,0,6,179,24,9
52,6,0,6,178,23,5
51,5,0,5,176,25,6
52,4,0,4,174,26,4
51,4,0,4,173,26,3
53,5,0,5,172,24,4
55,6,0,6,169,21,6
60,8,0,8,169,12,2
60,10,1,9,171,13,5
50,9,1,8,176,17,8
54,8,1,7,179,18,10
52,10,1,9,179,20,9
53,11,1,10,179,20,6
70,8,1,7,172,23,6
63,6,0,6,178,26,8
62,5,0,5,186,26,8
54,4,0,4,187,29,15
55,5,0,5,181,35,17
57,9,1,8,177,34,0
57,7,0,7,173,34,5
58,7,0,7,170,31,4
57,9,0,9,169,27,5
59,8,0,8,169,26,10
65,7,0,7,162,24,6
67,9,0,9,159,22,2
75,9,0,9,154,22,7
77,6,0,6,151,22,4
82,6,0,6,146,18,6
85,6,0,6,144,20,7
87,5,0,5,139,20,6
88,6,0,6,139,20,4
87,6,0,6,136,20,5
86,5,0,5,143,23,5
81,6,1,5,153,22,8
74,6,1,5,163,23,11
68,6,1,5,172,24,14
65,6,1,5,182,28,13
63,5,1,4,189,30,18
64,4,0,4,188,33,19
64,4,0,4,191,34,0
64,4,0,4,192,35,22
68,4,0,4,186,34,6
69,10,1,9,184,30,10
72,12,1,11,181,27,2
73,11,0,11,180,25,10
75,10,0,10,177,24,6
74,11,0,11,176,24,4
74,11,0,11,176,23,6
76,10,0,10,175,20,6
76,10,0,10,172,19,6
77,16.55524553,3.27648085,13.27876468,170,19,6
78,8,0,8,167,15,3
78,12,0,12,168,15,6
77,13,0,13,166,8,7
78,13,0,13,163,10,6
78,21,2,19,163,6,8
78,26,6,20,168,6,8
70,22,5,17,180,9,14
64,11,2,9,189,24.88728452,12.36461549
60,16.5549561,3.275977128,13.27897898,200,26,0
52,7,1,6,209,31,25
56,6,0,6,206,34,16
56,7,0,7,207,34,0
57,7,0,7,205,34,8
61,7,0,7,200,33,1
69,11,1,10,196,29,14
68,14,1,13,191,28,0
72,14,1,13,186,28,10
75,13,0,13,183,27,8
74,15,0,15,182,24,3
74,13,0,13,180,23,11
75,12,0,12,179,23,10
77,11,0,11,175,18,9
79,12,0,12,173,13,11
80,12,0,12,167,8,9
81,15,0,15,165,9,13
83,21,1,20,163,3,18
84,29,6,23,162,2,19
84,30,8,22,155,2,19
83,38,18,20,158,3,17
80,34,14,20,166,3,19
73,27,10,17,176,7,24
66,21,6,15,184,12,24
58,12,2,10,198,17,23
54,10,1,9,207,27,21
55,9,0,9,214,33,26
54,7,0,7,214,41,18
55,7,0,7,213,44,13
56,6,0,6,211,42,18
63,8,0,8,206,36,6
70,11,1,10,198,32,10
73,11,1,10,194,30,8
74,9,0,9,190,31,11
74,9,0,9,187,28,5
74,10,0,10,184,28,7
75,9,0,9,181,25,8
76,10,0,10,180,20,7
79,14,0,14,177,10,15
80,12,0,12,170,10,19
76,12,0,12,165,8,13
79,12,0,12,162,10,10
83,15,0,15,160,5,12
82,18,1,17,155,3,13
80,20,4,16,158,5,11
74,21,7,14,166,9,15
73,23,8,15,173,9,18
68,19,6,13,196,13,22
60,9,1,8,206,23,32
52,7,1,6,216,30,26
51,6,0,6,218,36,14
52,5,0,5,216,34,10
53,5,0,5,212,33,7
55,6,0,6,203,30,1
64,7,0,7,196,32,5
63,5,0,5,190,33,3
61,10,1,9,186,34,5
63,6,0,6,179,35,3
64,7,0,7,177,34,5
65,7,0,7,175,32,6
67,8,0,8,170,28,8
69,10,0,10,165,24,5
68,8,0,8,162,25,5
68,7,0,7,158,24,6
70,10,0,10,152,18,4
71,14,0,14,148,13,6
75,19,0,19,142,8,6
77,21,2,19,138,2,9
77,28,10,18,136,3,14
72,23,8,15,148,5,10
63,11,2,9,170,12,18
58,10,2,8,187,19,27
53,7,1,6,200,25,28
50,6,1,5,204,29,13
52,4,0,4,202,33,5
52,4,0,4,207,33,0
50,4,0,4,207,35,14
55,4,0,4,203,36,4
60,5,0,5,189,35,4
64,8,1,7,180,35,0
66,9,0,9,174,33,2
66,10,0,10,169,32,3
68,7,0,7,164,32,4
68,8,0,8,161,30,2
68,10,0,10,159,26,6
67,8,0,8,158,26,7
70,7,0,7,152,22,6
68,10,0,10,149,21,7
64,9,0,9,150,22,6
71,7,0,7,146,15,8
71,10,0,10,145,7,13
70,15,0,15,139,8,13
68,14,1,13,142,12,6
70,17,3,14,146,14,5
65,16,4,12,163,16,12
62,13,3,10,181,20,15
61,11,2,9,186,23,19
58,11,1,10,197,25,5
59,6,0,6,198,27,23
55,4,0,4,202,32,1
52,3,0,3,201,33,16
55,4,0,4,194,34,0
67,6,0,6,181,31,3
72,8,0,8,175,29,0
75,12,1,11,172,27,2
78,10,1,9,169,25,3
79,9,0,9,166,20,3
79,14,0,14,162,14,6
82,14,0,14,158,12,9
80,13,0,13,153,11,10
80,21,1,20,149,11,6
82,13,0,13,144,5,11
83,12,0,12,143,3,9
84,13,0,13,146,6,10
86,12,0,12,146,5,10
84,15,1,14,142,4,11
86,18,4,14,141,4,10
76,11,3,8,153,9,10
62.6362124,10,2,8,178.5080172,24.86884067,12.35357578
62.6362124,8,2,6,178.5080172,24.86884067,12.35357578
62.6362124,7,1,6,178.5080172,24.86884067,12.35357578
62.6362124,4,0,4,178.5080172,24.86884067,12.35357578
62.6362124,4,0,4,178.5080172,24.86884067,12.35357578
62.6362124,4,0,4,178.5080172,24.86884067,12.35357578
62.6362124,4,0,4,178.5080172,24.86884067,0
48,4,0,4,209,39,8
50,6,0,6,196,38,32
66,11,1,10,176,36,7
80,9,0,9,154,35,0
82,7,0,7,155,34,0
80,10,0,10,154,27,0
73,11,0,11,157,24,4
65,9,0,9,155,26,1
65,6,0,6,149,26,4
62,3,0,3,145,27,2
64,3,0,3,140,28,0
63,3,0,3,136,27,2
64,3,0,3,132,28,1
65,3,0,3,127,27,5
67,4,0,4,122,24,5
64,5,0,5,124,23,2
55,5,1,4,143,23,7
43,3,0,3,167,29,16
40,3,0,3,184,33,17
37,3,0,3,196,34,13
33,3,0,3,203,35,19
33,3,0,3,207,39,9
28,2,0,2,215,40,17
27,2,0,2,217,41,18
30,3,0,3,211,40,14
37,5,0,5,196,40,1
44,8,0,8,183,37,0
51,18,2,16,173,34,0
54,16,0,16,167,30,6
57,16,0,16,160,30,7
58,21,1,20,156,26,8
60,18,0,18,154,16,9
61,18,0,18,148,9,10
66,15,0,15,140,15,9
69,16.51281474,3.26015858,13.25265615,135,12,9
72,15,0,15,131,10,11
74,18,0,18,123,6,14
75,21,2,19,121,2,10
73,21,3,18,118,2,11
73,29,11,18,118,3,12
66,33,15,18,131,6,18
59,30,13,17,154,11,23
49,22,7,15,189,24.87006737,31
46,14,3,11,199,28,33
42,16.5152397,3.261258084,13.25398161,206,32,22
34,5,0,5,211,37,11
33,5,0,5,216,42,17
32,4,0,4,219,45,14
30,4,0,4,211,42,9
41,7,0,7,198,41,4
48,12,1,11,185,38,0
56,15,1,14,173,35,2
60,14,0,14,168,33,5
61,16,1,15,161,34,8
61,15,0,15,156,33,10
61,13,0,13,151,30,10
62,14,0,14,149,25,11
65,13,0,13,144,17,10
67,15,0,15,137,15,13
69,16,0,16,134,16,15
70,14,0,14,132,13,14
70,17,0,17,132,11,18
68,23,1,22,132,6,18
69,23,3,20,130,9,16
65,22,3,19,136,9,15
72,25,4,21,136,8,17
85,26,5,21,129,11,17
88,22,4,18,130,13,16
89,22,3,19,137,13,13
88,15,2,13,140,15,17
86,12,1,11,144,17,20
84,13,1,12,149,26,13
83,13,1,12,153,25,14
84,16,1,15,150,20,14
85,20,1,19,148,13,14
86,21,1,20,149,10,15
85,18,1,17,148,12,8
84,18,1,17,148,15,12
83,17,1,16,151,14,10
81,15,0,15,153,10,10
81,15,0,15,155,13,13
80,11,0,11,152,18,14
87,9,0,9,143,16,14
88,7,0,7,143,19,9
88,6,0,6,143,22,9
88,8,0,8,144,17,10
88,12,0,12,142,7,9
88,17,1,16,145,3,9
86,20,3,17,149,11,8
83,22,5,17,160,10,12
79,19,4,15,168,10,16
69,19,6,13,194,17,14
65,12,2,10,206,24,32
63,9,1,8,213,28,28
60,6,0,6,221,33,8
58,5,0,5,225,35,13
59,6,0,6,220,36,17
67,9,0,9,208,32,11
72,13,1,12,197,32,0
72,15,1,14,193,32,0
70,8,0,8,187,33,7
65,10,0,10,178,34,5
61,10,0,10,172,33,5
62,11,0,11,165,30,8
62,11,0,11,164,29,9
64,10,0,10,163,25,13
69,13,0,13,158,11,10
69,14,0,14,155,14,10
66,10,0,10,151,15,13
69,11,0,11,147,16,12
70,14,0,14,142,10,12
69,26,2,24,144,4,12
62,22,2,20,157,10,18
49,11,1,10,183,27,38
43,7,1,6,201,31,42
39,5,0,5,211,34,14
37,5,0,5,214,41,22
37,4,0,4,215,45,20
37,4,0,4,222,47,20
35,5,0,5,222,48,17
39,6,0,6,216,48,16
49,7,0,7,201,45,9
56,14,1,13,187,40,0
60,12,0,12,176,37,6
62,12,0,12,171,36,11
64,13,0,13,167,33,13
67,13,0,13,163,32,15
68,15,0,15,159,28,17
71,12,0,12,158,28,16
71,10,0,10,157,24,19
69,10,0,10,152,24,19
67,13,0,13,147,21,19
66,11,0,11,148,17,16
68,16,0,16,149,12,18
70,23,1,22,148,7,20
66,26,3,23,147,7,17
62,20,3,17,155,8,18
58,13,2,11,165,16,24
55,13,2,11,181,20,30
53,9,1,8,194,27,31
50,7,1,6,206,33,21
47,7,0,7,208,39,17
44,6,0,6,213,42,21
45,6,0,6,210,40,18
47,6,0,6,209,41,5
47,9,0,9,205,38,17
50,13,0,13,201,31,10
52,19,0,19,197,26,10
54,21,0,21,192,23,17
55,24,1,23,189,22,19
59,26,2,24,187,19,18
62,20,0,20,189,16,20
65,19,0,19,192,19,17
68,15,0,15,192,24,20
79,17,0,17,184,30,11
85,16,0,16,179,28,7
87,10,0,10,178,23,5
88,12,0,12,178,18,7
89,14,0,14,175,14,8
90,17,1,16,172,2,14
89,21,2,19,176,6,6
89,33,8,25,170,3,16
89,64,32,32,173,3,21
81,63,30,33,200,7,24
69,23,5,18,217,20,42
76,21,5,16,194,13,22
73,23,4,19,210,17,4
68,14,2,12,225,22,38
67,10,1,9,230,30,25
71,11,0,11,222,27,2
75,16,0,16,205,26,0
78,17,1,16,199,30,12
80,17,0,17,194,24,17
84,20,1,19,189,17,19
68,7,0,7,185,22,17
66,4,0,4,182,26,4
67,4,0,4,180,26,5
66,4,0,4,176,24,3
66,3,0,3,169,26,4
69,4,0,4,163,19,1
70,7,0,7,156,17,4
69,6,0,6,151,13,1
69,8,0,8,150,11,3
66,8,0,8,149,12,8
61,9,1,8,152,16,7
59,8,1,7,160,19,10
56,8,1,7,172,20,12
56,6,1,5,183,24,15
54,6,1,5,187,29,18
52,4,0,4,198,32,22
54,4,0,4,196,36,8
55,4,0,4,196,36,5
56,3,0,3,194,37,3
53,4,0,4,184,37,15
55,11,1,10,176,34,0
58,21,2,19,171,28,4
61,17,0,17,169,28,7
64,17,1,16,166,24,7
66,21,1,20,167,18,10
68,22,1,21,167,18,8
70,24,1,23,163,16,10
73,24,2,22,160,18,6
77,16.49624954,3.247000058,13.24924949,156,17,8
69,17,1,16,158,16,10
78,11,0,11,149,4,11
79,12,0,12,141,2,13
81,43,18,25,130,2,11
79,35,14,21,137,2,8
74,39,19,20,148,5,17
63,28,10,18,169,12,33
43,11,2,9,199,24.85327892,40
33,16.49908348,3.248682983,13.2504005,211,31,25
35,8,1,7,217,34,17
33,11,1,10,222,37,14
41,30,3,27,217,36,16
36,19,1,18,220,40,10
40,15,1,14,212,42,14
46,16,0,16,203,40,10
51,25,1,24,196,29,0
53,39,3,36,186,20,0
57,20,1,19,179,31,16
63,10,0,10,171,38,14
65,8,0,8,164,27,4
63,7,0,7,157,23,2
65,8,0,8,144,16,5
64,11,0,11,140,17,2
63,11,0,11,140,15,1
62,11,0,11,143,9,5
64,17,0,17,143,5,7
68,27,3,24,136,2,7
68,33,10,23,132,2,9
69,37,15,22,132,3,6
64,28,9,19,145,4,14
60,34,12,22,159,6,28
49,42,16,26,184,10,31
42,39,11,28,202,17,29
32,22,4,18,214,30,19
31,9,1,8,221,40,17
29,7,0,7,227,44,20
27,7,0,7,228,49,17
32,11,0,11,219,44,10
36,19,0,19,212,44,4
45,23,1,22,205,29,0
46,27,1,26,200,19,1
48,31,1,30,186,21,8
60,14,0,14,176,27,6
54,7,0,7,172,31,11
49,7,0,7,164,23,1
51,8,0,8,159,19,1
48,7,0,7,149,16,1
50,12,0,12,142,16,0
51,12,0,12,137,12,0
51,12,0,12,135,10,1
53,21,1,20,131,7,3
51,29,2,27,128,3,2
50,31,5,26,127,3,1
46,26,5,21,133,5,4
39,25,6,19,150,13,8
30,18,3,15,166,19,12
28,9,1,8,181,25,9
26,8,1,7,186,28,10
28,8,1,7,190,32,12
23,5,0,5,200,35,22
22,5,0,5,199,36,11
25,7,0,7,193,34,2
26,10,0,10,185,29,5
31,16,0,16,176,24,0
33,19,0,19,166,16,7
35,23,1,22,157,20,0
37,23,1,22,151,19,3
37,17,0,17,144,12,3
40,12,0,12,137,15,3
42,9,0,9,131,21,4
42,8,0,8,126,22,4
42,9,0,9,125,23,1
43,6,0,6,122,24,0
42,6,0,6,124,24,0
43,9,0,9,122,22,1
44,10,0,10,118,12,1
47,14,1,13,115,5,1
41,17,3,14,134,10,7
38,18,4,14,153,16,16
32,17,4,13,170,21,26
33,13,3,10,178,24,15
28,8,1,7,187,28,9
31,8,1,7,186,34,0
30,6,0,6,188,36,7
25,5,0,5,193,37,11
25,6,0,6,187,37,7
35,7,0,7,173,34,2
36,20,2,18,164,31,0
43,25,1,24,156,24,1
45,25,1,24,157,15,6
47,31,1,30,158,16,8
48,26,1,25,146,15,7
52,11,0,11,133,22,6
56,10,0,10,125,24,2
59,9,0,9,122,18,2
59,11,0,11,119,14,7
57,15,0,15,115,14,8
58,19,0,19,111,13,8
59,22,1,21,106,8,7
61,22,1,21,103,5,7
62,33,7,26,101,2,7
51,30,9,21,119,6,12
50,25,7,18,132,12,19
40,22,6,16,156,14,27
35,19,4,15,176,25,25
34,7,1,6,180,27,26
33,6,0,6,184,33,11
32,5,0,5,189,41,10
29,4,0,4,193,44,8
31,5,0,5,186,42,10
36,8,0,8,177,39,5
44,19,1,18,168,31,0
49,26,1,25,159,22,3
50,24,1,23,154,17,4
52,31,1,30,150,15,4
52,34,2,32,149,18,5
54,33,2,31,144,19,7
53,29,1,28,143,17,7
57,30,2,28,137,12,9
66,26,2,24,123,5,10
69,30,4,26,114,2,7
72,26,2,24,108,2,16
73,23,1,22,106,3,18
73,23,2,21,103,2,15
72,25,6,19,102,4,16
67,26,9,17,116,8,17
59,23,8,15,137,13,23
50,17,5,12,164,21,28
44,12,2,10,187,29,31
44,9,1,8,192,36,29
42,8,1,7,194,42,11
39,6,0,6,194,47,8
36,5,0,5,198,47,3
44,6,0,6,194,46,8
51,7,0,7,185,39,0
52,10,0,10,177,35,3
54,17,1,16,170,29,0
57,25,1,24,162,25,6
58,28,1,27,157,22,8
58,30,1,29,157,22,11
59,24,1,23,155,26,13
60,26,1,25,154,17,14
64,24,1,23,149,10,16
69,23,1,22,142,3,13
72,18,0,18,134,8,16
70,14,0,14,132,10,20
65,13,0,13,134,12,25
64,13,1,12,134,15,23
62,12,1,11,136,16,20
63,11,1,10,140,19,21
61,13,2,11,146,18,24
56,12,2,10,157,24,27
55,10,1,9,164,29,33
54,9,0,9,169,30,33
56,11,0,11,168,30,27
56,12,1,11,175,34,27
57,9,0,9,178,39,25
62,11,0,11,174,39,29
65,16,1,15,171,37,26
73,18,0,18,163,33,30
76,18,0,18,160,30,39
74,21,1,20,161,30,47
80,17,0,17,156,29,40
81,17,1,16,156,25,37
82,14,0,14,156,23,33
83,11,0,11,156,25,29
83,8,0,8,155,26,23
83,16.50106761,3.23737494,13.26369267,154,26,21
84,7,0,7,153,24,28
84,8,0,8,153,21,26
88,10,0,10,152,18,24
89,15,1,14,151,14,18
89,23,3,20,153,5,21
89,22,5,17,161,6,23
85,23,6,17,170,8,27
73,18,4,14,192,24.83375001,21
67,15,3,12,204,24.83375001,33
65,11,1,10,210,27,26
62,9,1,8,219,34,18
61,16.50016659,3.236864897,13.26330169,221,39,13
58,6,0,6,224,38,7
64,10,0,10,220,34,5
68,14,1,13,213,30,0
73,16,0,16,207,24,7
71,23,1,22,204,20,5
71,21,1,20,203,19,20
72,21,1,20,200,13,7
72,23,2,21,197,11,18
74,22,1,21,193,12,5
76,17,1,16,189,11,13
80,11,0,11,182,12,2
82,10,0,10,176,13,7
85,10,0,10,173,10,5
86,11,0,11,173,10,8
87,11,0,11,174,11,13
87,13,1,12,174,8,11
87,16,2,14,175,8,12
86,15,3,12,182,10,11
84,12,2,10,191,12,12
79,13,3,10,203,13,23
78,13,2,11,202,10,24
86,29,7,22,193,6,6
90,31,7,24,183,3,16
91,32,8,24,179,3,8
91,35,11,24,181,3,8
90,26,5,21,174,13,5
90,18,1,17,175,15,4
90,18,1,17,176,10,7
90,12,0,12,176,12,9
90,9,0,9,173,22,5
90,9,0,9,171,19,2
90,9,0,9,171,18,6
90,8,0,8,170,17,4
90,7,0,7,168,14,5
89,6,0,6,164,15,4
88,7,0,7,162,17,3
89,8,0,8,160,11,4
88,11,0,11,158,6,6
87,16,1,15,157,6,6
86,15,1,14,156,7,9
83,21,3,18,157,4,9
80,15,2,13,161,6,8
70,11,2,9,168,14,12
56,11,2,9,187,21,11
48,8,1,7,193,26,20
47,7,1,6,195,31,7
43,4,0,4,192,40,10
41,5,0,5,196,43,2
39,5,0,5,198,43,11
45,4,0,4,187,42,24
43,5,0,5,179,40,0
48,11,1,10,171,35,3
49,15,1,14,165,30,3
52,15,0,15,162,26,5
62,14,0,14,156,28,8
63,10,0,10,154,31,7
61,7,0,7,151,32,7
61,10,0,10,144,26,10
66,11,0,11,141,20,11
67,11,0,11,141,20,13
67,8,0,8,138,21,14
71,9,0,9,133,20,14
74,10,0,10,130,17,15
75,11,0,11,127,17,12
76,14,1,13,128,14,12
73,16,2,14,138,16,15
67,13,2,11,161,19,23
59,9,1,8,185,25,27
55,8,1,7,196,32,34
54,5,0,5,198,35,34
49,5,0,5,202,40,18
50,4,0,4,201,43,12
55,4,0,4,199,43,2
59,4,0,4,191,41,13
64,7,0,7,183,39,2
66,11,1,10,181,35,9
66,8,0,8,178,35,10
67,9,0,9,177,32,11
67,8,0,8,176,33,10
71,6,0,6,172,28,9
74,10,0,10,166,25,10
76,10,0,10,162,22,8
84,9,0,9,153,19,15
88,10,0,10,147,16,12
88,8,0,8,145,18,7
89,6,0,6,145,22,11
90,6,0,6,145,24,9
89,8,0,8,145,22,11
90,11,0,11,146,16,11
90,12,1,11,147,10,13
88,19,3,16,151,6,16
86,23,5,18,153,6,20
86,23,6,17,157,7,18
83,22,6,16,165,12,17
82,22,5,17,170,19,20
83,18,2,16,169,15,21
86,19,1,18,168,8,15
88,27,2,25,167,3,13
89,35,4,31,165,2,16
90,50,16,34,168,2,13
89,47,12,35,165,2,19
89,39,7,32,165,1,18
90,28,3,25,165,1,17
90,28,3,25,164,1,18
90,34,8,26,164,1,18
90,39,10,29,164,1,17
90,38,10,28,163,1,17
90,36,8,28,163,1,15
90,33,6,27,162,1,15
90,36,9,27,161,1,18
90,31,7,24,160,1,16
90,27,5,22,160,1,21
90,28,7,21,162,1,18
89,27,9,18,163,3,18
85,19,6,13,176,8,21
70,12,3,9,198,14,34
66,13,3,10,206,18,27
64,9,1,8,214,24,12
64,7,1,6,219,31,13
60,6,0,6,225,34,13
64,6,0,6,220,33,11
63,5,0,5,210,34,0
65,7,0,7,199,35,0
67,8,0,8,194,35,1
69,7,0,7,189,34,0
55,6,0,6,180,34,0
53,8,1,7,172,34,0
47,4,0,4,168,35,5
48,5,0,5,165,33,5
45,5,0,5,162,36,5
45,5,0,5,159,36,7
46,4,0,4,156,35,8
48,5,0,5,153,35,11
50,7,0,7,151,31,8
54,5,0,5,149,27,8
55,7,0,7,144,22,9
54,13,1,12,143,16,8
50,9,1,8,146,24,9
46,8,1,7,160,28,20
40,9,1,8,178,30,31
36,8,1,7,187,33,31
33,7,0,7,193,37,17
34,7,0,7,195,41,13
34,6,0,6,200,43,14
36,9,0,9,198,44,21
40,11,0,11,191,42,20
43,9,0,9,187,39,15
49,9,0,9,184,36,5
54,10,0,10,180,34,20
57,11,0,11,180,39,11
60,17,1,16,178,37,19
61,19,1,18,173,31,19
65,18,1,17,163,23,20
67,15,0,15,160,19,22
70,13,0,13,155,17,24
72,16.48325957,3.226406624,13.25685294,152,15,24
70,14,0,14,142,12,22
67,15,0,15,140,13,26
68,14,0,14,138,14,22
70,17,1,16,138,8,22
70,23,2,21,137,6,23
73,28,7,21,134,7,26
72,30,8,22,138,7,24
70,34,12,22,146,8,24
67,30,9,21,156,24.80295035,29
65,26,7,19,170,16,31
64,20,3,17,176,17,39
63,17,3,14,186,20,39
64,15,1,14,191,25,32
66,18,1,17,185,26,10
68,22,1,21,180,19,12
69,26,1,25,175,13,24
69,33,2,31,172,12,28
71,35,2,33,169,16,27
71,38,3,35,168,17,29
73,42,6,36,166,9,30
73,33,2,31,164,8,31
73,31,1,30,164,10,31
74,29,1,28,163,9,31
83,22,1,21,159,9,32
84,16,0,16,158,8,27
83,12,0,12,154,13,24
81,13,0,13,150,14,20
81,14,0,14,148,12,20
79,17,1,16,151,8,19
76,14,1,13,152,22,14
72,9,1,8,155,25,12
69,8,1,7,160,28,11
65,16.49142963,3.225306816,13.26612282,160,29,11
64,8,0,8,159,28,10
63,7,0,7,161,29,6
60,7,0,7,164,30,6
61,6,0,6,161,30,8
63,6,0,6,159,32,9
65,9,0,9,153,34,5
66,13,1,12,150,34,4
63,9,0,9,149,34,4
62,7,0,7,146,37,4
62,6,0,6,146,37,5
68,6,0,6,140,33,6
68,8,0,8,138,30,5
68,8,0,8,137,30,6
64,7,0,7,135,29,7
58,6,0,6,134,30,7
52,4,0,4,133,31,5
48,3,0,3,132,30,6
47,4,0,4,131,32,6
45,5,0,5,129,30,4
42,8,0,8,129,27,4
42,7,0,7,130,29,3
39,7,1,6,140,30,8
38,7,1,6,155,28,17
39,6,1,5,165,32,16
39,6,1,5,163,31,22
39,5,0,5,164,34,2
36,6,0,6,164,36,10
30,5,0,5,168,37,10
35,5,0,5,162,35,8
43,8,0,8,149,36,0
47,18,1,17,142,30,0
52,18,1,17,134,28,0
55,19,0,19,127,26,2
54,17,1,16,127,25,5
57,13,0,13,121,23,5
59,16,0,16,114,17,5
63,13,0,13,106,15,4
64,15,0,15,101,13,5
61,14,0,14,99,12,8
59,16,0,16,94,9,6
61,17,0,17,89,7,7
62,20,1,19,86,2,6
65,27,3,24,82,1,5
67,35,10,25,81,1,8
63,38,16,22,88,3,9
56,32,12,20,108,6,21
46,22,7,15,144,13,30
37,9,2,7,162,20,27
36,7,1,6,163,26,24
37,6,1,5,158,30,0
35,5,0,5,167,32,6
32,5,0,5,170,34,7
37,5,0,5,159,35,5
42,9,0,9,150,32,0
49,23,3,20,140,25,0
52,26,2,24,132,19,0
54,28,1,27,127,15,0
57,50,13,37,123,11,8
61,60,24,36,117,6,11
62,70,35,35,113,2,12
65,52,19,33,110,2,14
68,38,8,30,105,1,14
71,29,2,27,97,2,9
73,27,1,26,92,3,8
75,31,5,26,87,1,8
78,31,6,25,83,1,12
77,36,12,24,82,1,12
76,44,20,24,81,1,14
73,48,25,23,90,2,16
64,41,19,22,111,5,27
52,33,12,21,141,9,28
46,25,7,18,160,18,29
43,14,2,12,168,23,31
42,10,1,9,169,29,18
42,10,1,9,171,31,6
44,9,0,9,175,31,0
44,11,0,11,171,30,10
46,16,0,16,163,25,0
56,18,1,17,158,18,7
61,22,3,19,149,26,8
63,19,1,18,143,24,3
65,19,1,18,138,25,5
68,22,1,21,134,11,9
67,29,1,28,132,2,12
62,33,1,32,128,2,20
63,38,3,35,123,3,23
63,30,1,29,121,3,21
61,29,1,28,119,6,20
62,17,0,17,118,9,16
63,15,0,15,115,9,14
62,16,0,16,115,8,14
61,21,1,20,115,5,14
59,23,4,19,120,7,13
56,20,5,15,128,11,20
49,19,4,15,156,13,29
40,17,3,14,173,21,32
37,13,2,11,177,28,17
37,12,1,11,182,35,14
37,9,0,9,191,39,28
38,8,0,8,195,46,21
51,7,0,7,181,47,20
55,8,0,8,165,41,0
59,10,0,10,157,33,0
59,13,0,13,150,30,4
58,14,0,14,141,26,0
53,18,2,16,137,27,5
51,14,1,13,136,29,6
49,10,0,10,135,27,8
50,9,0,9,134,30,9
56,7,0,7,125,26,4
59,9,0,9,118,22,1
62,8,0,8,112,18,8
65,10,0,10,108,16,9
68,9,0,9,102,13,9
70,7,0,7,100,11,8
71,8,0,8,97,12,12
69,10,1,9,106,14,8
63,8,1,7,126,20,14
60,6,1,5,142,25,20
53,6,1,5,160,28,18
54,4,0,4,161,32,20
55,4,0,4,162,36,13
54,3,0,3,160,37,0
55,3,0,3,158,37,2
58,4,0,4,151,37,0
61,5,0,5,145,36,3
61,11,1,10,142,35,4
62,10,1,9,139,34,4
62,7,0,7,139,32,7
64,8,0,8,139,30,6
63,7,0,7,138,30,8
65,7,0,7,137,29,9
65,7,0,7,134,26,6
75,6,0,6,128,27,6
79,16.48593561,3.220534365,13.26540124,125,23,6
79,7,0,7,123,22,4
78,9,0,9,123,15,5
76,12,0,12,122,14,10
78,10,0,10,121,15,8
79,11,0,11,124,16,7
76,14,1,13,127,18,9
73,17,2,15,133,20,9
68,14,2,12,141,24.77709029,12.35631177
66,16.48429531,3.219635401,13.26465991,147,22,13
64,16,2,14,147,19,20
61,18,2,16,152,18,15
60,17,1,16,155,16,21
62,20,1,19,155,14,19
64,23,1,22,153,17,13
73,23,2,21,147,10,13
77,24,2,22,144,9,13
79,30,2,28,143,5,13
80,32,2,30,143,2,13
83,35,3,32,142,1,13
84,16,1,15,121,23,10
86,10,0,10,116,27,0
82,6,0,6,115,30,0
82,5,0,5,113,28,0
83,5,0,5,109,26,2
85,5,0,5,107,24,0
77,6,0,6,105,24,2
81,10,0,10,102,23,2
83,9,0,9,100,18,2
76,10,0,10,95,22,1
73,12,1,11,101,19,4
57,9,1,8,112,17,6
51,9,1,8,132,22,12
45,6,1,5,137,24,15
45,5,1,4,135,28,12
45,6,1,5,139,30,8
46,4,0,4,138,31,5
46,5,0,5,137,32,4
46,6,0,6,133,31,2
47,9,0,9,128,28,1
48,19,2,17,125,26,3
52,23,1,22,117,23,6
54,31,2,29,114,19,5
58,33,2,31,108,16,7
61,35,4,31,103,7,10
65,40,10,30,99,1,13
65,41,12,29,93,3,15
70,32,4,28,89,2,13
69,40,9,31,85,1,13
69,41,16,25,81,1,13
76,42,15,27,74,1,14
78,51,24,27,68,2,17
78,44,21,23,67,2,20
71,52,27,25,68,2,18
65,49,22,27,70,3,16
59,43,18,25,83,6,21
52,38,16,22,108,8,26
46,31,10,21,135,11,30
45,26,6,20,146,15,31
46,30,6,24,154,21,27
46,30,4,26,164,26,31
46,25,2,23,165,27,11
50,24,1,23,159,21,24
54,33,1,32,151,16,9
58,50,7,43,143,2,11
59,71,18,53,137,2,13
61,56,6,50,135,7,17
62,44,3,41,132,8,19
62,26,1,25,130,14,23
60,21,1,20,127,14,21
75,22,1,21,116,6,23
82,29,1,28,107,7,23
83,23,0,23,97,9,20
85,20,0,20,92,11,15
88,17,0,17,92,12,15
90,17,0,17,94,8,16
90,20,1,19,95,5,17
86,24,1,23,98,2,19
83,27,4,23,101,3,20
74,27,5,22,106,6,20
70,28,6,22,112,8,17
67,28,7,21,120,11,19
56,25,5,20,125,11,21
52,26,4,22,129,12,19
60,28,3,25,129,8,25
59,34,4,30,129,4,26
57,46,9,37,130,2,24
56,69,29,40,126,0,27
60,84,45,39,122,0,25
62,101,62,39,117,1,25
57,114,74,40,121,1,28
56,88,42,46,118,1,25
61,49,8,41,107,1,17
63,52,12,40,103,1,20
61,50,13,37,100,1,26
60,48,15,33,97,2,19
54,25,1,24,95,6,17
54,15,0,15,85,17,10
57,14,0,14,83,17,4
61,16,0,16,76,15,9
65,18,1,17,69,11,11
67,25,4,21,64,6,8
68,24,6,18,69,5,8
53,16,4,12,91,15,20
41,9,2,7,115,22,26
36,7,1,6,135,26,7
29,4,0,4,142,29,3
27,4,0,4,146,32,3
26,4,0,4,152,34,5
26,4,0,4,147,34,7
28,4,0,4,137,34,2
30,6,0,6,129,31,0
32,12,0,12,120,27,0
43,25,1,24,108,19,0
46,20,1,19,99,15,1
47,9,0,9,91,25,3
46,7,0,7,85,25,1
46,7,0,7,84,24,0
49,5,0,5,81,25,1
49,5,0,5,80,22,3
47,4,0,4,81,25,0
47,3,0,3,81,27,4
47,4,0,4,80,25,2
47,5,0,5,79,26,1
51,7,0,7,75,22,2
57,15,1,14,71,14,2
57,29,6,23,77,9,5
53,23,5,18,85,9,8
45,15,3,12,97,15,13
41,13,2,11,109,21,16
41,9,1,8,113,24,16
39,5,0,5,116,28,9
44,5,0,5,122,30,9
48,5,0,5,121,31,8
49,4,0,4,118,32,2
52,7,0,7,108,30,0
52,14,1,13,107,26,0
50,14,1,13,106,29,4
51,12,0,12,101,24,5
57,14,0,14,92,17,4
59,13,0,13,90,13,4
59,17,0,17,92,18,7
60,14,0,14,90,15,13
61,14,0,14,86,12,16
62,14,0,14,78,7,16
61,13,0,13,78,10,10
61,12,0,12,74,10,13
62,11,0,11,69,10,10
63,11,0,11,65,6,11
63,13,1,12,63,5,10
59,15,3,12,72,9,13
53,12,3,9,88,13,17
48,9,2,7,107,19,21
43,7,1,6,127,23,23
44,7,1,6,138,27,24
47,6,1,5,136,29,22
44,5,0,5,148,35,26
42,6,0,6,149,38,22
46,7,0,7,140,37,0
51,14,0,14,131,31,6
53,24,0,24,130,25,0
57,39,3,36,123,14,5
60,61,16,45,117,2,11
64,85,38,47,111,1,14
65,81,36,45,108,1,17
67,50,11,39,101,1,18
68,49,10,39,93,1,17
67,29,1,28,89,1,21
66,16.53303253,3.232805526,13.300227,88,7,18
67,17,0,17,85,9,14
70,18,0,18,85,5,13
70,27,2,25,83,1,15
73,28,3,25,79,1,16
71,27,4,23,75,2,14
66,29,8,21,83,4,12
59,28,8,20,107,8,17
48,18,3,15,141,24.70712364,27
40,16.53560004,3.232897401,13.30270264,166,23,26
44,14,2,12,164,28,29
44,10,1,9,168,30,18
42,6,0,6,170,36,14
41,6,0,6,168,36,3
46,11,0,11,159,28,4
50,24,1,23,149,19,0
56,30,1,29,148,12,11
56,29,2,27,144,23,14
56,33,1,32,140,20,8
57,33,1,32,138,23,10
58,30,1,29,137,23,12
59,30,1,29,134,21,13
61,21,0,21,131,22,14
64,17,0,17,126,15,14
67,22,0,22,122,8,16
67,22,0,22,119,9,16
67,19,0,19,116,5,16
68,26,1,25,117,5,18
65,30,2,28,117,1,18
65,32,4,28,116,1,19
64,31,7,24,116,2,15
62,29,6,23,122,4,17
56,30,7,23,134,8,19
53,29,7,22,149,15,22
51,25,4,21,159,18,28
53,22,3,19,166,23,24
53,13,1,12,171,30,22
51,15,1,14,178,29,28
57,20,1,19,169,29,18
61,47,2,45,158,14,4
65,73,24,49,152,3,8
69,91,43,48,142,2,10
72,114,67,47,137,2,17
73,101,55,46,135,2,18
76,81,37,44,131,3,18
77,68,31,37,126,2,17
79,63,28,35,118,1,19
80,53,16,37,113,1,20
79,48,15,33,109,1,24
76,43,16,27,107,1,24
76,39,13,26,103,1,22
77,33,6,27,99,1,23
77,41,16,25,97,1,21
78,67,38,29,94,1,22
79,80,49,31,97,1,23
70,41,16,25,109,3,28
62,34,12,22,133,8,37
54,37,12,25,156,12,37
52,27,6,21,166,21,35
51,17,2,15,172,35,42
49,17,1,16,181,40,21
50,19,1,18,181,43,22
56,19,0,19,168,38,17
59,22,0,22,159,31,16
56,27,1,26,162,26,18
60,34,3,31,158,26,26
62,29,1,28,155,18,22
60,27,1,26,155,23,22
63,28,1,27,150,14,25
63,31,1,30,148,16,34
69,27,1,26,145,14,41
80,22,1,21,139,18,31
79,13,0,13,134,20,24
81,9,0,9,128,26,20
82,6,0,6,124,27,18
82,6,0,6,120,25,14
80,7,0,7,114,25,14
78,7,0,7,112,24,13
74,8,0,8,112,24,13
68,10,1,9,115,23,11
58,8,1,7,122,23,12
51,8,1,7,142,23,15
49,6,1,5,145,26,20
48,4,0,4,144,29,19
44,4,0,4,158,32,14
45,5,0,5,152,32,18
49,6,0,6,141,32,1
52,7,0,7,132,32,0
55,14,1,13,128,28,1
56,20,2,18,126,23,4
62,13,0,13,121,26,7
63,17,0,17,119,27,6
74,15,0,15,112,19,9
74,11,0,11,111,20,7
78,10,0,10,110,21,10
76,16,0,16,109,12,9
72,21,0,21,105,9,10
67,17,0,17,97,10,11
60,14,0,14,93,8,14
59,14,0,14,87,10,11
64,19,1,18,77,10,15
69,27,4,23,70,2,11
71,32,10,22,76,3,12
64,35,13,22,93,4,23
46,21,5,16,125,14,34
37,18,4,14,142,19,28
33,17,3,14,151,26,23
34,15,2,13,145,30,20
29,12,1,11,159,34,3
31,11,0,11,157,37,19
32,12,0,12,152,33,3
35,18,0,18,146,27,10
38,24,0,24,144,23,3
46,17,0,17,132,26,12
48,19,0,19,125,26,6
49,23,2,21,119,20,7
52,23,1,22,111,23,12
58,21,1,20,108,16,10
63,11,0,11,104,17,6
65,9,0,9,98,17,4
62,9,0,9,87,16,2
62,9,0,9,83,16,1
63,10,0,10,79,14,2
64,11,0,11,78,10,3
64,15,0,15,78,3,6
62,26,3,23,80,1,10
61,31,8,23,84,2,11
57,28,9,19,94,4,16
50,27,9,18,125,6,24
46,33,10,23,146,12,35
44,35,10,25,154,14,28
41,39,10,29,159,18,23
35,25,4,21,166,30,19
33,16,1,15,170,34,17
29,10,0,10,167,37,7
33,7,0,7,152,36,5
32,7,0,7,141,31,0
32,8,0,8,133,27,0
33,8,0,8,124,31,0
34,7,0,7,117,32,0
37,5,0,5,109,33,0
36,6,0,6,106,33,1
38,6,0,6,102,31,2
39,4,0,4,95,31,3
43,7,0,7,87,32,2
52,6,0,6,82,27,1
47,5,0,5,79,27,4
53,5,0,5,74,25,5
55,6,0,6,73,21,7
54,11,0,11,70,16,6
54,12,1,11,71,17,8
50,13,2,11,75,19,13
50,13,2,11,86,20,15
46,11,1,10,94,22,20
45,9,1,8,103,27,18
46,9,1,8,110,29,22
46,9,1,8,116,30,23
46,7,0,7,116,30,25
46,9,0,9,113,30,20
49,10,0,10,112,29,17
50,11,0,11,112,28,20
50,14,0,14,111,25,21
49,12,0,12,113,27,20
51,11,0,11,113,28,20
67,11,0,11,105,26,19
82,9,0,9,95,27,12
81,8,0,8,92,26,7
78,9,0,9,95,20,11
70,16.57126173,3.240888957,13.33037278,98,15,16
70,11,0,11,97,15,16
64,10,0,10,98,13,12
63,12,0,12,100,13,14
63,15,0,15,99,5,12
64,27,4,23,100,2,11
62,49,21,28,101,3,13
59,53,23,30,112,4,17
58,48,19,29,122,4,25
51,42,15,27,139,6,29
53,30,7,23,143,24.66558305,26
50,33,7,26,153,9,21
51,37,7,30,152,10,21
54,36,4,32,148,7,19
58,36,4,32,145,4,13
62,43,4,39,143,3,13
63,56,12,44,141,1,16
64,57,15,42,141,1,19
64,56,15,41,141,1,19
66,55,16,39,138,1,27
67,47,11,36,135,1,26
66,47,12,35,128,1,28
69,42,9,33,124,1,33
68,40,8,32,125,1,38
69,46,14,32,126,1,39
69,44,13,31,125,1,35
72,43,12,31,124,1,29
73,45,14,31,124,1,31
71,48,19,29,123,1,29
72,57,28,29,125,1,29
72,65,36,29,128,1,28
69,55,27,28,134,2,31
63,16.60414279,3.252635235,13.35150755,147,3,32
55,44,16,28,171,5,39
52,59,20,39,188,10,49
56,73,20,53,197,12,52
65,50,10,40,218,18,36
62,19,2,17,224,23,17
64,16,1,15,220,24,3
65,20,1,19,220,26,0
70,23,1,22,216,24,0
74,18,1,17,213,16,5
77,14,1,13,215,18,15
81,8,0,8,212,17,9
57,21,1,20,183,13,13
85,25,1,24,199,14,18
85,9,0,9,204,20,9
69,22,1,21,164,6,15
70,25,1,24,166,4,14
69,24,1,23,168,4,17
68,17,1,16,162,11,9
70,18,1,17,159,8,6
59,25,2,23,164,4,8
57,20,1,19,164,18,5
58,12,0,12,161,18,0
59,16,1,15,159,18,4
58,16,1,15,165,23,4
53,15,2,13,179,23,5
50,10,1,9,183,28,12
47,9,1,8,186,30,18
43,7,1,6,192,32,2
42,7,1,6,188,32,8
47,7,0,7,182,34,1
53,15,0,15,174,28,2
54,9,0,9,160,33,2
54,13,2,11,151,31,2
54,7,0,7,146,30,3
53,7,0,7,140,27,5
54,9,0,9,133,23,11
53,8,0,8,129,23,8
52,7,0,7,125,24,6
52,8,0,8,121,22,6
54,6,0,6,121,23,5
57,6,0,6,122,22,5
58,6,0,6,118,21,5
55,7,0,7,112,17,3
66,9,0,9,103,16,5
80,12,0,12,91,12,4
87,18,1,17,85,10,0
88,19,2,17,87,8,4
90,19,2,17,90,11,8
88,16,2,14,94,14,9
88,17,2,15,94,15,14
90,16,2,14,96,13,10
87,15,2,13,98,14,10
86,14,1,13,98,15,10
85,13,1,12,99,13,12
86,14,0,14,96,11,11
87,18,1,17,96,7,11
88,19,1,18,98,4,12
88,24,2,22,99,1,15
88,24,2,22,99,1,14
87,24,2,22,102,2,15
87,27,4,23,101,2,14
88,32,9,23,97,1,12
89,31,10,21,95,0,13
89,33,14,19,94,1,14
90,33,14,19,92,0,14
90,28,12,16,89,0,14
88,30,12,18,89,0,14
86,29,10,19,89,0,12
86,30,10,20,88,0,10
85,48,27,21,93,1,13
84,59,38,21,101,1,19
80,43,24,19,110,2,21
77,44,24,20,124,3,23
72,44,20,24,133,3,26
70,64,31,33,144,3,27
68,75,36,39,150,2,22
70,61,23,38,146,0,27
71,58,22,36,147,0,16
73,70,33,37,143,0,18
76,92,54,38,137,0,17
78,106,65,41,131,0,21
81,97,61,36,125,0,19
83,77,47,30,116,1,25
84,56,30,26,111,1,26
80,57,32,25,108,1,25
59,48,21,27,96,2,15
57,19,1,18,91,13,3
50,15,0,15,91,15,3
45,8,0,8,93,20,1
43,10,0,10,92,22,3
47,12,0,12,88,22,3
51,9,0,9,87,15,3
57,9,0,9,89,20,3
57,9,0,9,89,18,1
57,9,1,8,95,19,3
53,9,1,8,101,18,5
53,9,1,8,105,19,8
53,9,1,8,113,19,5
53,8,1,7,114,21,10
54,8,1,7,112,23,9
55,8,1,7,112,24,2
59,24,8,16,104,24,3
64,13,2,11,95,24,0
66,20,2,18,91,19,0
70,27,3,24,84,14,4
67,26,4,22,79,11,6
66,20,1,19,73,8,6
69,21,1,20,69,8,5
71,27,2,25,66,7,8
69,22,1,21,64,8,12
69,20,1,19,60,6,11
65,14,0,14,58,8,11
41,7,0,7,69,20,9
35,3,0,3,75,33,5
37,3,0,3,72,32,1
38,3,0,3,72,30,4
44,5,0,5,64,29,2
44,6,0,6,64,24,3
41,7,1,6,72,24,5
38,6,1,5,78,26,11
36,5,0,5,82,27,7
35,4,0,4,86,28,0
34,5,1,4,92,28,3
28,3,0,3,96,29,10
25,3,0,3,97,31,5
31,3,0,3,88,32,0
37,5,0,5,78,28,0
39,12,0,12,71,22,0
36,10,0,10,68,19,2
37,11,0,11,62,21,2
42,14,0,14,54,18,0
46,21,1,20,48,16,4
47,21,1,20,44,15,5
48,15,0,15,42,17,2
49,11,0,11,43,21,3
53,16.63578102,3.269500163,13.36628085,39,20,5
50,7,0,7,41,22,1
48,7,0,7,42,24,4
49,7,0,7,41,23,5
48,11,0,11,43,22,7
47,15,0,15,42,18,1
45,14,1,13,47,16,2
45,10,1,9,53,16,4
42,13,2,11,58,19,7
42,13,2,11,62,19,9
39,13,2,11,67,24.58829828,8
39,13,2,11,77,19,8
34,16.63323945,3.268400205,13.36483925,83,18,14
34,7,0,7,78,20,14
40,9,1,8,70,20,7
42,15,1,14,63,11,4
43,44,8,36,57,12,0
47,56,15,41,53,3,4
51,80,38,42,48,1,7
51,84,40,44,43,1,10
53,78,35,43,43,1,13
54,57,17,40,38,1,17
57,48,12,36,30,1,22
59,58,23,35,26,1,23
63,52,20,32,21,1,24
64,33,4,29,17,1,26
64,29,2,27,17,1,25
67,19,0,19,8,1,18
68,30,3,27,7,1,19
66,56,25,31,8,1,21
65,61,32,29,12,1,18
60,37,15,22,27,3,24
53,46,20,26,44,4,25
50,49,21,28,55,6,15
52,48,18,30,58,7,19
50,48,17,31,63,7,20
48,30,5,25,70,8,19
49,27,3,24,72,9,18
53,27,1,26,73,7,26
62,31,2,29,67,4,21
66,30,2,28,65,5,20
74,25,1,24,63,11,18
83,18,1,17,57,17,13
86,12,1,11,51,24,4
87,8,0,8,44,25,4
89,7,0,7,36,26,4
91,7,0,7,35,23,3
91,6,0,6,35,23,5
92,5,0,5,36,23,4
92,5,0,5,37,21,6
92,8,0,8,36,15,10
92,9,0,9,42,19,7
91,10,0,10,45,14,5
91,11,0,11,48,17,5
90,14,1,13,51,16,5
90,18,1,17,53,13,4
90,19,2,17,58,14,3
89,16,2,14,66,12,3
84,16,3,13,79,13,8
77,21,5,16,88,14,13
70,22,5,17,103,16,15
68,19,3,16,102,15,11
71,17,1,16,100,10,7
72,31,2,29,97,4,2
70,45,8,37,98,3,4
45,25,2,23,100,12,1
46,9,0,9,91,27,0
46,8,0,8,82,28,0
45,8,0,8,76,27,0
46,7,0,7,70,30,0
43,4,0,4,67,34,0
43,4,0,4,69,35,3
44,3,0,3,65,35,2
44,3,0,3,64,33,2
44,3,0,3,62,30,4
43,5,0,5,60,27,1
45,7,0,7,57,23,3
43,8,0,8,60,22,4
44,13,1,12,60,22,4
43,24,4,20,65,20,8
38,18,3,15,77,24,9
33,16,3,13,94,27,9
35,14,2,12,91,27,9
36,12,1,11,93,24,10
35,9,1,8,94,22,6
37,7,0,7,89,24,11
46,8,0,8,82,24,3
59,13,0,13,71,21,0
72,28,4,24,65,18,1
73,26,2,24,64,11,4
73,28,2,26,61,14,6
73,35,3,32,59,9,8
76,45,7,38,59,2,8
76,40,4,36,59,3,12
77,47,10,37,56,2,9
79,42,8,34,51,2,4
77,49,13,36,44,2,7
74,48,13,35,34,2,8
71,42,12,30,28,1,8
69,35,7,28,24,1,9
64,37,9,28,32,1,10
53,23,2,21,49,9,8
50,21,3,18,53,15,7
36,14,2,12,75,21,8
33,7,1,6,86,28,14
28,7,1,6,93,31,6
25,5,1,4,95,33,5
25,4,0,4,94,33,6
25,4,0,4,98,33,8
27,4,0,4,86,34,10
29,4,0,4,78,32,0
30,6,0,6,68,32,1
32,7,0,7,63,32,0
35,8,0,8,57,30,1
37,7,0,7,53,29,7
40,7,0,7,48,30,4
39,7,0,7,50,31,8
40,6,0,6,46,31,8
39,6,0,6,49,31,8
39,4,0,4,50,33,11
37,4,0,4,50,33,6
37,4,0,4,46,33,8
39,7,0,7,42,31,7
37,10,0,10,41,28,9
40,12,0,12,35,26,10
44,15,0,15,30,22,11
45,18,2,16,31,17,10
44,17,3,14,42,18,19
39,14,3,11,67,20,25
36,12,2,10,79,25,27
28,8,1,7,90,33,15
26,4,0,4,87,36,0
26,3,0,3,90,37,0
27,4,0,4,89,37,4
29,5,0,5,81,36,4
31,5,0,5,72,34,0
32,10,0,10,65,28,0
36,16,0,16,56,23,0
40,24,1,23,48,19,2
42,27,1,26,41,18,1
43,38,4,34,37,13,1
46,53,14,39,31,10,5
46,62,24,38,31,10,6
50,57,22,35,29,8,9
50,59,28,31,26,6,8
51,47,18,29,26,11,8
58,38,11,27,14,6,5
63,40,8,32,7,2,7
66,29,2,27,0,1,10
67,29,4,25,0,2,11
67,29,8,21,1,5,11
58,25,8,17,17,9,20
50,22,6,16,34,14,23
44,16,4,12,51,18,27
46,11,1,10,44,21,26
44,13,2,11,45,22,13
53,14,1,13,47,23,18
59,17,1,16,48,20,17
58,22,2,20,47,20,21
59,26,1,25,46,17,34
58,29,2,27,47,12,39
57,30,2,28,44,8,43
57,43,7,36,40,5,42
56,38,4,34,36,4,35
54,42,7,35,35,5,32
56,53,17,36,37,5,36
56,55,20,35,36,2,43
58,58,26,32,36,2,42
60,16.67847525,3.280916428,13.39755883,35,1,43
61,39,5,34,34,2,40
63,41,9,32,34,1,34
70,40,10,30,34,1,24
75,33,5,28,35,1,23
80,40,11,29,37,1,19
82,60,30,30,39,2,21
84,69,40,29,38,2,23
85,78,47,31,42,24.52800676,26
74,16.6896899,3.286417171,13.40327273,50,4,19
64,41,17,24,72,6,25
59,39,15,24,80,10,36
54,36,11,25,107,12,45
53,35,8,27,119,12,47
64,33,5,28,107,4,31
73,75,29,46,92,0,16
76,92,48,44,89,0,6
77,129,84,45,89,0,15
77,120,74,46,85,1,22
74,153,96,57,84,1,32
71,110,56,54,84,1,30
73,103,54,49,78,1,27
73,100,55,45,75,1,25
70,100,64,36,72,0,23
65,94,62,32,70,1,20
61,80,49,31,69,4,13
61,36,3,33,64,7,8
61,27,1,26,60,3,9
59,27,2,25,57,2,5
61,37,6,31,49,3,3
49,48,16,32,66,8,3
43,32,9,23,81,18,4
36,11,2,9,102,23,10
30,9,1,8,116,27,16
28,7,1,6,124,28,11
27,6,0,6,120,29,11
26,6,0,6,125,29,13
30,10,1,9,126,31,17
38,23,1,22,115,26,14
42,31,1,30,107,18,0
48,42,2,40,103,5,0
53,65,15,50,98,2,0
58,83,29,54,92,1,6
62,88,39,49,79,0,10
67,115,63,52,76,0,13
64,88,39,49,73,1,15
68,89,48,41,67,1,13
67,78,36,42,61,1,15
54,61,22,39,64,0,13
51,63,29,34,61,2,10
51,61,33,28,59,1,9
55,66,37,29,49,0,9
59,59,27,32,44,1,8
58,82,48,34,42,1,8
58,111,75,36,40,1,6
55,89,51,38,55,2,15
40,65,29,36,92,6,29
34,40,13,27,112,13,32
31,23,5,18,124,18,18
37,27,5,22,116,16,16
37,25,4,21,121,18,1
42,29,5,24,123,16,0
37,24,3,21,124,19,9
38,26,1,25,119,10,6
41,44,6,38,106,5,0
42,61,14,47,102,0,2
44,60,16,44,95,0,8
46,47,7,40,88,0,7
50,53,10,43,77,1,9
53,71,28,43,74,2,8
58,65,25,40,65,1,10
59,69,32,37,62,1,9
58,58,24,34,64,2,10
57,31,4,27,66,4,6
58,31,1,30,66,5,9
60,37,3,34,62,5,7
62,30,2,28,58,5,8
62,43,8,35,56,0,8
62,78,37,41,58,1,14
56,123,76,47,68,2,24
49,92,48,44,95,3,29
39,44,13,31,123,10,36
34,30,6,24,135,15,30
34,32,6,26,126,18,26
31,23,3,20,142,23,21
37,25,2,23,138,26,10
41,30,2,28,128,23,8
49,37,1,36,115,10,0
51,69,18,51,106,2,9
53,40,4,36,96,10,16
55,31,2,29,87,14,13
56,26,2,24,80,14,13
60,33,3,30,74,7,17
62,53,12,41,67,1,21
63,49,10,39,60,1,23
63,38,3,35,54,3,15
65,29,1,28,49,2,9
65,25,1,24,46,3,10
66,26,1,25,43,6,13
68,29,2,27,41,4,13
66,30,2,28,45,1,19
68,52,22,30,40,2,16
71,61,28,33,39,3,16
65,51,22,29,51,5,21
53,31,8,23,87,8,31
40,21,4,17,121,16,37
34,12,1,11,133,25,37
34,10,1,9,123,33,25
29,10,1,9,136,36,17
29,10,0,10,142,35,1
35,11,0,11,129,33,17
41,25,1,24,113,25,0
42,55,11,44,108,10,5
46,64,13,51,106,9,15
55,62,12,50,106,6,17
60,42,3,39,106,10,23
60,30,2,28,107,14,23
62,28,1,27,105,10,20
62,33,2,31,101,3,21
60,50,9,41,86,1,22
63,69,25,44,82,1,26
60,39,3,36,80,2,18
55,33,2,31,78,3,18
57,27,1,26,73,6,18
58,27,1,26,68,1,19
59,29,2,27,66,2,20
61,36,9,27,65,2,19
61,45,16,29,72,3,23
52,43,14,29,94,5,31
51,30,5,25,105,14,34
47,33,5,28,117,14,35
46,31,4,27,124,19,32
60,27,3,24,120,18,37
59,30,3,27,120,17,28
64,32,2,30,118,13,26
66,41,4,37,116,4,28
62,50,7,43,112,1,31
62,62,12,50,108,1,42
63,56,9,47,106,1,47
64,53,8,45,102,1,50
63,44,3,41,100,2,58
65,43,4,39,93,2,54
67,42,4,38,91,2,53
69,38,3,35,86,1,53
68,36,3,33,86,1,50
70,28,3,25,84,8,42
73,14,0,14,93,21,25
72,11,0,11,94,21,18
72,9,0,9,92,13,19
72,21,1,20,88,2,26
72,31,5,26,88,3,29
70,23,5,18,95,8,27
67,21,4,17,104,13,23
64,17,2,15,108,19,21
63,15,1,14,111,21,20
68,17,1,16,110,22,21
77,17,1,16,105,17,23
81,17,1,16,100,17,22
82,15,1,14,99,21,23
84,20,1,19,99,19,25
85,23,1,22,99,14,27
84,19,1,18,98,13,29
83,17,1,16,99,19,35
82,19,1,18,100,14,33
80,22,1,21,99,9,35
78,24,1,23,91,9,31
79,32,4,28,86,7,31
81,38,11,27,80,5,31
82,16.87055952,3.35682321,13.51373631,76,4,34
82,24,4,20,73,3,29
79,19,1,18,75,4,23
74,25,2,23,79,9,20
64,21,1,20,74,7,15
59,12,0,12,73,19,6
48,6,0,6,75,28,3
34,5,0,5,86,28,0
30,5,0,5,100,30,12
25,4,0,4,105,31,7
24,4,0,4,108,31,3
24,4,0,4,104,32,3
24,4,0,4,105,33,2
25,4,0,4,99,33,4
27,4,0,4,88,32,1
27,4,0,4,77,31,0
27,8,0,8,70,31,0
30,7,0,7,60,30,0
31,7,0,7,58,26,0
35,12,0,12,48,26,3
37,20,1,19,42,23,1
38,36,4,32,38,19,1
43,29,2,27,36,17,1
45,18,0,18,34,20,3
46,15,0,15,30,22,2
46,18,1,17,29,24,3
46,18,1,17,31,23,3
47,26,4,22,32,18,5
49,29,6,23,30,2,5
54,46,19,27,26,1,8
55,65,34,31,26,1,9
47,64,32,32,38,2,13
37,30,9,21,58,24.41804268,12.40937729
32,18,4,14,78,21,15
30,16.87282432,3.357416826,13.5154075,82,23,17
32,17,3,14,82,22,20
32,16,2,14,90,21,13
31,16,2,14,104,21,9
35,15,1,14,90,16,18
44,18,0,18,86,15,6
49,38,4,34,73,6,0
53,58,17,41,66,1,10
56,97,53,44,58,1,15
57,123,77,46,60,1,25
55,115,70,45,54,1,20
51,98,56,42,50,1,21
55,91,49,42,43,1,31
54,77,37,40,34,1,33
55,58,23,35,29,1,25
57,51,18,33,23,1,17
58,42,11,31,21,1,20
58,46,16,30,20,1,21
58,53,24,29,19,2,24
53,66,36,30,25,2,21
54,109,75,34,28,2,17
52,75,43,32,38,2,20
50,63,33,30,47,2,28
45,61,32,29,74,3,33
42,80,41,39,86,3,47
40,56,23,33,94,6,45
40,49,16,33,112,10,41
37,45,12,33,126,8,38
40,33,4,29,116,8,44
41,29,1,28,108,8,30
43,27,1,26,103,9,9
47,43,6,37,91,4,16
50,67,25,42,87,1,23
48,78,33,45,93,0,28
52,86,39,47,89,1,31
55,89,40,49,84,1,28
55,74,29,45,77,0,32
55,61,19,42,73,0,36
55,58,19,39,72,0,31
58,57,19,38,65,0,22
61,42,8,34,58,0,20
61,23,1,22,56,1,14
65,26,2,24,47,0,14
64,34,5,29,50,1,14
60,38,11,27,57,3,17
55,33,10,23,73,5,19
46,31,9,22,93,9,23
44,23,5,18,102,15,15
34,18,4,14,121,16,14
34,10,1,9,120,23,20
31,12,1,11,133,26,17
27,11,1,10,139,30,19
31,13,1,12,130,29,16
37,31,1,30,117,20,2
41,44,3,41,110,11,0
32,41,4,37,100,9,2
34,13,0,13,87,17,0
34,18,1,17,78,18,0
34,17,1,16,73,21,0
36,13,0,13,65,22,0
37,11,0,11,60,19,0
34,6,0,6,55,23,0
31,4,0,4,50,25,0
30,4,0,4,46,28,0
35,5,0,5,38,29,0
40,5,0,5,27,24,0
35,6,0,6,27,25,0
37,7,0,7,25,25,0
32,8,0,8,33,25,0
27,8,1,7,42,27,0
20,7,1,6,59,28,4
19,6,1,5,69,28,8
18,4,0,4,74,28,7
19,4,0,4,70,27,4
20,3,0,3,73,26,2
19,4,0,4,75,27,2
20,4,0,4,65,26,0
26,6,0,6,54,25,0
33,8,0,8,43,25,0
36,8,0,8,36,24,0
38,10,0,10,31,25,0
42,10,0,10,24,23,1
44,12,0,12,20,20,0
39,15,0,15,19,17,3
34,12,0,12,24,24,2
26,8,0,8,26,28,1
26,4,0,4,28,32,3
26,5,0,5,27,31,7
26,5,0,5,26,32,2
27,5,0,5,24,31,0
29,9,0,9,19,27,2
32,18,0,18,15,15,2
27,32,5,27,26,13,5
21,25,5,20,47,21,8
17,7,1,6,73,26,16
15,7,1,6,86,29,18
15,6,1,5,97,29,12
15,7,1,6,90,29,6
25,4,0,4,88,31,5
27,3,0,3,78,32,0
26,3,0,3,70,31,0
28,4,0,4,60,31,0
30,5,0,5,48,30,0
31,5,0,5,41,31,0
34,6,0,6,36,31,0
36,5,0,5,30,32,0
33,4,0,4,29,33,0
37,6,0,6,22,31,2
41,7,0,7,15,26,0
40,7,0,7,15,26,3
40,7,0,7,15,28,1
36,7,0,7,16,27,1
36,6,0,6,14,27,3
36,7,0,7,11,24,5
37,12,0,12,6,14,2
38,19,1,18,8,19,3
32,18,1,17,18,21,2
25,9,1,8,45,27,6
21,5,0,5,67,29,10
17,4,0,4,82,32,12
17,3,0,3,87,33,8
17,3,0,3,88,33,9
21,3,0,3,88,34,3
25,2,0,2,81,34,2
26,2,0,2,71,34,0
28,3,0,3,61,34,0
26,5,0,5,56,32,0
31,5,0,5,47,32,0
37,5,0,5,41,31,0
41,6,0,6,35,29,1
43,6,0,6,30,28,1
43,8,0,8,27,28,2
47,7,0,7,22,26,1
49,8,0,8,19,23,1
45,16.91913359,3.384451875,13.53468171,22,22,2
42,8,0,8,24,24,1
41,9,0,9,23,25,1
43,9,0,9,20,24,3
48,9,0,9,10,15,5
53,11,0,11,2,19,3
52,11,1,10,6,18,0
46,11,2,9,22,17,6
36,8,1,7,55,21,21
31,7,1,6,79,26,24
27,6,1,5,79,30,16
27,3,0,3,80,31,2
23,3,0,3,91,32,3
24,3,0,3,86,34,3
27,4,0,4,79,32,0
29,6,0,6,71,30,3
31,12,0,12,65,26,0
35,19,1,18,54,24,0
39,28,2,26,44,18,1
41,30,3,27,39,16,6
40,38,6,32,36,16,7
41,28,4,24,35,17,10
41,13,0,13,31,21,8
43,14,1,13,25,20,7
41,10,0,10,26,20,12
41,8,0,8,25,22,10
42,9,0,9,19,22,7
43,8,0,8,16,20,10
42,14,0,14,17,19,14
41,10,0,10,18,19,8
43,19,2,17,16,17,8
40,20,4,16,31,21,9
34,10,2,8,59,23,21
28,7,1,6,88,26,15
23,6,1,5,100,28,15
22,5,0,5,99,31,15
20,4,0,4,107,35,8
18,3,0,3,120,36,13
33,7,0,7,98,34,8
32,10,0,10,89,31,0
32,17,0,17,80,28,0
38,33,1,32,72,15,0
46,45,4,41,65,13,5
49,38,3,35,62,13,6
49,44,5,39,60,17,10
56,39,5,34,55,17,11
55,37,5,32,42,10,12
51,24,1,23,31,15,10
53,17,1,16,21,12,8
56,11,0,11,17,14,8
57,9,0,9,16,12,10
60,7,0,7,15,15,3
58,8,0,8,16,12,3
59,9,0,9,20,12,7
56,9,1,8,30,19,4
47,8,1,7,53,22,9
38,6,1,5,76,28,18
30,5,0,5,91,32,17
24,4,0,4,102,34,6
23,3,0,3,101,34,5
26,2,0,2,104,36,0
22,2,0,2,108,36,2
23,3,0,3,97,36,2
27,4,0,4,81,35,2
28,8,0,8,70,33,0
31,10,0,10,62,32,0
34,12,0,12,53,28,0
38,13,0,13,46,26,0
40,15,0,15,43,23,1
43,13,0,13,35,22,0
48,18,0,18,29,18,1
49,16,1,15,22,21,2
50,10,0,10,21,25,2
50,10,0,10,20,23,3
51,9,0,9,17,24,4
53,8,0,8,11,22,3
50,8,0,8,16,20,1
53,14,0,14,9,19,3
55,18,2,16,6,16,4
51,14,2,12,20,17,10
38,10,2,8,63,23,21
30,7,1,6,91,29,16
25,4,0,4,101,32,9
26,3,0,3,97,34,6
21,3,0,3,99,36,0
24,2,0,2,99,37,0
27,2,0,2,84,37,0
30,3,0,3,71,37,0
33,4,0,4,61,37,0
35,5,0,5,54,34,0
38,7,0,7,47,33,0
41,13,0,13,38,29,2
44,16,1,15,33,28,0
45,10,0,10,30,28,3
48,9,0,9,25,28,3
51,6,0,6,22,28,4
50,8,0,8,23,29,3
49,8,0,8,21,28,3
50,5,0,5,15,27,3
49,7,0,7,16,25,3
50,15,0,15,15,24,5
52,27,3,24,8,17,6
51,44,13,31,13,10,7
47,26,6,20,25,16,11
39,12,2,10,53,24.38548567,22
32,16.89915219,3.373792301,13.52535988,76,24,23
29,10,1,9,91,27,23
30,10,1,9,82,30,10
28,6,0,6,90,32,4
26,7,0,7,101,32,18
32,11,0,11,88,30,6
36,19,0,19,79,22,0
42,49,8,41,65,8,0
42,66,19,47,65,4,0
42,37,2,35,63,10,8
47,35,2,33,59,11,11
52,30,1,29,59,9,12
55,36,3,33,53,4,15
54,44,5,39,39,1,15
54,36,2,34,27,2,15
55,19,1,18,20,4,14
56,17,0,17,17,7,15
55,21,1,20,16,9,10
55,22,1,21,16,9,12
54,21,1,20,16,7,12
56,26,2,24,15,10,9
56,31,6,25,14,5,12
53,36,11,25,36,6,15
45,44,16,28,74,6,37
35,58,24,34,109,9,38
31,39,10,29,129,15,36
31,25,4,21,132,27,24
29,10,1,9,145,33,8
26,7,0,7,158,34,5
28,6,0,6,140,35,12
31,6,0,6,121,35,0
33,9,0,9,107,32,0
33,8,0,8,96,34,0
32,7,0,7,86,35,0
33,7,0,7,77,37,0
35,6,0,6,67,36,0
40,13,0,13,55,32,0
42,10,0,10,51,27,0
38,6,0,6,46,29,2
37,5,0,5,42,33,1
34,3,0,3,44,35,0
33,2,0,2,48,37,0
34,2,0,2,45,36,0
35,5,0,5,39,35,2
43,10,0,10,26,31,5
44,17,1,16,24,27,1
39,10,1,9,34,31,4
34,7,1,6,52,30,14
33,5,0,5,61,31,18
33,5,0,5,60,29,9
31,5,0,5,66,32,2
29,5,0,5,72,32,7
28,5,0,5,75,36,9
26,5,0,5,72,37,6
26,9,0,9,68,36,0
29,20,1,19,63,33,0
29,23,1,22,62,31,3
32,23,1,22,55,33,7
38,19,1,18,45,30,3
40,15,0,15,39,29,4
40,12,0,12,41,31,4
41,11,0,11,36,33,5
44,12,0,12,27,28,4
44,16.90068742,3.370488154,13.53019927,24,22,8
43,17,0,17,24,26,9
42,21,1,20,24,24,5
44,25,1,24,18,20,8
41,31,3,28,20,16,8
43,58,22,36,16,7,7
38,73,37,36,33,8,7
30,12,1,11,58,23,9
25,9,1,8,77,24.38341054,11
22,16.90525175,3.372096299,13.53315545,89,31,8
21,6,1,5,98,31,7
22,4,0,4,94,32,5
21,5,0,5,101,33,7
18,4,0,4,106,34,6
23,4,0,4,92,34,8
24,6,0,6,80,32,6
26,9,0,9,69,29,0
28,18,0,18,58,21,1
30,40,6,34,53,17,0
32,68,20,48,48,9,2
35,98,47,51,45,7,6
37,106,54,52,44,1,6
38,106,58,48,39,1,8
42,91,46,45,33,1,10
45,79,39,40,28,2,8
47,86,43,43,21,1,8
50,67,25,42,13,2,10
54,58,18,40,6,1,8
56,59,21,38,0,1,11
59,65,27,38,0,1,15
57,68,31,37,2,2,14
52,63,28,35,18,4,17
45,54,21,33,39,8,24
37,45,15,30,66,8,28
30,42,13,29,86,10,27
33,45,13,32,91,14,29
32,37,8,29,93,13,25
33,40,6,34,108,14,16
38,46,6,40,92,9,17
46,52,5,47,85,1,16
51,79,26,53,73,0,5
54,125,66,59,65,0,11
56,150,89,61,62,1,18
56,111,51,60,59,1,25
53,102,44,58,53,1,25
54,57,10,47,43,1,30
56,42,3,39,34,1,36
61,44,7,37,28,1,36
66,30,2,28,27,1,24
69,23,1,22,24,4,12
68,18,1,17,23,9,6
64,21,1,20,30,8,6
57,20,1,19,31,17,9
50,19,1,18,30,14,5
42,20,2,18,32,24,4
36,12,1,11,46,25,2
31,7,1,6,60,31,11
24,5,0,5,65,32,8
24,4,0,4,66,34,8
23,4,0,4,65,34,4
22,4,0,4,70,35,6
21,4,0,4,71,35,6
24,4,0,4,64,33,6
27,6,0,6,54,31,3
29,8,0,8,46,30,0
29,9,0,9,41,27,0
32,9,0,9,35,29,2
31,8,0,8,33,31,1
31,10,0,10,28,30,4
32,11,0,11,25,29,5
34,14,1,13,18,27,4
35,15,0,15,18,28,5
37,12,0,12,12,21,5
42,14,0,14,4,18,3
45,13,0,13,0,19,4
47,18,0,18,0,12,7
48,24,1,23,0,6,7
46,30,2,28,0,2,9
48,40,9,31,0,4,8
42,44,15,29,10,6,15
34,37,10,27,31,12,28
32,26,5,21,45,14,13
30,30,6,24,51,15,17
29,42,9,33,45,15,18
29,37,6,31,46,13,9
33,32,3,29,47,10,12
31,34,5,29,47,8,22
31,35,3,32,43,7,32
35,49,7,42,36,3,33
37,69,22,47,30,1,37
39,65,19,46,25,1,46
38,74,27,47,24,1,46
37,101,52,49,27,1,44
41,122,73,49,23,1,43
42,116,68,48,23,2,41
44,114,66,48,23,1,36
47,104,62,42,19,2,31
42,102,63,39,29,2,31
45,97,54,43,27,2,25
46,72,33,39,29,1,22
48,39,4,35,44,7,13
48,29,2,27,44,9,3
45,25,2,23,50,15,7
39,20,3,17,70,22,11
33,13,2,11,91,28,12
27,8,1,7,105,31,14
25,7,1,6,113,32,13
23,7,1,6,113,32,10
23,6,0,6,114,33,11
22,6,0,6,117,33,9
23,6,0,6,105,32,9
24,7,0,7,97,30,1
24,11,0,11,88,28,4
29,29,3,26,75,18,2
43,26,1,25,67,11,6
49,23,1,22,63,17,6
46,42,5,37,57,9,9
57,32,4,28,48,4,9
50,21,1,20,39,16,13
53,17,1,16,36,19,6
48,18,1,17,37,4,8
49,24,1,23,39,2,11
48,25,1,24,39,4,12
47,25,1,24,38,6,9
50,20,0,20,33,7,9
54,31,2,29,20,2,9
53,35,6,29,22,3,13
54,43,13,30,19,4,14
51,54,23,31,26,5,27
50,52,20,32,34,8,24
48,41,12,29,40,11,24
52,38,10,28,44,13,35
52,35,7,28,54,12,36
55,22,2,20,61,15,24
59,23,2,21,60,15,25
62,28,2,26,58,8,28
67,38,4,34,57,2,34
68,36,4,32,56,2,34
66,39,5,34,58,2,40
59,59,17,42,58,2,38
67,62,19,43,56,2,37
73,54,14,40,53,2,35
68,39,6,33,50,3,32
67,26,1,25,48,2,34
62,24,1,23,47,4,37
65,21,1,20,46,8,35
64,14,0,14,44,11,30
61,11,0,11,43,15,18
59,9,0,9,40,17,13
61,14,1,13,34,16,11
59,13,1,12,34,17,9
57,12,1,11,41,18,9
53,14,2,12,52,19,13
43,11,2,9,79,22,16
36,8,1,7,96,28,25
36,5,0,5,93,33,32
34,4,0,4,97,36,22
31,4,0,4,108,37,18
29,4,0,4,97,36,11
43,6,0,6,82,37,8
49,10,0,10,69,35,0
53,16,1,15,60,31,0
57,31,3,28,53,26,2
59,17,1,16,48,25,5
58,18,1,17,46,24,6
59,18,1,17,41,21,6
60,16,1,15,34,23,8
56,12,0,12,35,20,5
59,17.0239834,3.419949971,13.60403342,30,22,7
57,8,0,8,30,21,6
61,7,0,7,24,20,5
65,14,0,14,14,11,9
68,20,1,19,6,2,11
69,26,2,24,2,1,13
68,35,10,25,3,4,15
61,36,13,23,20,8,19
52,28,9,19,48,14,27
43,15,3,12,73,20,24
36,11,2,9,91,27,24
36,8,1,7,88,33,20
34,5,0,5,95,36,13
29,4,0,4,107,36,15
33,4,0,4,94,36,13
35,10,1,9,85,34,6
42,22,2,20,73,30,0
48,26,2,24,62,25,0
51,44,6,38,59,24,1
55,65,21,44,50,16,5
58,75,30,45,44,11,9
62,68,26,42,39,4,11
66,34,4,30,36,6,11
67,29,2,27,32,18,8
71,21,1,20,24,12,7
70,26,1,25,18,1,11
71,35,4,31,14,1,17
68,43,10,33,12,1,17
70,71,35,36,7,1,16
71,62,28,34,4,1,18
68,54,22,32,7,1,20
65,57,25,32,18,4,29
59,71,36,35,35,24.30790548,32
57,17.04397982,3.427616186,13.61636363,44,6,33
54,54,20,34,50,5,32
54,47,12,35,52,5,31
51,40,10,30,68,7,27
63,52,13,39,60,4,37
64,73,28,45,64,4,23
67,79,28,51,63,2,31
71,102,48,54,59,1,29
75,142,87,55,52,2,25
74,161,107,54,45,1,26
74,121,71,50,40,1,25
77,103,57,46,40,1,31
66,25,3,22,95,15,20
62,11,1,10,73,26,12
65,55,17,38,37,2,23
67,51,14,37,31,1,23
67,50,14,36,28,1,20
68,45,11,34,25,1,22
73,51,17,34,19,1,23
74,54,21,33,18,2,27
71,61,29,32,19,1,25
72,71,40,31,21,2,24
64,66,34,32,39,2,30
46,46,17,29,77,8,36
35,24,5,19,101,17,34
22,15,2,13,109,27,20
24,7,0,7,107,35,6
22,7,0,7,111,35,5
23,7,0,7,104,32,10
24,8,0,8,96,33,12
25,10,0,10,88,30,5
25,14,0,14,82,28,6
27,15,0,15,77,28,6
29,20,1,19,73,22,7
34,19,1,18,69,14,10
31,18,1,17,63,14,17
31,21,1,20,60,27,12
33,9,0,9,54,29,6
35,8,0,8,46,29,3
37,10,0,10,44,28,4
37,13,0,13,41,26,10
40,12,0,12,34,26,8
41,9,0,9,28,24,9
42,14,0,14,25,20,8
41,32,3,29,23,17,9
40,51,17,34,24,12,10
37,29,6,23,36,12,12
29,36,10,26,69,13,27
23,33,8,25,98,15,32
28,39,10,29,105,14,28
34,44,10,34,103,17,20
31,36,6,30,111,23,14
34,18,1,17,115,30,17
39,20,1,19,104,30,19
49,24,1,23,96,28,11
52,32,1,31,92,17,0
52,48,3,45,87,4,5
52,61,8,53,85,0,13
41,65,13,52,77,0,20
37,30,1,29,72,10,11
39,16,1,15,68,15,2
41,11,0,11,65,21,2
37,8,0,8,63,27,1
37,4,0,4,56,30,0
32,4,0,4,48,31,0
29,3,0,3,43,36,0
31,3,0,3,37,37,0
32,5,0,5,33,34,4
34,8,0,8,29,34,4
35,12,1,11,28,28,2
32,13,1,12,41,25,7
27,9,1,8,60,29,14
22,7,1,6,72,32,11
21,6,1,5,85,30,9
20,4,0,4,83,30,8
20,4,0,4,88,32,10
19,4,0,4,91,32,7
20,4,0,4,82,31,7
20,6,0,6,75,30,4
24,9,0,9,65,29,0
27,10,0,10,57,25,0
27,9,0,9,57,28,0
29,11,0,11,53,28,0
29,10,0,10,50,29,2
31,11,0,11,46,30,3
32,12,0,12,43,29,4
33,9,0,9,40,28,3
36,9,0,9,32,24,2
38,10,0,10,25,22,3
42,11,0,11,19,23,3
43,14,0,14,18,20,5
43,20,0,20,16,17,4
44,23,1,22,17,18,5
42,25,2,23,25,14,4
33,16,2,14,56,22,6
27,10,1,9,80,30,12
20,5,0,5,97,34,12
20,5,0,5,105,34,12
20,5,0,5,106,34,10
18,5,0,5,116,35,11
16,6,0,6,127,36,30
19,7,0,7,111,35,54
22,11,0,11,100,34,10
27,28,1,27,92,19,0
32,58,11,47,83,8,0
36,97,42,55,73,1,4
34,97,39,58,66,1,8
36,72,19,53,56,4,13
37,71,22,49,49,3,8
41,65,18,47,43,3,10
44,54,10,44,36,3,16
46,30,1,29,29,6,11
48,27,1,26,21,10,15
50,24,1,23,15,12,16
49,20,0,20,20,10,23
52,25,1,24,20,4,16
53,36,3,33,18,2,18
52,34,6,28,22,4,20
51,31,8,23,29,10,21
42,22,5,17,54,15,30
34,18,3,15,90,20,37
32,26,5,21,102,22,38
35,26,5,21,105,24,30
34,21,3,18,118,29,22
36,19,2,17,136,34,19
33,19,1,18,124,35,19
31,16,0,16,111,36,15
35,16,0,16,98,32,1
37,21,0,21,101,29,4
39,22,1,21,96,27,8
41,21,1,20,88,27,1
45,17,0,17,85,29,0
36,6,0,6,81,35,0
33,4,0,4,70,37,0
32,3,0,3,60,37,0
32,17.1079653,3.450814407,13.65715089,52,37,0
34,3,0,3,47,36,6
33,3,0,3,43,35,4
34,4,0,4,35,34,6
35,6,0,6,31,32,3
34,6,0,6,29,29,6
35,8,0,8,30,27,6
30,8,1,7,48,28,8
23,7,1,6,68,24.2851077,10
21,17.10423252,3.449773914,13.6544586,83,30,8
18,6,1,5,95,30,10
20,5,0,5,92,31,9
19,5,0,5,99,30,11
18,5,0,5,103,31,11
21,5,0,5,93,32,11
23,8,0,8,81,29,8
24,25,1,24,74,18,0
27,64,20,44,65,9,0
29,102,50,52,58,7,0
31,114,62,52,51,0,1
37,125,74,51,44,0,8
40,124,73,51,36,0,10
43,87,40,47,29,1,9
43,53,11,42,26,0,9
46,37,2,35,21,1,13
48,35,2,33,16,0,11
50,31,1,30,11,1,13
53,37,3,34,7,0,9
52,40,6,34,2,1,10
57,49,14,35,0,1,11
53,67,31,36,2,2,13
50,65,31,34,19,4,17
41,53,24,29,58,8,24
39,21,5,16,78,17,25
29,16,3,13,97,23,19
24,8,1,7,98,29,9
24,5,0,5,100,30,6
23,5,0,5,104,31,5
24,6,0,6,95,30,6
24,6,0,6,81,29,10
25,10,0,10,70,27,0
27,12,0,12,61,23,0
30,14,0,14,54,22,1
34,21,1,20,47,22,4
35,25,1,24,41,18,7
37,27,1,26,36,16,7
39,46,7,39,32,10,9
43,53,14,39,30,13,8
45,37,5,32,29,15,8
45,23,1,22,29,18,8
46,18,0,18,30,16,11
46,16,0,16,28,12,9
46,19,1,18,22,2,10
51,34,3,31,12,1,11
48,54,20,34,12,3,16
43,43,14,29,25,6,19
37,34,10,24,54,7,31
29,33,9,24,86,11,33
27,40,11,29,102,14,38
33,29,6,23,101,24,30
36,21,3,18,108,24,12
41,20,2,18,110,27,11
45,18,1,17,106,28,10
49,20,1,19,99,23,8
50,40,4,36,93,9,5
52,61,10,51,95,5,7
46,55,6,49,97,11,15
45,94,35,59,91,14,20
50,66,13,53,78,4,23
46,54,7,47,85,13,20
56,53,7,46,59,0,18
44,41,2,39,63,2,16
47,25,1,24,51,12,13
50,25,1,24,42,8,10
39,16,0,16,49,21,9
33,7,0,7,51,29,3
33,7,0,7,46,30,0
34,9,0,9,42,25,0
33,11,1,10,44,24,3
29,9,1,8,53,26,6
23,7,1,6,70,30,21
21,7,1,6,83,29,13
16,6,1,5,91,29,14
16,4,0,4,90,30,10
16,4,0,4,92,30,6
16,4,0,4,90,31,9
23,4,0,4,76,32,3
25,5,0,5,67,31,0
27,7,0,7,59,30,0
30,6,0,6,53,31,0
30,7,0,7,49,30,0
27,6,0,6,52,32,1
31,6,0,6,45,33,4
30,5,0,5,44,33,0
32,7,0,7,37,29,6
32,7,0,7,35,31,4
33,6,0,6,32,31,5
33,5,0,5,32,31,6
33,5,0,5,32,32,3
33,6,0,6,32,31,5
35,10,0,10,26,19,5
34,17,0,17,27,12,11
35,32,4,28,27,12,6
34,23,4,19,39,17,8
29,15,2,13,66,20,18
24,12,1,11,83,26,15
20,5,0,5,93,31,8
23,5,0,5,87,32,4
21,5,0,5,99,31,3
21,5,0,5,95,32,14
22,7,0,7,89,31,7
27,13,0,13,82,24,1
37,21,1,20,74,19,2
35,37,3,34,66,8,6
42,44,3,41,62,4,6
43,58,11,47,61,1,8
45,61,15,46,63,1,10
45,61,15,46,59,1,15
44,58,14,44,58,1,15
47,37,3,34,55,9,14
53,30,1,29,45,12,10
57,28,2,26,30,8,12
58,21,1,20,17,4,13
59,22,1,21,11,9,10
53,18,1,17,28,10,9
59,18,1,17,29,11,14
60,18,2,16,31,12,19
54,16,2,14,42,21,16
42,11,1,10,58,26,12
36,8,1,7,66,29,13
32,8,1,7,85,30,11
25,8,1,7,86,32,18
18,6,0,6,87,30,13
19,4,0,4,84,32,0
25,4,0,4,64,34,0
30,5,0,5,53,34,0
34,7,0,7,45,32,0
35,7,0,7,34,30,0
37,6,0,6,28,33,1
38,5,0,5,25,34,0
44,5,0,5,20,34,0
45,5,0,5,19,34,0
51,4,0,4,16,34,2
54,4,0,4,13,36,0
57,4,0,4,5,34,3
51,5,0,5,12,31,1
52,4,0,4,16,35,3
53,4,0,4,12,33,2
56,5,0,5,5,30,0
55,7,0,7,4,26,3
43,17,2,15,21,24,0
36,10,1,9,41,29,6
30,4,0,4,62,34,11
26,3,0,3,73,36,6
23,3,0,3,82,36,6
23,2,0,2,83,36,5
23,2,0,2,87,37,1
23,3,0,3,87,38,4
27,3,0,3,78,38,2
28,3,0,3,69,37,1
31,5,0,5,59,37,0
33,5,0,5,55,38,0
32,5,0,5,52,38,0
33,6,0,6,49,38,2
36,9,0,9,42,34,4
38,15,0,15,35,29,5
40,25,1,24,28,26,7
41,27,1,26,26,22,3
43,17.13776359,3.458168913,13.67959468,19,12,8
45,29,2,27,17,8,6
46,25,2,23,17,9,5
48,29,2,27,16,1,9
48,30,3,27,14,4,8
49,52,13,39,10,1,10
50,88,46,42,14,5,7
49,86,44,42,22,2,13
46,67,27,40,31,24.26090731,12.35256483
44,17.14861588,3.462662199,13.68595368,42,4,20
40,72,30,42,59,5,22
27,62,27,35,107,8,30
26,12,1,11,124,31,27
15,13,1,12,134,31,16
18,13,1,12,128,28,13
31,29,2,27,103,8,19
35,52,6,46,88,1,19
38,60,12,48,98,12,11
40,16,0,16,95,29,0
40,18,1,17,91,27,5
45,32,2,30,77,20,8
44,62,11,51,62,1,11
46,27,1,26,66,20,9
53,11,0,11,59,31,1
44,7,0,7,55,34,1
41,7,0,7,50,33,0
34,5,0,5,48,33,2
35,4,0,4,42,34,0
39,6,0,6,33,29,0
42,8,0,8,28,27,4
38,9,0,9,34,27,4
30,9,1,8,47,29,9
26,8,1,7,67,32,14
25,7,1,6,80,33,18
24,5,0,5,88,33,17
21,5,0,5,91,34,18
20,4,0,4,91,36,18
20,4,0,4,89,37,18
23,5,0,5,83,37,18
26,7,0,7,72,36,19
30,8,0,8,63,34,11
33,9,0,9,55,33,10
32,9,0,9,53,31,13
34,8,0,8,51,35,16
37,10,0,10,43,33,12
38,14,0,14,40,29,13
40,16,0,16,34,26,15
42,19,0,19,32,26,17
43,16,0,16,27,22,14
45,14,0,14,25,20,14
45,20,1,19,25,17,16
50,36,7,29,15,7,17
54,44,9,35,2,1,19
58,67,27,40,0,1,16
57,89,49,40,0,2,22
46,78,40,38,17,4,30
38,49,18,31,52,12,38
31,29,7,22,65,20,43
31,16,2,14,88,24,33
34,17,2,15,91,25,35
33,27,4,23,103,25,24
35,24,3,21,109,22,28
38,25,2,23,100,28,25
39,29,1,28,92,29,14
42,42,1,41,84,20,8
46,82,24,58,77,8,11
50,110,51,59,64,1,19
53,146,82,64,57,1,30
54,175,111,64,55,1,30
57,171,111,60,52,1,34
59,141,85,56,44,1,35
52,107,51,56,34,1,33
52,88,37,51,27,1,29
52,47,6,41,26,0,24
53,44,5,39,25,0,25
54,41,4,37,20,1,25
56,44,7,37,14,1,24
54,57,18,39,18,1,23
52,68,28,40,24,1,28
52,90,46,44,29,1,29
49,103,57,46,40,1,33
45,103,56,47,53,1,36
48,111,60,51,67,2,36
52,96,45,51,82,3,40
49,66,22,44,96,2,43
47,73,22,51,100,0,47
43,78,25,53,98,0,35
39,82,23,59,97,0,35
51,68,17,51,89,0,32
72,40,3,37,75,5,27
79,31,2,29,53,25,8
83,8,0,8,36,30,0
89,8,0,8,22,27,0
90,9,0,9,13,29,0
91,9,0,9,13,26,2
87,7,0,7,21,27,8
87,6,0,6,21,24,7
51,6,0,6,30,29,7
44,4,0,4,29,35,0
45,4,0,4,25,33,0
46,7,0,7,20,27,1
43,9,0,9,18,22,4
42,10,1,9,22,26,1
36,8,1,7,33,26,6
29,7,1,6,51,29,8
27,7,1,6,61,30,5
26,6,1,5,70,30,8
28,6,1,5,73,30,9
26,4,0,4,73,32,11
26,5,0,5,73,31,9
25,5,0,5,63,29,5
29,5,0,5,52,29,4
31,7,0,7,43,28,1
30,8,0,8,36,27,0
32,8,0,8,32,28,4
34,7,0,7,29,29,3
34,7,0,7,27,30,5
34,7,0,7,25,29,4
34,7,0,7,25,30,8
34,7,0,7,25,29,8
37,10,0,10,18,25,6
37,16,0,16,17,17,7
43,21,0,21,11,10,8
39,25,1,24,18,8,8
49,31,3,28,11,2,9
52,68,29,39,13,1,10
50,72,34,38,23,3,11
48,67,30,37,44,5,16
37,81,39,42,94,7,33
25,32,9,23,110,20,36
24,12,2,10,126,28,21
23,13,2,11,120,30,14
29,20,3,17,123,24,13
26,27,4,23,132,25,15
32,23,2,21,120,25,12
37,22,1,21,113,23,9
44,20,0,20,103,20,5
49,33,1,32,93,5,0
46,56,7,49,94,1,13
47,63,13,50,90,3,20
40,75,20,55,84,5,17
43,59,11,48,75,16,14
45,39,3,36,70,19,9
48,41,5,36,61,19,7
51,34,3,31,52,12,10
53,31,3,28,47,14,10
56,19,1,18,39,9,9
57,17,1,16,33,10,10
59,23,2,21,28,11,9
63,23,2,21,23,6,11
66,26,5,21,23,9,14
57,26,7,19,40,14,16
43,16,4,12,87,20,28
36,11,2,9,113,26,29
32,10,1,9,132,29,29
33,12,1,11,129,32,27
32,13,1,12,133,35,15
35,9,0,9,123,42,0
41,11,0,11,119,40,1
45,12,0,12,118,36,2
49,15,0,15,117,33,7
51,28,1,27,114,24,15
50,45,3,42,114,13,14
52,35,2,33,111,8,17
48,42,2,40,115,15,18
54,31,2,29,104,9,17
56,9,1,8,95,0,17
54,37,3,34,87,0,16
55,17.24908982,3.502518612,13.74657121,84,0,18
54,6,0,6,79,2,21
73,11,0,11,84,5,17
83,6,0,6,156,22,13
80,9,1,8,160,23,21
61,19,1,18,78,2,20
56,22,2,20,83,3,3
53,23,4,19,90,6,8
44,23,5,18,134,10,24
31,16,3,13,175,23,34
28,6,0,6,180,33,8
25,6,0,6,181,37,3
23,6,0,6,180,39,2
21,17.24692593,3.501475317,13.74545061,175,41,4
21,7,0,7,162,40,3
26,7,0,7,136,41,0
28,7,0,7,120,37,0
29,8,0,8,106,36,0
32,7,0,7,94,34,0
34,6,0,6,83,34,2
34,6,0,6,76,36,4
33,5,0,5,71,35,4
31,5,0,5,70,37,5
32,4,0,4,69,36,6
34,5,0,5,65,34,9
35,9,0,9,64,30,12
37,9,0,9,62,24,9
38,7,0,7,57,27,11
38,9,0,9,52,32,10
38,12,0,12,50,28,10
38,14,1,13,52,27,15
36,11,1,10,57,24,13
35,8,0,8,66,24.22839367,19
29,11,1,10,84,25,23
31,10,1,9,82,27,28
38,10,1,9,87,28,20
38,7,0,7,92,28,19
40,8,0,8,90,31,21
41,10,0,10,88,29,17
50,10,0,10,83,25,18
53,15,2,13,77,29,16
55,22,2,20,72,28,15
57,26,1,25,68,24,17
59,42,4,38,64,21,21
59,41,3,38,65,9,19
59,33,1,32,67,4,23
60,29,1,28,63,7,23
58,22,1,21,67,8,22
61,18,0,18,64,13,21
60,14,0,14,64,20,21
55,16,0,16,61,12,19
51,21,1,20,59,11,24
61,22,1,21,55,7,27
60,26,2,24,53,5,22
65,28,3,25,52,5,25
70,30,5,25,51,6,24
80,31,6,25,53,7,24
73,37,8,29,56,6,27
79,34,6,28,54,6,26
81,37,6,31,57,7,27
79,37,6,31,64,8,26
81,39,6,33,66,4,25
83,43,8,35,74,3,27
80,57,17,40,74,2,25
78,53,11,42,67,1,33
80,59,17,42,63,1,26
81,74,32,42,61,1,29
83,78,37,41,57,1,35
84,84,44,40,61,2,36
84,99,62,37,63,2,35
84,113,77,36,62,2,36
85,108,73,35,59,2,33
86,109,77,32,60,2,38
87,113,84,29,52,3,35
89,118,92,26,56,3,35
88,119,94,25,50,3,36
89,138,108,30,38,3,40
89,163,125,38,33,3,36
88,172,134,38,33,3,33
86,118,78,40,47,3,39
80,130,83,47,61,3,44
67,140,88,52,86,5,48
67,110,54,56,97,3,57
62,117,55,62,114,5,56
48,51,18,33,152,9,56
50,15,2,13,155,18,34
48,19,2,17,161,13,22
47,20,1,19,159,20,19
50,24,1,23,153,21,8
53,22,1,21,149,18,6
54,25,1,24,146,20,13
55,25,1,24,146,16,16
59,31,1,30,130,9,20
50,36,3,33,129,12,14
49,40,2,38,114,4,16
39,19,1,18,99,24,7
36,7,0,7,91,32,0
34,6,0,6,84,33,0
36,5,0,5,75,33,0
35,7,0,7,70,31,0
37,8,0,8,64,29,2
36,21,2,19,59,29,4
47,22,3,19,53,20,1
42,10,1,9,59,20,8
31,11,2,9,74,20,19
30,8,1,7,71,27,9
25,8,1,7,75,28,0
24,5,0,5,74,30,0
24,6,0,6,73,29,1
24,7,0,7,73,29,3
22,7,0,7,69,30,5
23,7,0,7,64,30,2
23,9,0,9,60,31,1
25,12,0,12,52,28,3
28,11,0,11,46,23,1
27,12,0,12,44,23,5
28,16,0,16,43,26,6
27,23,1,22,41,23,10
29,22,1,21,42,26,12
29,19,0,19,39,28,8
38,13,0,13,30,22,5
41,10,0,10,24,22,13
43,10,0,10,20,24,14
55,9,0,9,19,24,15
79,8,0,8,3,29,14
83,11,0,11,0,24,9
86,15,1,14,0,19,9
85,16,1,15,0,19,9
85,15,2,13,0,19,17
87,15,2,13,0,18,17
86,15,3,12,3,21,17
82,13,2,11,4,24,19
81,10,1,9,6,26,22
80,10,1,9,7,28,22
78,12,1,11,7,27,17
80,12,0,12,7,23,15
84,13,0,13,6,21,16
87,15,1,14,6,19,16
88,13,1,12,5,21,16
89,10,1,9,5,22,15
88,9,0,9,6,21,14
86,8,0,8,5,24,15
90,6,0,6,2,31,11
90,6,0,6,2,34,6
89,7,0,7,4,33,6
84,4,0,4,4,32,8
84,4,0,4,0,31,9
85,4,0,4,0,28,5
84,5,0,5,0,31,4
75,8,0,8,0,32,8
67,10,1,9,3,30,8
57,9,2,7,21,30,9
50,6,1,5,40,31,16
42,6,1,5,52,33,7
31,5,1,4,61,34,8
30,4,0,4,65,36,13
27,3,0,3,69,37,6
24,3,0,3,70,39,8
23,3,0,3,65,39,9
25,4,0,4,61,39,3
27,9,1,8,58,35,0
42,12,1,11,51,34,6
42,10,0,10,49,31,5
43,12,0,12,47,31,3
39,8,0,8,36,34,5
40,7,0,7,33,34,6
39,7,0,7,30,34,5
38,6,0,6,28,33,4
41,17.30735108,3.54337027,13.76398081,25,31,8
46,9,0,9,25,27,5
46,7,0,7,24,24,9
57,6,0,6,19,29,9
65,4,0,4,12,33,7
77,8,0,8,8,32,10
79,11,1,10,10,24,6
81,10,1,9,11,22,11
77,13,1,12,12,24,11
79,12,2,10,21,24,13
77,9,1,8,25,16,21
73,6,0,6,30,24,20
74,7,0,7,38,28,12
74,8,1,7,44,28,9
76,10,1,9,46,26,13
75,12,1,11,44,25,10
74,14,1,13,42,25,10
67,15,1,14,40,25,9
66,14,1,13,39,24,18
67,12,0,12,37,23,19
65,13,0,13,35,19,19
66,15,1,14,35,19,21
68,13,0,13,36,20,16
65,16,0,16,28,19,19
64,16,0,16,22,15,17
66,16,0,16,17,8,21
57,13,0,13,30,14,20
57,16,0,16,27,22,10
57,21,1,20,21,15,8
48,18,1,17,33,16,9
41,16,2,14,45,25,5
33,14,2,12,62,27,8
28,8,1,7,82,24.20404145,14
26,17.3005154,3.539655263,13.76086014,93,33,6
25,17.3005154,3.539655263,13.76086014,97,32,11
24,17.3005154,3.539655263,13.76086014,99,35,8
24,17.3005154,3.539655263,13.76086014,101,35,9
25,17.3005154,3.539655263,13.76086014,96,35,6
25,17.3005154,3.539655263,13.76086014,90,32,4
26,17.3005154,3.539655263,13.76086014,85,30,5
28,17.3005154,3.539655263,13.76086014,77,27,1
29,17.3005154,3.539655263,13.76086014,73,23,2
32,17.3005154,3.539655263,13.76086014,68,8,5
33,17.3005154,3.539655263,13.76086014,60,13,8
38,17.3005154,3.539655263,13.76086014,48,10,8
48,17.3005154,3.539655263,13.76086014,42,8,9
48,17.3005154,3.539655263,13.76086014,32,12,13
46,17.3005154,3.539655263,13.76086014,28,20,8
44,17.3005154,3.539655263,13.76086014,25,22,10
45,17.3005154,3.539655263,13.76086014,24,22,10
45,17.3005154,3.539655263,13.76086014,25,21,10
45,17.3005154,3.539655263,13.76086014,26,18,12
45,17.3005154,3.539655263,13.76086014,29,13,13
47,17.3005154,3.539655263,13.76086014,24,7,14
47,17.3005154,3.539655263,13.76086014,23,8,12
44,17.3005154,3.539655263,13.76086014,30,7,13
40,17.3005154,3.539655263,13.76086014,37,10,13
43,17.3005154,3.539655263,13.76086014,43,12,17
46,17.3005154,3.539655263,13.76086014,49,9,21
37,28,8,20,69,14,22
33,18,4,14,77,24,27
35,13,1,12,77,23,25
41,12,0,12,75,23,8
46,11,0,11,75,24,8
48,17,1,16,72,20,9
55,22,3,19,67,17,9
56,19,1,18,63,19,7
59,23,2,21,59,17,12
66,13,1,12,57,24,13
69,12,1,11,56,28,9
56,11,1,10,47,27,10
56,8,0,8,37,25,11
50,9,0,9,30,28,8
45,6,0,6,27,31,8
48,4,0,4,23,35,8
47,4,0,4,21,31,10
40,6,0,6,16,26,15
41,13,0,13,12,23,10
36,13,1,12,19,24,8
32,9,1,8,37,29,9
26,7,1,6,60,32,14
23,4,0,4,68,35,14
25,4,0,4,69,37,12
22,3,0,3,79,38,6
22,4,0,4,77,38,12
22,4,0,4,81,39,12
20,4,0,4,83,38,8
21,5,0,5,72,38,10
23,7,0,7,61,36,3
24,10,0,10,54,33,0
27,11,0,11,44,32,0
32,12,0,12,33,27,0
36,15,0,15,24,26,7
38,19,1,18,20,21,6
38,19,1,18,17,19,5
41,22,1,21,11,22,6
42,15,0,15,13,24,10
43,14,0,14,7,25,8
46,17,0,17,4,19,9
46,19,0,19,1,8,13
42,28,2,26,2,10,10
44,42,11,31,1,9,10
48,52,20,32,6,2,11
48,51,20,31,11,3,18
42,32,7,25,20,4,22
37,28,6,22,28,7,25
43,20,3,17,30,12,20
60,17,2,15,29,15,20
63,12,1,11,39,20,14
66,11,1,10,45,25,14
67,12,1,11,47,23,12
67,16,1,15,47,22,13
66,19,1,18,48,18,16
66,19,1,18,43,20,12
63,17,1,16,38,22,10
63,16,1,15,40,22,12
63,19,1,18,40,21,14
64,22,1,21,34,16,17
62,19,1,18,30,14,18
61,20,1,19,29,12,20
60,20,1,19,29,9,17
59,19,1,18,28,11,19
59,18,1,17,24,13,18
61,19,1,18,23,8,17
59,23,2,21,21,4,18
62,28,4,24,15,3,19
60,39,14,25,18,4,20
51,32,11,21,36,8,29
41,24,7,17,60,15,36
42,21,5,16,66,15,34
39,24,6,18,87,18,32
32,20,4,16,109,24,30
29,14,2,12,130,31,39
26,12,1,11,138,38,32
29,12,0,12,128,43,13
29,16,1,15,121,36,0
25,13,0,13,110,40,0
30,8,0,8,101,39,0
25,8,0,8,90,37,0
26,7,0,7,81,39,0
29,6,0,6,67,41,4
30,5,0,5,58,42,6
32,4,0,4,50,42,9
33,4,0,4,47,43,14
32,4,0,4,47,44,16
33,3,0,3,46,44,17
34,3,0,3,44,45,18
36,3,0,3,41,45,17
37,3,0,3,37,43,15
37,3,0,3,36,42,16
37,4,0,4,44,42,16
31,4,0,4,58,40,19
27,4,0,4,70,41,21
24,3,0,3,80,42,19
23,3,0,3,90,41,15
19,3,0,3,106,41,16
16,2,0,2,113,40,19
16,2,0,2,113,41,18
15,2,0,2,112,41,12
16,3,0,3,100,41,8
19,4,0,4,87,40,0
23,7,0,7,76,38,0
28,9,0,9,65,38,0
32,9,0,9,57,37,0
36,13,0,13,51,34,6
38,10,0,10,44,33,7
40,10,0,10,40,28,7
40,9,0,9,36,26,10
37,17.28422307,3.531234323,13.75298875,35,29,10
37,8,0,8,37,34,10
37,8,0,8,34,32,12
41,9,0,9,26,25,8
43,15,0,15,18,19,10
43,24,1,23,15,7,11
41,27,5,22,24,7,10
34,26,6,20,54,8,24
25,17.28406526,3.530731232,13.75333403,103,16,30
21,24,5,19,120,28,28
20,9,1,8,131,24.20971379,17
18,6,0,6,136,37,10
18,6,0,6,143,38,13
16,7,0,7,146,41,17
26,17,1,16,139,40,21
33,20,0,20,125,38,6
44,19,0,19,115,40,3
50,31,1,30,108,32,0
54,58,5,53,105,20,5
55,70,12,58,96,8,15
57,70,12,58,86,5,16
60,73,18,55,84,2,19
62,57,10,47,77,2,22
64,43,3,40,70,2,24
65,35,2,33,66,4,21
62,44,3,41,62,7,20
56,37,2,35,56,2,22
56,30,1,29,56,5,19
54,31,2,29,57,4,18
51,37,4,33,60,3,18
48,41,8,33,65,4,20
46,43,11,32,73,6,21
45,39,9,30,83,10,23
52,35,7,28,87,12,24
55,49,11,38,88,9,26
56,57,14,43,95,6,23
67,71,19,52,94,3,27
67,99,38,61,99,3,24
67,97,37,60,103,2,31
68,89,30,59,103,1,34
77,88,32,56,99,1,34
80,35,2,33,100,1,29
87,23,1,22,104,18,17
87,12,0,12,106,23,8
85,20,1,19,102,18,12
86,24,1,23,90,1,21
82,37,5,32,78,7,26
79,24,1,23,78,10,29
80,29,1,28,78,5,33
79,26,1,25,78,5,31
79,18,1,17,73,5,30
81,18,1,17,64,5,26
81,24,2,22,61,1,23
84,38,10,28,58,1,25
83,53,25,28,67,2,30
76,52,23,29,87,5,41
60,36,12,24,126,11,51
54,30,8,22,151,15,43
53,18,3,15,172,23,41
57,14,1,13,178,32,41
56,13,2,11,185,34,6
57,8,1,7,170,36,6
60,8,0,8,160,38,0
66,10,1,9,145,36,4
68,11,1,10,138,36,0
70,11,1,10,133,36,0
71,8,0,8,129,35,1
73,7,0,7,126,37,3
80,5,0,5,112,35,2
78,6,0,6,98,32,4
82,5,0,5,94,31,1
81,6,0,6,92,28,0
84,7,0,7,90,25,3
84,8,0,8,83,21,4
68,9,0,9,75,23,0
44,9,0,9,78,31,0
39,6,0,6,79,36,1
41,8,0,8,77,35,6
39,10,0,10,80,34,8
36,9,1,8,93,34,14
30,8,1,7,110,35,16
28,7,0,7,119,36,15
25,6,0,6,133,37,15
25,5,0,5,139,38,14
25,5,0,5,145,41,11
26,6,0,6,148,42,14
26,6,0,6,143,42,15
28,7,0,7,131,43,10
29,13,0,13,123,36,4
29,21,0,21,116,25,0
32,20,0,20,104,30,0
35,16,0,16,93,29,0
38,17,0,17,85,30,0
42,21,1,20,77,26,0
43,13,0,13,75,27,2
44,10,0,10,68,29,2
47,10,0,10,62,30,0
49,11,0,11,57,27,0
49,12,0,12,53,20,1
53,15,0,15,48,14,3
63,29,2,27,37,2,6
63,42,11,31,36,2,7
55,37,10,27,51,5,9
47,29,7,22,68,10,20
38,22,5,17,95,16,21
36,17,3,14,118,22,23
36,13,2,11,132,27,29
37,12,1,11,145,34,27
37,10,1,9,150,36,25
39,11,1,10,148,36,5
45,12,1,11,140,36,14
52,11,0,11,129,32,0
57,11,0,11,121,33,0
60,12,0,12,115,36,3
61,14,1,13,112,38,5
61,13,1,12,110,37,11
64,18,2,16,106,35,13
65,14,0,14,105,29,16
64,10,0,10,99,31,16
58,12,0,12,87,30,17
55,11,0,11,78,28,16
53,12,0,12,77,28,22
53,10,0,10,71,29,22
55,10,0,10,66,27,28
54,11,0,11,63,26,32
53,13,0,13,62,25,29
44,8,0,8,68,29,26
42,10,1,9,76,31,28
32,7,0,7,102,31,25
29,7,0,7,115,35,39
27,7,0,7,124,38,29
25,5,0,5,133,40,26
23,5,0,5,138,43,18
18,4,0,4,130,41,8
21,5,0,5,123,42,0
19,5,0,5,109,42,2
25,5,0,5,94,43,3
27,6,0,6,83,42,2
30,6,0,6,74,40,9
30,6,0,6,68,40,8
29,6,0,6,66,42,8
34,7,0,7,56,41,11
35,8,0,8,51,37,16
36,12,0,12,50,39,19
37,15,0,15,46,39,20
36,12,0,12,44,37,20
39,13,0,13,41,34,20
38,13,0,13,38,28,17
38,18,0,18,39,24,20
42,28,3,25,36,17,18
35,31,7,24,47,20,21
32,13,1,12,66,30,28
26,11,1,10,95,35,42
23,13,1,12,114,38,34
23,10,1,9,122,38,29
26,8,0,8,115,41,26
26,8,0,8,127,45,12
30,9,0,9,130,49,16
34,7,0,7,130,51,16
43,14,0,14,122,49,15
48,22,0,22,121,47,5
54,26,0,26,119,42,5
55,22,0,22,114,35,13
58,15,1,14,112,35,17
62,15,1,14,110,34,17
64,17,1,16,108,29,14
67,18,1,17,103,22,19
57,26,1,25,92,16,18
51,17.30477331,3.527296372,13.77747694,87,16,22
47,29,1,28,77,14,25
44,19,0,19,72,18,24
42,17,0,17,69,19,23
46,21,0,21,63,9,21
45,26,1,25,65,4,23
45,35,5,30,71,3,26
41,44,12,32,80,24.21751822,29
42,37,9,28,89,8,28
41,17.30829244,3.527287792,13.78100465,114,11,36
42,39,10,29,125,15,45
43,32,6,26,137,18,38
48,30,5,25,155,21,33
44,29,5,24,170,24,43
43,36,5,31,171,26,32
46,54,6,48,160,17,6
59,63,5,58,150,12,17
63,77,16,61,141,15,0
64,80,22,58,134,3,7
65,73,17,56,128,1,10
72,28,2,26,122,15,17
61,17,1,16,113,25,14
51,11,0,11,112,22,15
43,14,0,14,108,29,18
42,11,0,11,107,32,12
42,11,0,11,105,31,16
43,12,0,12,103,29,16
43,13,0,13,103,25,16
44,17,0,17,102,22,17
48,14,0,14,102,30,18
49,12,0,12,103,35,23
50,11,0,11,104,34,24
50,8,0,8,102,39,26
48,7,0,7,105,38,25
47,6,0,6,106,38,24
45,6,0,6,112,38,26
45,6,0,6,117,40,24
41,6,0,6,125,42,30
41,7,0,7,124,45,32
46,7,0,7,114,45,33
49,12,1,11,102,44,18
53,16,1,15,94,42,11
57,19,1,18,88,41,15
58,22,1,21,85,39,20
59,13,0,13,86,38,23
58,11,0,11,80,38,25
57,14,0,14,78,36,20
58,16,0,16,78,28,22
34,17,0,17,73,31,21
36,13,0,13,65,32,10
42,13,0,13,56,27,11
43,17,0,17,51,20,13
43,17,0,17,46,23,15
44,35,6,29,44,15,15
42,43,11,32,57,13,21
35,16,2,14,73,28,35
32,11,1,10,82,32,23
29,8,0,8,93,32,24
29,7,0,7,96,34,22
35,7,0,7,97,34,18
38,7,0,7,99,37,24
38,9,0,9,103,36,20
39,7,0,7,105,38,18
41,9,0,9,104,40,18
42,15,1,14,101,40,18
43,20,1,19,98,32,17
48,16,0,16,94,35,16
58,22,1,21,88,32,16
67,22,1,21,83,27,17
74,17,0,17,78,27,20
79,14,0,14,75,28,18
81,14,0,14,69,20,15
86,19,0,19,67,23,20
86,9,0,9,62,28,20
82,10,0,10,63,26,25
73,14,0,14,63,17,28
69,26,1,25,64,12,27
67,29,2,27,62,4,26
63,31,3,28,58,8,27
66,28,3,25,59,15,21
73,26,3,23,60,11,24
77,28,4,24,63,11,25
79,31,5,26,66,11,25
84,32,4,28,66,8,23
87,34,4,30,66,6,24
89,37,5,32,66,7,24
90,45,8,37,69,5,23
91,37,4,33,72,3,25
92,41,6,35,76,2,23
92,33,3,30,79,5,19
91,20,1,19,76,15,19
91,14,0,14,75,15,15
91,19,1,18,75,17,17
90,21,1,20,74,18,18
89,17,0,17,73,19,18
89,18,1,17,73,16,17
88,18,0,18,74,14,18
89,14,0,14,72,16,20
89,11,0,11,72,18,22
89,8,0,8,70,26,18
87,12,0,12,69,25,15
87,15,0,15,70,19,15
85,18,1,17,72,17,17
81,18,2,16,76,16,16
78,15,2,13,83,20,19
67,11,1,10,97,23,19
54,11,2,9,118,24,21
50,8,1,7,123,30,31
47,7,0,7,132,35,23
45,8,0,8,133,37,18
43,9,0,9,135,39,18
43,14,0,14,125,36,13
47,17,0,17,115,33,4
49,32,3,29,106,23,0
52,55,8,47,103,6,5
58,55,8,47,100,1,12
63,58,10,48,99,1,18
50,71,21,50,92,4,19
40,21,1,20,85,33,11
40,10,0,10,78,37,8
40,9,0,9,71,33,10
41,8,0,8,72,39,16
45,6,0,6,64,40,26
44,9,0,9,58,36,25
42,12,0,12,58,33,19
42,13,0,13,62,32,21
38,21,2,19,72,33,27
29,13,1,12,96,37,38
24,6,0,6,115,41,40
18,6,0,6,125,39,27
18,5,0,5,129,40,22
17,5,0,5,138,40,24
13,5,0,5,141,42,28
20,5,0,5,145,45,22
21,6,0,6,144,49,28
22,6,0,6,133,50,30
29,12,0,12,121,48,9
38,14,1,13,106,49,9
39,14,0,14,98,42,13
41,19,0,19,94,37,18
41,19,0,19,92,36,22
38,19,0,19,96,33,23
41,17,0,17,90,35,23
41,14,0,14,83,33,25
39,10,0,10,79,35,26
40,8,0,8,74,35,28
47,8,0,8,67,27,30
45,11,0,11,59,24,26
47,13,0,13,59,20,28
44,13,0,13,60,20,29
43,13,0,13,64,22,29
53,15,1,14,64,20,31
67,20,2,18,54,18,36
73,18,2,16,56,26,29
75,12,1,11,60,28,26
79,12,1,11,62,32,30
80,10,0,10,66,32,28
81,10,0,10,68,36,29
86,11,0,11,69,35,28
88,12,0,12,68,33,24
89,11,0,11,69,31,27
90,10,0,10,68,29,26
90,11,0,11,68,27,29
90,12,0,12,67,28,29
90,11,0,11,65,29,26
91,9,0,9,64,31,21
91,7,0,7,63,29,20
92,6,0,6,64,29,20
92,17.31502015,3.515600046,13.7994201,64,28,17
92,7,0,7,64,29,14
93,7,0,7,67,30,17
93,7,0,7,69,30,12
93,9,0,9,72,29,11
93,11,0,11,74,26,8
93,12,0,12,77,25,4
93,15,1,14,80,24,6
93,15,1,14,84,22,8
93,14,1,13,87,22,12.4737236
92,13,1,12,89,24.23488899,12.4737236
91,14,1,13,91,24.23488899,12.4737236
90,10,0,10,93,28,12.4737236
88,17.31214058,3.514148669,13.79799191,88,31,12.4737236
87,8,0,8,84,32,12.4737236
83,9,0,9,79,33,12.4737236
85,10,0,10,72,33,12.4737236
85,11,0,11,67,34,12.4737236
85,11,0,11,64,34,12.4737236
83,11,0,11,63,36,12.4737236
86,8,0,8,59,39,12.4737236
86,7,0,7,58,38,12.4737236
86,5,0,5,57,36,12.4737236
86,4,0,4,56,39,12.4737236
83,3,0,3,54,41,12.4737236
77,4,0,4,53,43,12.4737236
82,5,0,5,53,37,12.4737236
83,9,0,9,55,27,12.4737236
82,15,0,15,54,16,12.4737236
83,30,2,28,54,18,12.4737236
81,34,6,28,61,14,12.4737236
71,24,5,19,85,16,12.4737236
56,9,1,8,112,28,12.4737236
50,8,1,7,130,32,12.4737236
41,6,0,6,135,36,28
40,6,0,6,144,39,28
37,6,0,6,151,43,19
35,6,0,6,153,46,15
31,6,0,6,152,46,15
41,7,0,7,138,47,17
50,10,0,10,123,42,6
55,11,0,11,108,44,12
58,12,0,12,102,44,11
63,21,1,20,96,37,16
64,14,0,14,91,34,23
63,20,0,20,93,34,23
67,15,0,15,90,33,25
69,10,0,10,90,34,25
68,10,0,10,91,30,23
72,12,0,12,86,25,27
73,10,0,10,85,25,23
76,13,0,13,83,15,27
78,20,0,20,81,8,25
80,31,2,29,82,5,33
79,41,9,32,87,6,42
75,44,12,32,94,8,38
69,45,11,34,102,6,37
66,41,10,31,113,9,37
65,39,7,32,119,13,35
64,41,8,33,126,15,34
63,40,7,33,135,15,34
63,39,4,35,138,16,32
58,31,3,28,139,25,18
64,27,2,25,137,32,8
69,35,1,34,131,24,11
72,45,5,40,128,10,10
73,45,4,41,128,3,15
75,53,7,46,123,2,18
78,38,3,35,118,5,21
81,32,2,30,116,3,21
86,28,2,26,110,1,21
88,25,1,24,105,2,27
89,31,2,29,102,5,33
90,20,1,19,99,10,33
90,18,0,18,96,12,30
91,17,0,17,96,11,30
89,16,0,16,90,15,31
89,15,0,15,83,23,21
91,13,0,13,79,28,15
91,14,1,13,82,29,9
90,14,1,13,82,28,12
87,12,1,11,89,27,13
86,11,1,10,95,28,17
84,8,1,7,98,28,12
78,7,0,7,97,32,11
81,8,0,8,95,33,8
86,10,0,10,88,29,3
87,11,0,11,87,33,0
84,16,1,15,86,37,4
85,13,1,12,82,42,5
85,12,0,12,78,43,4
80,12,0,12,71,43,5
68,11,0,11,69,41,5
55,9,0,9,67,44,6
56,9,0,9,61,39,14
55,8,0,8,55,35,20
57,7,0,7,49,37,17
47,6,0,6,51,40,15
46,5,0,5,49,39,7
53,7,0,7,39,34,4
52,9,0,9,37,30,6
52,12,0,12,37,30,4
49,11,1,10,49,26,5
41,10,1,9,70,27,0
33,9,1,8,86,34,12.48950703
29,5,0,5,98,36,0
26,5,0,5,105,34,19
25,4,0,4,108,37,13
26,4,0,4,116,37,5
22,4,0,4,118,38,5
23,5,0,5,115,39,7
26,5,0,5,102,38,5
27,6,0,6,89,39,6
30,12,0,12,81,36,0
36,14,0,14,70,29,3
38,15,0,15,65,26,5
38,38,3,35,60,24,8
39,42,4,38,56,26,10
41,48,9,39,53,23,11
45,37,4,33,49,23,11
43,40,6,34,46,22,10
43,35,4,31,42,29,9
51,34,4,30,39,21,9
54,35,7,28,31,5,9
54,43,15,28,28,8,12
56,30,5,25,28,14,9
48,23,4,19,45,13,13
44,19,4,15,65,20,23
35,19,4,15,92,25,29
36,26,6,20,118,26,29
40,26,5,21,138,26,34
41,19,3,16,151,32,26
41,13,1,12,155,36,14
31,11,1,10,162,41,10
19,8,0,8,163,41,8
28,9,0,9,151,42,8
38,9,0,9,143,46,2
44,10,0,10,137,45,0
45,10,0,10,133,44,0
44,11,0,11,132,44,4
42,8,0,8,131,44,5
46,8,0,8,126,44,4
49,7,0,7,125,45,7
53,6,0,6,125,45,6
55,6,0,6,121,45,6
56,7,0,7,117,42,6
54,9,0,9,95,33,6
53,12,0,12,78,22,8
54,18,0,18,73,12,5
54,27,3,24,72,8,12
53,32,8,24,81,9,19
43,19,4,15,110,18,31
38,14,2,12,131,23,33
35,12,1,11,149,27,35
36,10,0,10,157,36,24
34,11,0,11,165,39,20
39,15,1,14,166,40,23
44,11,0,11,163,39,4
49,9,0,9,161,43,9
54,10,0,10,158,42,1
56,29,3,26,153,33,3
57,26,2,24,149,26,11
62,26,2,24,146,23,15
65,18,1,17,141,22,12
73,16,1,15,135,24,10
79,12,0,12,129,26,7
83,7,0,7,122,31,1
85,6,0,6,115,35,3
88,17.31019817,3.502697418,13.80750075,112,37,0
89,4,0,4,111,35,0
90,3,0,3,109,36,0
91,3,0,3,107,35,2
92,7,0,7,107,29,0
91,6,0,6,102,29,0
90,6,0,6,102,32,0
86,6,0,6,105,32,0
82,10,1,9,110,24.26476986,1
67,17.30657288,3.501649501,13.80492338,129,27,4
63,8,1,7,131,30,10
60,11,1,10,136,27,2
65,12,1,11,140,28,6
59,13,2,11,155,26,11
52,14,2,12,167,26,22
50,18,1,17,163,28,18
37,14,0,14,160,35,13
41,9,0,9,146,39,0
40,7,0,7,137,38,0
43,9,0,9,124,37,0
43,7,0,7,117,40,0
42,6,0,6,113,42,0
43,7,0,7,109,42,0
43,5,0,5,104,43,1
40,5,0,5,101,45,2
40,4,0,4,100,47,6
42,4,0,4,97,46,3
45,7,0,7,90,40,6
48,13,0,13,85,30,7
49,16,0,16,81,24,6
46,18,1,17,88,26,10
38,20,2,18,108,27,14
31,14,1,13,135,31,27
28,13,1,12,152,33,26
29,14,1,13,164,35,25
31,14,1,13,165,35,25
29,13,1,12,163,37,0
28,12,0,12,170,42,16
28,14,0,14,174,40,12
32,26,1,25,160,40,10
33,24,0,24,151,45,0
37,24,0,24,146,41,2
44,23,0,23,135,34,7
49,16,0,16,127,43,8
54,17,0,17,122,39,9
58,25,1,24,122,30,11
63,26,1,25,108,27,17
65,19,0,19,101,30,14
66,16,0,16,94,30,11
67,11,0,11,89,29,10
68,12,0,12,85,26,17
70,16,0,16,84,21,15
72,26,1,25,81,5,15
74,42,8,34,79,7,15
67,37,8,29,95,15,18
57,37,9,28,122,17,35
33,52,15,37,158,19,35
22,24,4,20,172,32,29
20,9,0,9,177,44,24
28,15,1,14,177,39,19
28,13,1,12,179,47,0
26,10,0,10,169,52,23
14,9,0,9,162,48,0
20,7,0,7,147,41,0
21,7,0,7,132,41,0
20,6,0,6,116,41,0
33,6,0,6,92,40,0
33,6,0,6,81,39,0
34,5,0,5,73,38,0
35,5,0,5,65,37,0
35,6,0,6,60,36,0
36,6,0,6,56,34,3
39,7,0,7,50,37,4
41,9,0,9,45,32,2
43,10,0,10,43,25,4
46,17,0,17,38,12,5
46,30,2,28,36,9,5
43,40,9,31,47,9,7
36,16,2,14,65,23,10
33,9,1,8,82,31,20
29,8,1,7,102,34,18
26,6,0,6,114,34,15
21,5,0,5,121,35,11
16,4,0,4,125,41,15
16,4,0,4,127,42,8
16,5,0,5,122,44,7
17,5,0,5,122,45,5
24,8,0,8,115,42,11
20,15,0,15,109,40,9
24,14,0,14,98,37,2
25,17,0,17,89,30,2
24,19,0,19,85,25,6
27,32,2,30,79,26,6
33,29,1,28,71,18,8
37,24,1,23,66,14,12
37,23,0,23,61,12,13
38,25,0,25,57,24,9
39,27,0,27,52,23,8
43,23,0,23,46,22,8
44,16,0,16,45,19,13
47,17,0,17,41,17,14
48,30,3,27,36,11,15
46,39,10,29,45,12,17
35,27,6,21,78,16,30
23,16,2,14,113,28,34
20,7,0,7,128,35,29
24,8,0,8,129,38,25
25,9,0,9,139,42,17
25,10,0,10,141,43,12
31,14,1,13,142,46,15
35,13,0,13,138,50,16
38,10,0,10,132,51,13
43,13,0,13,127,51,5
47,18,0,18,124,49,6
49,18,0,18,120,48,11
47,18,0,18,118,43,16
37,19,0,19,119,42,19
40,17,0,17,116,35,18
40,18,0,18,117,36,22
38,15,0,15,111,44,20
51,17,0,17,95,24,19
67,27,0,27,78,12,17
69,18,1,17,70,22,12
71,11,0,11,64,27,8
72,15,0,15,62,21,15
71,19,1,18,61,21,17
65,24,3,21,69,19,17
61,21,3,18,76,21,21
53,23,5,18,102,21,23
46,18,3,15,110,24,34
43,12,1,11,117,30,27
44,9,0,9,125,37,24
45,6,0,6,126,44,17
37,5,0,5,133,45,11
35,5,0,5,128,49,17
49,6,0,6,113,50,17
56,8,0,8,103,47,2
61,8,0,8,88,45,1
60,8,0,8,84,45,1
61,11,1,10,84,40,4
60,14,0,14,78,33,8
42,10,0,10,71,32,8
36,7,0,7,66,33,4
32,5,0,5,68,38,7
34,5,0,5,64,37,8
36,5,0,5,57,37,10
37,6,0,6,56,37,11
38,6,0,6,52,36,11
40,7,0,7,48,34,12
36,8,0,8,50,34,11
35,10,1,9,66,32,14
30,7,0,7,89,34,28
26,7,0,7,109,34,28
22,7,0,7,120,35,28
24,8,0,8,128,38,20
24,8,0,8,136,40,6
24,8,0,8,139,40,8
27,10,0,10,145,43,18
26,10,0,10,138,45,16
26,12,0,12,131,45,1
46,10,0,10,113,46,0
45,7,0,7,103,45,0
47,8,0,8,95,44,6
51,9,0,9,85,39,9
47,9,0,9,85,38,7
43,8,0,8,78,38,10
46,7,0,7,69,37,9
46,8,0,8,64,36,8
46,17.28535729,3.485181564,13.80017573,59,34,9
41,9,0,9,61,39,7
45,9,0,9,54,39,2
46,5,0,5,49,35,3
45,11,0,11,48,23,2
42,17,1,16,51,22,4
38,13,1,12,60,29,15
33,10,1,9,76,29,20
26,7,0,7,105,24.3255252,31
19,17.2831502,3.484222889,13.79892731,119,32,23
20,15,2,13,128,32,16
14,13,1,12,134,31,9
14,13,1,12,142,37,4
18,13,1,12,141,42,4
22,13,1,12,143,43,6
29,11,0,11,130,47,3
44,11,0,11,123,47,0
45,13,0,13,120,46,0
51,15,0,15,116,41,0
54,15,0,15,115,40,7
54,20,0,20,116,42,7
55,17,0,17,116,40,7
55,12,0,12,119,36,7
49,10,0,10,120,36,10
48,9,0,9,109,34,8
55,22,0,22,94,17,8
59,27,0,27,87,10,10
60,33,1,32,82,8,10
62,41,5,36,76,4,12
61,44,11,33,75,3,14
54,31,7,24,86,7,17
49,30,7,23,105,16,32
37,27,5,22,134,18,32
29,34,6,28,156,21,26
22,37,7,30,189,23,27
23,25,3,22,179,25,28
19,21,2,19,193,35,23
26,18,1,17,190,42,4
34,16,1,15,183,43,18
36,14,0,14,167,44,2
39,17,0,17,160,44,0
40,28,1,27,157,36,0
42,38,1,37,153,27,4
44,57,7,50,148,12,11
48,68,12,56,140,3,13
50,51,3,48,133,3,14
46,35,1,34,124,10,14
44,27,0,27,109,14,15
49,30,0,30,99,14,22
55,22,0,22,91,10,21
56,22,0,22,84,9,17
55,28,1,27,81,11,17
56,32,2,30,77,6,17
55,42,8,34,80,4,18
51,44,12,32,98,11,25
39,42,11,31,134,17,34
31,21,3,18,169,26,36
23,13,1,12,191,35,41
21,7,0,7,197,40,30
19,7,0,7,205,44,10
16,6,0,6,210,45,13
19,7,0,7,215,51,16
23,11,0,11,210,55,19
26,16,0,16,195,58,11
24,18,0,18,185,56,0
33,25,0,25,172,45,0
47,19,0,19,159,30,10
53,18,1,17,152,29,11
56,23,1,22,150,33,13
62,18,1,17,149,38,13
65,15,1,14,147,45,13
65,12,0,12,148,47,13
61,11,0,11,146,45,12
61,14,0,14,145,44,11
61,14,0,14,145,42,11
60,11,0,11,150,43,10
62,10,0,10,150,40,11
67,14,0,14,150,39,11
72,22,1,21,147,40,11
69,17,1,16,155,35,11
68,16,1,15,164,36,15
68,13,1,12,171,34,12
57,9,1,8,185,35,12
45,9,1,8,209,36,15
45,9,1,8,207,40,21
52,6,0,6,203,42,18
57,6,0,6,199,41,0
66,6,0,6,185,39,9
66,10,0,10,182,38,0
68,11,0,11,183,35,0
70,9,0,9,183,36,1
72,10,0,10,183,37,7
77,7,0,7,180,31,4
76,8,0,8,181,31,5
77,8,0,8,180,29,8
77,10,0,10,179,31,6
79,10,0,10,170,24,6
78,11,0,11,168,18,5
73,15,0,15,158,14,5
76,23,1,22,148,8,7
83,27,2,25,143,4,5
77,24,4,20,147,6,7
72,27,8,19,156,11,9
66,20,5,15,172,13,18
53,15,3,12,201,21,24
42,8,1,7,211,30,34
33,8,0,8,219,42,31
27,7,0,7,223,45,7
26,7,0,7,221,46,0
24,9,0,9,202,45,2
25,9,0,9,190,43,0
21,10,0,10,185,41,0
22,9,0,9,171,41,5
24,11,0,11,151,36,0
26,12,0,12,135,38,0
28,8,0,8,121,41,2
33,6,0,6,113,42,0
40,5,0,5,98,41,0
35,5,0,5,94,39,0
32,4,0,4,91,41,0
33,3,0,3,85,41,2
32,4,0,4,82,42,1
32,3,0,3,79,40,4
31,4,0,4,77,38,5
32,5,0,5,76,37,5
33,7,0,7,74,34,6
37,5,0,5,72,39,6
41,5,0,5,68,39,7
47,6,0,6,67,36,9
62,7,0,7,57,36,7
58,8,0,8,64,31,9
59,11,1,10,66,31,12
46,10,1,9,74,32,8
46,7,0,7,79,34,11
61,7,0,7,69,33,13
64,7,0,7,66,33,4
63,12,1,11,65,33,0
67,13,1,12,63,32,4
67,12,0,12,64,30,9
62,10,0,10,64,32,7
60,9,0,9,64,35,8
59,11,0,11,62,33,8
58,20,1,19,59,31,5
43,25,1,24,50,27,4
64,16,0,16,45,25,6
63,12,0,12,41,21,7
60,14,0,14,41,26,7
53,13,0,13,36,26,8
64,12,0,12,30,23,9
47,14,1,13,32,19,8
37,11,1,10,48,24,13
30,9,1,8,79,30,22
24,7,0,7,103,37,24
21,4,0,4,115,38,7
20,3,0,3,126,39,2
16,3,0,3,132,38,6
16,3,0,3,137,39,17
16,3,0,3,139,43,15
17,4,0,4,138,43,14
17,4,0,4,126,44,12
19,5,0,5,114,44,12
21,9,0,9,106,40,0
24,18,0,18,98,34,0
31,10,0,10,88,33,3
31,7,0,7,78,37,7
33,8,0,8,70,37,6
35,8,0,8,63,35,5
40,7,0,7,56,30,9
43,17.27063774,3.469613031,13.80102471,48,21,11
45,11,0,11,40,26,10
47,12,0,12,36,24,9
49,13,0,13,32,20,12
49,18,0,18,31,17,17
46,25,3,22,40,16,15
44,27,5,22,52,20,16
41,27,6,21,79,21,19
38,17.27110118,3.469219199,13.80188198,111,24.3720639,26
37,10,1,9,129,27,36
35,9,1,8,141,30,35
37,11,1,10,137,38,24
34,10,0,10,133,43,10
39,15,1,14,141,39,5
37,15,1,14,138,42,12
40,13,0,13,139,43,8
38,16,0,16,138,39,6
40,24,0,24,135,26,5
41,46,2,44,129,10,12
43,35,1,34,124,15,14
46,22,0,22,120,19,13
50,24,1,23,116,23,9
55,21,1,20,113,24,11
59,18,0,18,111,25,16
61,15,0,15,107,15,15
59,21,0,21,103,12,16
56,25,1,24,100,12,21
56,28,1,27,98,5,24
58,30,1,29,96,2,25
59,40,7,33,94,3,25
59,39,8,31,99,6,23
56,35,6,29,100,4,28
62,36,8,28,103,6,26
57,30,5,25,113,10,25
57,26,3,23,117,11,30
53,26,3,23,124,16,26
49,24,3,21,136,23,25
42,18,2,16,155,31,29
37,14,1,13,164,35,32
40,12,0,12,154,40,25
42,19,1,18,147,41,6
43,27,1,26,140,35,6
29,34,1,33,139,33,7
28,12,0,12,133,48,12
36,8,0,8,127,58,13
37,6,0,6,121,62,11
39,5,0,5,116,58,17
37,5,0,5,108,54,15
34,5,0,5,101,48,10
35,4,0,4,94,47,9
32,4,0,4,87,44,10
32,4,0,4,82,42,8
32,8,0,8,78,32,10
33,12,0,12,83,22,11
29,20,2,18,95,24,20
20,18,2,16,133,27,27
18,19,2,17,156,28,35
27,30,4,26,165,25,31
40,16,1,15,173,38,21
44,14,1,13,170,44,19
49,10,0,10,172,56,15
36,9,0,9,178,54,20
22,16,0,16,192,46,18
23,15,0,15,187,47,26
26,20,0,20,178,44,4
30,18,0,18,170,49,14
30,15,0,15,166,47,13
31,14,0,14,161,47,16
28,14,0,14,160,47,19
27,13,0,13,160,51,19
25,11,0,11,160,53,19
26,9,0,9,161,58,20
26,7,0,7,162,59,15
28,8,0,8,161,58,14
26,7,0,7,164,58,19
28,7,0,7,163,56,20
37,10,0,10,142,50,19
41,10,0,10,135,52,12
40,12,0,12,141,45,6
34,11,0,11,150,48,11
38,9,0,9,149,49,13
51,7,0,7,150,43,11
48,6,0,6,150,43,11
51,7,0,7,142,46,10
57,11,0,11,137,42,4
38,10,0,10,141,43,3
42,10,0,10,151,44,11
49,11,0,11,128,35,12
49,11,0,11,123,39,2
55,17,1,16,115,38,0
55,8,0,8,109,39,1
55,9,0,9,106,40,5
53,10,0,10,103,40,8
52,9,0,9,103,38,8
53,8,0,8,98,40,10
45,6,0,6,94,38,5
34,3,0,3,81,40,8
39,3,0,3,80,42,6
42,4,0,4,74,39,8
43,5,0,5,72,37,7
43,6,0,6,72,36,7
41,8,0,8,69,32,8
36,9,0,9,70,33,5
36,8,0,8,72,31,7
39,8,0,8,74,30,8
42,6,0,6,78,31,6
42,5,0,5,81,34,10
42,5,0,5,83,35,12
41,5,0,5,85,34,9
42,6,0,6,83,33,7
46,6,0,6,86,35,7
50,7,0,7,80,35,7
52,13,1,12,78,35,7
53,15,1,14,78,33,6
55,12,0,12,78,34,9
56,11,0,11,78,33,12
58,11,0,11,78,30,10
60,8,0,8,79,32,14
59,10,0,10,76,32,10
60,9,0,9,75,32,10
62,6,0,6,75,34,9
70,4,0,4,73,37,10
70,4,0,4,73,37,7
74,7,0,7,73,32,11
73,11,0,11,73,25,10
71,13,1,12,74,19,14
69,14,1,13,79,20,14
65,17,1,16,81,19,17
63,18,2,16,87,20,20
65,10,0,10,96,21,25
64,7,0,7,99,31,22
65,7,0,7,99,33,19
64,6,0,6,103,33,15
65,6,0,6,108,36,13
69,5,0,5,106,35,13
70,6,0,6,106,34,10
72,7,0,7,102,32,13
72,14,2,12,94,33,13
79,9,0,9,89,31,13
84,11,0,11,82,22,14
88,12,0,12,80,17,15
88,12,0,12,79,15,20
88,11,0,11,81,19,19
89,12,0,12,79,14,20
89,10,0,10,78,14,18
89,9,0,9,77,17,19
89,6,0,6,79,20,14
89,6,0,6,81,20,9
90,6,0,6,82,22,14
90,4,0,4,81,28,10
88,5,0,5,86,32,5
82,5,0,5,94,30,10
74,7,1,6,107,31,17
74,6,0,6,108,32,24
64,6,1,5,121,31,15
56,6,0,6,138,40,26
46,5,0,5,148,44,26
43,5,0,5,150,48,25
38,5,0,5,156,49,18
38,6,0,6,151,50,12
48,7,0,7,145,47,10
25,8,0,8,137,41,2
29,7,0,7,121,41,0
34,5,0,5,111,43,0
40,5,0,5,99,43,0
42,5,0,5,96,42,0
44,5,0,5,90,42,0
49,5,0,5,80,41,0
47,17.23962959,3.451502756,13.78812683,77,39,0
47,5,0,5,75,38,1
51,5,0,5,67,38,1
51,6,0,6,62,32,2
46,10,0,10,64,31,0
45,17,1,16,70,28,8
38,10,1,9,87,31,17
31,9,1,8,110,33,18
26,9,1,8,131,24.43600187,16
21,17.23708424,3.450604619,13.78647962,142,37,16
17,5,0,5,152,40,16
16,5,0,5,150,45,18
18,5,0,5,142,49,13
34,12,0,12,128,39,0
34,15,0,15,124,40,0
48,18,0,18,105,40,4
54,14,0,14,94,42,1
59,9,0,9,82,46,0
76,7,0,7,75,47,0
76,5,0,5,63,44,0
80,4,0,4,58,44,0
80,4,0,4,54,42,1
80,4,0,4,50,42,3
82,4,0,4,44,41,5
84,4,0,4,44,41,5
83,4,0,4,41,40,8
83,4,0,4,37,36,4
83,6,0,6,37,31,6
72,9,0,9,36,19,2
54,19,2,17,46,21,10
38,16,2,14,63,31,20
32,8,1,7,81,39,23
26,6,0,6,98,40,16
22,6,0,6,113,38,19
17,5,0,5,118,41,21
15,4,0,4,126,42,17
26,8,0,8,113,42,18
27,12,0,12,109,39,5
36,12,0,12,106,41,1
34,12,0,12,102,41,8
26,10,0,10,100,41,7
27,6,0,6,85,42,4
31,6,0,6,72,43,0
32,7,0,7,69,42,2
35,6,0,6,62,42,5
41,6,0,6,56,41,8
44,5,0,5,51,40,5
43,5,0,5,49,41,7
44,5,0,5,48,39,7
40,5,0,5,46,40,9
40,5,0,5,44,37,7
42,8,0,8,40,32,10
42,11,0,11,38,21,10
40,15,1,14,45,19,11
31,13,1,12,61,28,20
24,10,1,9,87,37,17
25,6,0,6,94,41,13
23,5,0,5,101,41,14
20,4,0,4,114,41,13
20,4,0,4,119,42,14
19,4,0,4,122,42,12
21,4,0,4,124,44,12
20,4,0,4,124,45,11
20,4,0,4,112,45,11
24,5,0,5,101,45,7
26,6,0,6,93,44,2
29,9,0,9,87,40,2
31,11,0,11,81,37,9
33,13,0,13,75,34,9
34,13,0,13,72,31,9
34,17,0,17,71,30,13
37,16,0,16,63,33,14
39,12,0,12,59,28,13
39,17,0,17,54,25,14
39,17,0,17,51,26,14
41,17,0,17,47,24,14
41,26,3,23,43,22,14
42,50,17,33,48,11,16
39,31,7,24,67,12,29
26,24,5,19,105,17,31
15,19,3,16,127,30,28
14,11,1,10,141,37,23
17,24,4,20,153,38,23
19,26,4,22,149,34,21
21,15,1,14,151,43,11
20,16,1,15,158,47,15
20,11,0,11,160,51,12
28,10,0,10,146,52,0
35,11,0,11,142,54,7
39,19,0,19,138,52,0
43,23,0,23,136,46,7
49,25,0,25,130,37,15
51,26,1,25,126,33,17
55,25,1,24,126,31,18
53,28,1,27,123,21,18
54,33,1,32,114,12,20
50,43,1,42,104,7,20
48,41,2,39,99,13,19
50,41,2,39,92,5,18
52,41,3,38,87,2,15
52,63,23,40,85,1,18
48,81,37,44,91,6,22
46,74,31,43,106,8,27
41,54,15,39,147,12,36
31,52,12,40,169,14,46
27,28,4,24,187,24,30
25,15,1,14,195,37,23
22,12,1,11,202,42,5
23,11,0,11,209,46,22
17,10,0,10,211,49,6
21,12,0,12,208,50,17
23,12,0,12,199,49,6
29,15,0,15,191,50,8
30,13,0,13,186,53,4
31,12,0,12,184,51,8
32,12,0,12,182,51,12
34,15,0,15,175,51,13
34,25,1,24,170,51,12
35,33,1,32,161,47,12
39,19,0,19,152,36,13
32,12,0,12,146,44,20
36,5,0,5,140,59,12
36,5,0,5,133,57,1
36,6,0,6,126,51,5
36,7,0,7,125,42,7
34,15,0,15,125,37,15
28,9,0,9,139,43,21
22,6,0,6,165,45,32
19,6,0,6,182,46,22
18,5,0,5,193,46,27
17,5,0,5,201,49,30
16,5,0,5,211,50,17
15,6,0,6,210,53,20
18,8,0,8,214,62,18
23,9,0,9,210,68,24
27,11,0,11,194,71,20
35,13,0,13,184,70,5
48,21,0,21,172,60,15
59,14,0,14,164,49,10
62,14,1,13,163,43,11
65,15,0,15,159,39,13
24,21,1,20,150,35,18
28,18,0,18,140,30,9
36,19,0,19,128,28,4
37,15,0,15,117,26,6
35,7,0,7,110,34,6
37,7,0,7,106,33,7
38,8,0,8,105,30,9
38,10,0,10,107,27,11
43,10,0,10,114,24,12
52,9,0,9,128,29,17
60,5,0,5,151,33,20
54,5,0,5,169,40,31
46,5,0,5,188,41,31
41,6,0,6,198,47,32
40,6,0,6,204,49,20
36,7,0,7,215,56,18
32,7,0,7,221,58,23
31,8,0,8,222,63,27
34,13,0,13,205,69,18
35,19,0,19,198,67,9
39,27,1,26,189,56,5
60,16,0,16,175,43,21
67,11,0,11,163,38,7
70,10,0,10,154,41,10
71,6,0,6,149,46,10
73,6,0,6,145,44,11
74,5,0,5,143,41,11
60,17.21831381,3.437364211,13.78094959,131,46,11
61,3,0,3,123,50,6
54,3,0,3,115,51,5
50,3,0,3,108,49,7
49,3,0,3,105,48,5
63,4,0,4,97,45,7
69,6,0,6,85,42,7
65,6,0,6,83,24.52916122,12.47003265
68,5,0,5,82,40,0
55,17.21435483,3.436324869,13.77802996,92,36,7
50,6,0,6,101,36,15
41,5,0,5,113,37,10
39,4,0,4,126,39,17
40,4,0,4,127,43,22
48,5,0,5,113,44,11
76,6,0,6,93,44,0
81,14,1,13,82,40,0
84,10,0,10,74,39,0
82,9,0,9,74,41,1
88,17.21088161,3.435194186,13.77568743,75,35,6
88,17.21088161,3.435194186,13.77568743,72,34,7
80,10,0,10,67,36,8
81,9,0,9,64,35,8
81,8,0,8,58,36,8
83,8,0,8,56,28,5
82,9,0,9,54,29,8
81,11,0,11,53,22,7
69,13,0,13,55,22,10
66,22,1,21,58,25,5
61,15,1,14,66,23,8
52,10,1,9,79,30,14
39,8,1,7,108,33,6
33,6,0,6,119,37,10
27,5,0,5,133,38,7
22,4,0,4,143,39,5
21,4,0,4,148,39,6
22,4,0,4,152,40,6
22,4,0,4,154,41,9
21,5,0,5,149,42,7
26,4,0,4,135,41,4
26,5,0,5,126,42,0
25,6,0,6,117,41,0
27,8,0,8,112,35,0
28,14,0,14,107,32,4
30,18,0,18,107,31,4
31,21,1,20,105,30,6
32,20,0,20,102,27,7
36,17,0,17,99,22,5
38,13,0,13,97,26,6
38,10,0,10,95,28,6
38,10,0,10,93,32,6
44,8,0,8,92,33,5
61,8,0,8,81,36,5
72,14,0,14,74,32,2
79,16,1,15,70,27,4
82,15,1,14,67,23,3
85,16,1,15,65,22,6
87,20,2,18,65,24,3
88,19,1,18,59,22,9
88,19,1,18,59,20,5
88,9,0,9,59,20,9
89,9,0,9,53,22,9
89,17,1,16,49,19,5
90,18,1,17,46,19,5
91,18,1,17,43,19,4
91,13,0,13,42,21,4
91,13,0,13,38,25,5
91,13,0,13,40,24,3
92,11,0,11,42,28,2
92,12,0,12,37,18,3
92,13,0,13,40,27,2
92,9,0,9,44,28,0
92,7,0,7,49,32,2
91,5,0,5,50,33,4
90,5,0,5,51,33,4
85,5,0,5,52,36,1
76,6,0,6,62,35,0
67,7,0,7,76,32,5
57,8,1,7,89,28,14
50,7,1,6,109,29,12
42,7,1,6,126,31,10
40,6,0,6,140,32,5
30,5,0,5,148,35,14
30,4,0,4,152,35,3
29,5,0,5,150,38,4
29,5,0,5,146,39,2
28,5,0,5,139,37,0
27,5,0,5,128,39,0
29,5,0,5,120,40,0
54,13,1,12,110,37,0
61,9,0,9,100,38,3
63,8,0,8,94,37,3
65,8,0,8,90,36,0
66,8,0,8,88,36,4
64,8,0,8,86,37,4
65,5,0,5,85,37,6
64,5,0,5,83,36,5
67,5,0,5,82,36,4
65,6,0,6,80,36,4
59,8,0,8,79,34,5
59,8,0,8,79,32,5
54,11,1,10,83,28,5
49,14,2,12,88,24,9
47,14,2,12,96,23,14
41,11,1,10,107,26,10
34,7,0,7,112,29,13
33,6,0,6,111,31,13
35,5,0,5,107,37,8
35,5,0,5,114,36,0
34,5,0,5,122,37,11
34,6,0,6,117,39,17
33,5,0,5,113,38,4
33,6,0,6,108,40,2
37,24,3,21,102,35,5
39,24,0,24,99,26,4
40,34,1,33,96,26,6
42,53,10,43,94,26,12
43,85,38,47,96,24,8
44,46,6,40,97,17,11
46,37,1,36,94,10,10
52,34,1,33,83,5,10
54,26,0,26,76,10,7
58,20,0,20,71,6,9
62,27,1,26,65,4,11
62,31,3,28,62,4,13
48,23,4,19,77,17,12
41,14,2,12,95,28,17
33,10,1,9,119,34,18
29,7,0,7,138,35,17
26,6,0,6,148,36,25
20,5,0,5,155,39,25
20,4,0,4,161,40,21
18,5,0,5,169,45,23
20,5,0,5,173,51,3
17,7,0,7,170,54,16
25,10,0,10,159,56,7
30,11,0,11,148,57,6
36,7,0,7,136,51,0
42,11,0,11,131,44,0
40,13,0,13,132,40,2
45,19,0,19,132,44,6
46,14,0,14,132,43,8
50,12,0,12,131,42,8
53,10,0,10,131,42,8
60,11,0,11,128,41,8
57,12,0,12,126,39,6
54,12,0,12,126,36,9
44,12,0,12,116,37,9
47,14,0,14,111,25,9
46,16,1,15,115,21,9
45,18,2,16,128,19,18
42,22,3,19,142,25,27
38,16,2,14,164,30,20
37,8,0,8,169,44,20
37,7,0,7,165,50,10
37,6,0,6,169,52,1
45,7,0,7,169,54,2
44,7,0,7,168,56,9
48,7,0,7,165,54,6
49,8,0,8,163,53,3
52,12,0,12,162,51,6
57,15,0,15,161,46,7
64,14,0,14,156,46,7
81,10,0,10,144,44,5
82,13,0,13,144,37,0
84,11,0,11,146,34,4
80,7,0,7,146,39,4
80,5,0,5,139,43,4
81,17.18262901,3.42012962,13.76249939,137,42,1
85,5,0,5,134,40,4
88,8,0,8,134,38,3
89,7,0,7,135,40,6
89,9,0,9,136,26,7
86,15,0,15,135,18,4
81,21,2,19,141,22,4
70,19,4,15,157,18,12
55,12,2,10,177,24.58524013,16
47,17.18107184,3.419402473,13.76166937,190,31,19
23,6,0,6,208,43,15
14,6,0,6,208,49,5
15,7,0,7,201,55,0
16,6,0,6,206,54,2
14,6,0,6,204,51,11
14,6,0,6,192,51,9
15,6,0,6,180,54,0
23,6,0,6,162,51,0
22,6,0,6,148,47,1
22,5,0,5,142,48,0
27,6,0,6,133,48,1
30,6,0,6,126,48,5
30,6,0,6,124,49,7
31,4,0,4,123,50,4
31,4,0,4,124,52,6
34,5,0,5,120,54,9
35,5,0,5,114,52,9
39,5,0,5,105,45,9
40,8,0,8,105,42,6
37,8,0,8,114,39,12
33,6,0,6,132,42,16
26,6,0,6,153,44,16
19,6,0,6,171,45,18
17,7,0,7,183,45,22
17,6,0,6,191,47,21
13,7,0,7,204,51,14
15,11,0,11,208,53,15
14,12,0,12,211,58,14
25,15,0,15,201,59,11
33,10,0,10,179,61,0
38,10,0,10,172,63,0
43,13,0,13,164,60,0
47,16,0,16,160,54,1
52,15,0,15,156,53,6
58,15,0,15,156,49,7
59,14,0,14,158,50,9
62,16,0,16,153,47,9
65,12,0,12,150,44,10
68,18,0,18,145,39,10
71,13,0,13,143,38,9
63,15,0,15,130,29,8
64,21,0,21,123,19,13
66,25,1,24,120,16,11
64,31,4,27,125,14,11
60,31,5,26,133,15,19
54,28,4,24,153,19,26
51,25,3,22,168,23,32
50,21,2,19,186,35,30
48,12,1,11,184,48,23
43,10,0,10,188,52,0
44,10,0,10,187,53,17
44,13,0,13,183,52,3
41,12,0,12,179,55,6
44,10,0,10,176,53,2
41,9,0,9,173,50,8
50,19,2,17,166,47,8
52,14,0,14,162,46,7
53,15,0,15,158,44,8
53,14,0,14,157,43,11
55,13,0,13,155,45,10
57,13,0,13,152,44,10
59,12,0,12,147,38,11
62,14,0,14,142,27,11
63,16,0,16,139,21,11
65,12,0,12,136,20,15
65,12,0,12,132,19,16
69,14,0,14,132,18,15
68,17,1,16,137,15,15
64,15,2,13,160,24,18
54,10,1,9,176,36,37
39,6,0,6,200,41,28
38,6,0,6,207,46,16
29,6,0,6,213,48,4
27,5,0,5,221,53,20
21,5,0,5,228,57,18
25,6,0,6,226,60,24
28,11,0,11,224,64,18
37,14,0,14,205,62,5
51,20,0,20,187,56,0
56,18,0,18,176,56,0
57,20,0,20,171,55,5
58,16,0,16,167,47,2
64,13,0,13,163,51,3
68,14,0,14,162,51,5
71,12,0,12,163,57,10
74,13,0,13,158,56,12
76,11,0,11,157,52,12
72,11,0,11,159,52,13
70,10,0,10,160,51,14
63,11,0,11,162,48,14
63,18,0,18,157,41,13
65,35,5,30,157,11,18
61,25,4,21,170,17,20
53,13,1,12,188,31,32
43,13,1,12,208,43,34
38,15,1,14,222,49,20
41,23,2,21,225,47,24
40,20,1,19,232,50,21
35,13,0,13,231,60,18
39,13,0,13,228,63,17
41,14,0,14,228,60,16
43,17,0,17,220,56,15
51,28,0,28,212,62,6
58,23,1,22,202,50,20
59,15,1,14,194,56,22
75,7,0,7,164,58,16
70,7,0,7,157,55,5
72,6,0,6,145,47,5
70,5,0,5,134,42,0
62,5,0,5,133,42,9
62,4,0,4,129,43,11
64,4,0,4,115,42,7
62,3,0,3,107,42,3
63,3,0,3,102,43,4
61,4,0,4,98,41,6
54,5,0,5,105,38,5
49,4,0,4,119,37,14
46,4,0,4,136,38,17
41,4,0,4,145,38,19
39,4,0,4,155,39,19
36,4,0,4,170,43,23
34,9,0,9,176,46,25
35,9,0,9,179,55,3
37,8,0,8,176,54,24
42,11,0,11,172,49,9
46,10,0,10,160,49,20
47,8,0,8,155,44,0
49,6,0,6,147,45,1
54,9,0,9,150,42,0
57,9,0,9,147,41,5
59,10,0,10,147,40,9
61,9,0,9,148,39,8
64,9,0,9,150,37,11
65,10,0,10,153,38,11
62,9,0,9,150,35,10
61,8,0,8,147,31,6
66,5,0,5,140,35,9
71,5,0,5,134,34,5
75,6,0,6,132,29,1
73,6,0,6,136,27,5
69,6,0,6,151,27,16
61,6,0,6,172,32,27
57,6,0,6,185,38,30
54,5,0,5,192,46,20
51,5,0,5,203,49,10
49,6,0,6,216,50,26
51,6,0,6,212,48,18
45,7,0,7,211,61,9
50,8,0,8,206,60,18
53,8,0,8,206,54,22
59,9,0,9,187,55,7
65,10,0,10,174,48,0
68,10,0,10,172,44,10
70,13,1,12,172,40,12
70,9,0,9,172,40,14
75,7,0,7,164,37,14
75,9,0,9,161,32,11
77,7,0,7,155,31,6
77,17.14345342,3.40087473,13.74257869,152,31,9
78,17.14345342,3.40087473,13.74257869,150,31,10
79,6,0,6,148,29,7
78,7,0,7,147,26,9
79,11,0,11,148,28,9
77,12,1,11,156,20,10
68,16,2,14,173,28,19
61,11,1,10,185,24.70303089,29
53,17.1419657,3.400262434,13.74170326,211,29,32
48,8,0,8,228,42,41
43,8,0,8,236,56,34
40,8,0,8,248,58,43
39,7,0,7,253,59,47
45,9,0,9,253,61,28
47,10,0,10,241,60,32
47,8,0,8,225,57,29
52,8,0,8,209,58,14
60,13,1,12,183,56,0
60,12,0,12,177,54,16
52,14,0,14,176,49,10
51,11,0,11,175,50,15
55,10,0,10,172,48,16
54,6,0,6,171,55,16
57,5,0,5,166,57,10
50,4,0,4,162,54,13
49,5,0,5,158,52,12
55,6,0,6,155,47,12
59,6,0,6,153,46,11
58,9,0,9,152,42,11
57,10,0,10,160,42,11
49,9,0,9,170,43,15
41,7,0,7,183,40,18
34,6,0,6,199,40,25
34,6,0,6,209,39,22
39,7,0,7,217,41,17
38,7,0,7,223,43,19
38,10,0,10,226,50,16
43,9,0,9,222,51,13
43,9,0,9,226,49,16
42,12,0,12,217,51,13
45,16,0,16,206,48,1
52,16,0,16,199,44,0
59,10,0,10,190,48,10
62,13,0,13,189,46,6
65,13,0,13,187,49,12
68,9,0,9,184,40,10
70,12,0,12,183,41,12
73,15,0,15,184,41,14
76,13,0,13,186,41,15
77,11,0,11,189,38,15
79,8,0,8,188,35,15
85,8,0,8,186,31,15
87,11,0,11,187,20,12
85,24,2,22,190,12,13
82,32,6,26,193,18,17
79,18,2,16,197,20,16
74,11,1,10,202,22,15
71,12,1,11,203,27,18
74,12,1,11,199,31,18
74,9,1,8,198,35,7
70,10,1,9,200,34,14
64,8,0,8,206,33,15
64,9,0,9,205,32,17
69,11,0,11,200,32,14
68,15,0,15,199,27,13
69,14,0,14,199,29,13
71,11,0,11,196,32,15
77,12,0,12,189,31,18
77,13,0,13,191,32,16
83,12,0,12,185,31,13
88,10,0,10,183,27,14
88,11,0,11,183,26,14
88,10,0,10,186,25,12
89,11,0,11,188,27,12
90,5,0,5,187,30,8
90,9,0,9,187,28,4
90,11,0,11,186,29,3
89,15,1,14,189,22,7
84,17,2,15,194,22,4
74,17,3,14,208,32,6
69,13,2,11,223,33,19
81,11,1,10,216,29,27
87,9,1,8,213,29,5
84,6,0,6,218,31,0
80,8,1,7,222,31,15
73,9,1,8,233,36,2
71,9,0,9,236,39,28
72,37,4,33,231,30,11
72,25,1,24,223,33,1
74,25,1,24,221,28,0
78,27,1,26,214,13,11
80,32,2,30,208,8,1
81,37,2,35,205,8,14
82,34,2,32,205,11,1
76,10,0,10,190,19,17
81,4,0,4,157,33,5
77,3,0,3,146,43,2
73,3,0,3,140,47,0
74,3,0,3,137,47,2
74,4,0,4,137,46,5
82,4,0,4,133,45,11
85,4,0,4,124,44,6
85,4,0,4,116,45,1
85,4,0,4,111,42,0
87,5,0,5,108,40,1
87,5,0,5,111,37,0
84,6,0,6,117,33,3
77,5,0,5,119,32,8
72,6,0,6,121,33,8
72,5,0,5,119,34,4
76,5,0,5,116,34,4
78,7,0,7,109,31,3
78,6,0,6,106,32,3
78,7,0,7,108,32,0
73,7,0,7,107,33,1
74,7,0,7,104,34,4
74,6,0,6,102,35,2
76,4,0,4,103,35,1
83,4,0,4,99,35,4
87,3,0,3,98,34,4
88,3,0,3,96,36,0
89,2,0,2,93,38,0
87,2,0,2,88,35,0
89,3,0,3,82,34,1
88,5,0,5,82,33,0
88,5,0,5,86,32,0
82,5,0,5,92,29,5
77,7,1,6,101,25,8
71,6,1,5,107,26,6
69,6,1,5,115,24,6
67,6,1,5,126,26,14
64,5,0,5,125,29,8
65,4,0,4,124,32,5
70,4,0,4,120,33,0
70,4,0,4,117,33,0
64,5,0,5,114,36,2
68,6,0,6,113,36,2
39,9,0,9,115,33,3
37,4,0,4,111,42,0
41,4,0,4,101,42,0
38,4,0,4,96,42,0
42,5,0,5,89,42,2
41,5,0,5,87,41,2
41,4,0,4,83,39,1
42,5,0,5,81,41,4
43,6,0,6,78,37,3
42,5,0,5,75,35,3
41,4,0,4,75,38,1
40,5,0,5,80,35,1
37,5,0,5,93,36,5
35,3,0,3,110,38,11
34,3,0,3,130,39,10
30,3,0,3,140,38,13
29,3,0,3,154,36,15
19,3,0,3,169,35,17
16,3,0,3,176,35,18
20,3,0,3,180,38,20
19,4,0,4,184,43,3
20,4,0,4,177,46,0
35,6,0,6,164,48,0
37,5,0,5,146,43,5
39,6,0,6,137,41,0
42,4,0,4,135,40,0
44,6,0,6,134,41,0
45,9,0,9,131,39,1
47,11,0,11,127,35,2
49,14,0,14,123,32,3
50,16,0,16,120,29,3
53,17.09371235,3.381873322,13.71183902,114,26,5
56,17.09371235,3.381873322,13.71183902,112,21,5
57,7,0,7,112,27,7
58,8,0,8,113,28,3
60,9,0,9,114,21,7
60,8,0,8,118,17,9
54,9,1,8,134,19,12
44,12,2,10,162,23,23
42,11,1,10,166,24.77457463,32
37,17.09164811,3.381143661,13.71050445,178,37,0
36,5,0,5,181,38,21
35,5,0,5,183,40,1
38,5,0,5,183,41,8
34,5,0,5,184,41,0
40,5,0,5,179,43,13
44,5,0,5,174,41,0
52,6,0,6,167,45,2
55,5,0,5,164,44,0
57,11,0,11,162,45,0
59,11,0,11,162,40,5
62,11,0,11,160,39,6
62,10,0,10,160,35,3
62,10,0,10,160,32,6
65,8,0,8,158,27,9
72,6,0,6,151,29,6
81,5,0,5,143,30,0
85,5,0,5,142,32,1
84,6,0,6,138,37,0
87,6,0,6,137,37,1
89,5,0,5,139,33,1
89,5,0,5,141,33,2
88,6,0,6,147,34,3
84,7,0,7,159,33,8
74,6,0,6,169,36,12
73,6,0,6,174,39,12
69,6,0,6,177,38,11
63,7,0,7,181,41,7
65,5,0,5,178,41,7
63,5,0,5,177,42,4
72,4,0,4,171,43,5
81,3,0,3,160,41,0
85,4,0,4,152,43,0
88,4,0,4,152,41,0
89,5,0,5,152,37,0
90,4,0,4,149,42,2
90,4,0,4,148,44,0
91,3,0,3,147,42,0
91,2,0,2,147,42,0
91,3,0,3,148,39,0
92,2,0,2,148,37,0
92,3,0,3,147,38,0
92,2,0,2,146,38,0
92,4,0,4,148,37,1
91,3,0,3,149,34,1
86,4,0,4,158,30,3
81,5,0,5,170,29,3
74,4,0,4,189,27,10
68,4,0,4,204,29,18
61,4,0,4,223,29,22
59,4,0,4,227,36,14
60,5,0,5,226,41,5
62,9,0,9,219,48,5
66,10,0,10,211,53,0
78,11,0,11,199,54,0
85,21,0,21,194,36,6
88,22,0,22,182,30,9
89,8,0,8,181,29,0
89,7,0,7,179,31,1
87,8,0,8,174,36,3
87,5,0,5,167,40,4
87,4,0,4,160,42,0
86,3,0,3,160,41,0
85,4,0,4,161,35,2
83,4,0,4,160,37,8
83,5,0,5,161,31,6
83,8,0,8,157,32,3
82,9,0,9,160,28,6
76,14,1,13,166,24,10
67,12,1,11,171,33,13
66,8,0,8,177,38,20
53,11,1,10,182,31,13
60,10,1,9,186,30,14
38,9,1,8,209,31,0
29,4,0,4,217,39,21
25,4,0,4,230,38,3
23,5,0,5,233,43,19
22,5,0,5,236,44,15
22,6,0,6,229,46,13
23,6,0,6,221,49,5
27,8,0,8,209,45,0
32,15,0,15,198,36,9
32,14,0,14,188,34,5
36,10,0,10,179,34,9
49,12,0,12,168,31,5
49,12,0,12,158,25,3
47,13,0,13,150,27,4
47,12,0,12,144,28,2
46,8,0,8,139,27,5
49,8,0,8,136,26,4
50,9,0,9,132,20,9
50,10,0,10,130,16,6
45,10,1,9,139,20,9
42,9,1,8,158,23,18
33,6,0,6,183,25,20
32,5,0,5,202,27,27
29,5,0,5,220,31,21
26,5,0,5,239,38,20
20,6,0,6,252,44,30
22,10,0,10,253,51,41
21,13,0,13,252,56,13
34,18,0,18,247,60,17
42,12,0,12,230,53,14
42,11,0,11,220,53,2
32,15,0,15,215,53,0
42,20,0,20,206,42,15
55,20,0,20,197,31,8
70,12,0,12,189,40,19
79,9,0,9,181,43,5
79,11,0,11,179,38,14
79,7,0,7,173,35,14
79,6,0,6,171,36,11
81,5,0,5,165,35,13
81,4,0,4,161,32,9
79,5,0,5,156,27,8
69,6,0,6,160,28,9
57,5,0,5,168,32,19
49,4,0,4,184,35,24
47,4,0,4,200,41,31
47,4,0,4,219,42,17
47,4,0,4,230,44,12
43,4,0,4,236,45,12
46,4,0,4,235,46,13
42,5,0,5,237,50,10
37,5,0,5,232,55,8
44,4,0,4,225,55,9
50,7,0,7,214,50,1
40,7,0,7,205,52,10
46,9,0,9,203,51,9
60,11,0,11,198,44,7
57,16,1,15,190,42,6
54,17,0,17,180,37,15
57,22,0,22,170,38,7
59,19,0,19,163,37,5
60,16,0,16,158,37,8
64,13,0,13,150,32,7
67,11,0,11,146,31,6
67,11,0,11,144,30,9
67,10,0,10,143,26,5
67,15,1,14,141,16,6
64,13,2,11,151,18,14
54,12,2,10,169,21,19
46,9,1,8,193,28,28
43,9,1,8,212,37,30
38,7,0,7,227,44,16
30,5,0,5,238,50,18
30,5,0,5,243,52,11
31,6,0,6,247,55,14
34,7,0,7,243,61,20
35,9,0,9,239,57,9
36,7,0,7,230,56,6
45,8,0,8,218,59,1
52,10,0,10,206,60,0
56,6,0,6,202,61,9
59,8,0,8,197,59,0
58,17,0,17,194,53,11
64,15,0,15,190,51,10
67,13,0,13,189,50,7
71,9,0,9,183,48,10
66,17.03864562,3.361999061,13.67664656,182,49,7
74,17.03864562,3.361999061,13.67664656,178,51,6
70,6,0,6,178,53,5
72,8,0,8,177,46,7
72,9,0,9,179,43,10
66,8,0,8,179,45,10
66,14,1,13,185,44,9
58,9,1,8,196,40,15
54,6,0,6,201,45,18
45,6,0,6,212,44,16
42,5,0,5,219,44,8
40,7,0,7,216,48,12
33,6,0,6,217,48,1
37,5,0,5,217,49,11
43,5,0,5,209,50,3
46,4,0,4,204,52,4
46,4,0,4,202,51,0
58,7,0,7,195,51,6
59,10,0,10,190,50,0
64,8,0,8,186,49,0
68,6,0,6,185,49,3
55,7,0,7,170,48,4
61,4,0,4,156,53,0
62,4,0,4,153,53,0
65,4,0,4,148,54,0
68,4,0,4,141,57,0
68,3,0,3,139,57,0
67,4,0,4,136,56,0
66,6,0,6,137,51,1
64,10,0,10,142,47,7
58,11,1,10,155,42,10
52,6,0,6,170,24.88362114,22
40,6,0,6,176,46,22
34,17.02663273,3.358271361,13.66836137,184,47,12
34,5,0,5,182,47,0
29,7,0,7,175,41,5
26,5,0,5,172,43,0
26,6,0,6,169,44,1
56,6,0,6,156,45,3
59,6,0,6,148,42,4
53,7,0,7,145,44,2
53,5,0,5,141,43,3
51,10,0,10,139,42,2
54,13,0,13,135,39,7
57,25,1,24,131,31,6
46,27,1,26,128,29,5
36,19,0,19,123,26,2
32,19,0,19,117,24,2
32,16,0,16,111,25,6
32,16,0,16,108,23,5
31,17,0,17,108,24,6
34,19,0,19,103,14,6
36,26,2,24,102,10,7
36,30,6,24,120,8,16
25,26,5,21,146,21,23
21,23,4,19,174,26,22
22,22,3,19,189,27,21
22,19,2,17,197,27,26
21,12,1,11,201,34,9
26,10,0,10,210,39,13
29,9,0,9,207,44,8
32,8,0,8,214,49,15
34,9,0,9,209,52,8
26,9,0,9,203,52,5
28,9,0,9,198,50,1
45,10,0,10,188,48,0
53,8,0,8,182,49,3
56,7,0,7,179,50,3
43,7,0,7,182,48,6
47,9,0,9,180,53,6
47,9,0,9,178,53,8
45,9,0,9,178,52,6
43,7,0,7,179,50,7
45,8,0,8,176,48,8
46,9,0,9,173,43,9
50,13,0,13,166,33,9
48,21,1,20,168,18,8
44,28,3,25,171,15,10
41,29,5,24,184,12,14
35,13,1,12,207,29,27
28,10,1,9,220,36,17
23,7,0,7,223,41,1
25,8,0,8,219,44,6
25,12,0,12,221,44,0
26,10,0,10,228,45,10
34,11,0,11,224,43,8
42,10,0,10,216,40,5
46,8,0,8,207,42,3
46,10,0,10,202,42,3
47,15,0,15,197,44,4
46,13,0,13,194,42,10
46,16,0,16,189,40,9
50,17,0,17,183,37,8
51,21,0,21,179,32,8
54,24,1,23,176,27,10
58,24,0,24,165,17,10
64,25,0,25,155,10,10
66,28,0,28,152,8,9
62,22,0,22,149,7,11
60,24,0,24,145,10,16
57,26,2,24,145,11,13
46,24,3,21,163,20,23
38,17,2,15,186,30,28
28,13,1,12,217,39,36
22,10,0,10,240,48,29
19,7,0,7,252,54,26
16,8,0,8,260,64,32
15,7,0,7,272,72,40
15,10,0,10,274,76,27
16,10,0,10,277,84,19
27,12,0,12,259,83,22
31,13,0,13,243,70,17
37,20,0,20,231,82,14
39,23,0,23,222,87,8
41,23,0,23,218,73,15
40,26,0,26,215,51,26
46,32,0,32,206,48,25
57,34,1,33,196,46,22
58,26,1,25,191,47,23
57,22,0,22,188,43,23
59,20,0,20,186,40,24
60,25,1,24,182,42,21
62,23,1,22,179,38,21
65,26,1,25,173,21,22
68,29,5,24,169,8,23
68,32,5,27,176,8,31
63,27,3,24,186,21,29
51,23,2,21,211,35,35
39,22,2,20,237,51,49
36,20,1,19,251,59,40
21,21,1,20,262,66,41
18,18,0,18,273,63,21
19,11,0,11,277,69,12
29,14,0,14,283,94,16
37,14,0,14,266,81,22
38,16,0,16,257,92,27
49,13,0,13,243,58,19
53,15,0,15,233,34,5
55,18,1,17,224,28,2
60,12,0,12,211,30,18
68,14,0,14,204,31,0
71,13,0,13,200,27,12
75,15,0,15,197,18,10
75,16,0,16,196,14,11
75,10,0,10,185,17,11
78,3,0,3,160,32,9
77,3,0,3,153,33,0
73,3,0,3,153,35,3
69,3,0,3,152,35,3
66,3,0,3,153,33,5
58,3,0,3,164,31,7
51,3,0,3,179,33,13
49,4,0,4,181,32,15
47,4,0,4,182,34,13
42,3,0,3,198,37,10
42,4,0,4,204,40,1
40,4,0,4,208,40,19
39,4,0,4,211,41,4
43,4,0,4,202,42,14
48,4,0,4,187,42,0
54,4,0,4,175,41,4
57,4,0,4,166,41,0
60,3,0,3,156,42,0
61,5,0,5,151,42,1
62,4,0,4,150,42,3
62,3,0,3,150,42,2
61,3,0,3,149,41,6
59,4,0,4,146,40,6
61,17.01096456,3.34434603,13.66661853,143,38,8
57,17.01096456,3.34434603,13.66661853,139,39,5
55,3,0,3,138,38,5
57,5,0,5,136,36,6
56,6,0,6,136,35,6
52,7,0,7,139,32,6
49,7,0,7,145,30,8
51,8,1,7,154,29,6
52,5,0,5,173,24.96230226,12.38171425
50,17.0081044,3.343525075,13.66457932,198,28,18
49,5,0,5,211,34,29
48,6,0,6,218,38,18
48,7,0,7,218,37,14
46,6,0,6,225,47,11
48,5,0,5,219,46,20
52,6,0,6,213,43,14
55,6,0,6,203,42,9
57,5,0,5,198,43,0
58,6,0,6,193,43,9
59,6,0,6,190,44,5
60,6,0,6,191,44,6
63,5,0,5,187,43,6
64,9,0,9,188,40,8
65,8,0,8,186,39,6
67,8,0,8,184,41,7
67,9,0,9,184,40,5
67,7,0,7,185,32,8
66,8,0,8,187,31,9
64,13,0,13,190,33,9
64,15,0,15,191,39,8
63,19,1,18,193,39,6
64,12,0,12,194,41,8
71,10,0,10,192,36,10
72,13,1,12,192,37,7
67,14,1,13,194,33,11
58,33,4,29,203,35,14
55,19,1,18,207,35,19
65,12,1,11,194,41,4
65,14,0,14,191,47,11
74,10,0,10,184,47,0
76,12,0,12,181,40,4
73,18,0,18,179,41,5
73,16,0,16,179,39,8
77,12,0,12,177,39,7
68,16,0,16,177,40,8
62,23,0,23,178,41,12
74,12,0,12,167,53,11
77,11,0,11,166,44,6
79,11,0,11,167,38,10
79,10,0,10,167,38,7
79,10,0,10,168,36,11
77,10,0,10,169,33,11
72,13,0,13,172,28,12
65,21,1,20,180,35,14
61,27,2,25,189,40,15
59,19,2,17,190,43,22
60,14,1,13,195,41,16
51,11,1,10,209,44,11
50,11,1,10,214,47,16
43,8,0,8,225,49,14
51,8,0,8,215,54,18
49,10,0,10,215,50,6
52,8,0,8,211,49,0
51,5,0,5,212,47,10
52,6,0,6,207,47,8
55,8,0,8,202,46,2
57,9,0,9,196,44,2
61,11,0,11,189,39,9
64,13,0,13,184,40,4
66,15,0,15,180,34,7
67,14,0,14,178,34,10
71,11,0,11,172,32,7
73,12,0,12,170,28,8
75,12,0,12,169,27,11
75,12,0,12,169,27,8
75,15,0,15,170,27,11
73,15,1,14,172,28,10
63,16,2,14,189,33,12
50,6,0,6,203,41,22
40,4,0,4,224,46,12
38,4,0,4,236,46,18
35,4,0,4,236,47,12
36,5,0,5,236,48,7
36,5,0,5,245,52,6
38,6,0,6,244,56,14
41,5,0,5,238,50,7
39,5,0,5,238,46,6
40,5,0,5,231,46,0
44,5,0,5,222,47,1
52,5,0,5,210,44,0
58,7,0,7,200,45,0
61,7,0,7,196,44,0
62,8,0,8,193,42,8
64,11,0,11,189,36,5
66,12,0,12,184,34,6
70,12,0,12,179,32,7
76,10,0,10,175,28,5
79,9,0,9,171,26,2
79,10,0,10,167,23,4
81,10,0,10,164,21,7
81,15,2,13,168,20,7
73,13,2,11,183,21,15
57,8,1,7,205,30,29
48,3,0,3,221,38,16
44,4,0,4,233,40,10
39,5,0,5,238,42,14
39,6,0,6,251,45,10
41,5,0,5,241,48,12
38,5,0,5,244,46,4
35,5,0,5,247,47,11
32,5,0,5,244,48,10
34,5,0,5,234,47,2
44,5,0,5,221,46,4
55,5,0,5,209,44,0
60,5,0,5,203,42,2
60,6,0,6,200,40,2
61,8,0,8,199,40,9
62,12,0,12,195,35,7
64,14,0,14,191,32,6
67,12,0,12,185,29,1
68,10,0,10,182,31,8
69,10,0,10,180,32,6
70,11,0,11,176,28,7
75,10,0,10,171,25,7
75,15,2,13,177,22,7
64,11,1,10,193,27,14
53,5,0,5,206,36,25
45,4,0,4,217,42,26
43,3,0,3,229,43,8
41,4,0,4,233,46,9
38,4,0,4,242,44,7
39,4,0,4,241,48,9
38,4,0,4,247,44,9
42,4,0,4,241,46,18
43,4,0,4,235,46,10
43,4,0,4,227,46,7
45,4,0,4,217,45,1
46,4,0,4,211,46,0
53,5,0,5,205,46,12
57,6,0,6,203,44,0
57,8,0,8,201,44,14
57,6,0,6,199,44,6
58,4,0,4,199,45,12
61,6,0,6,196,43,11
62,6,0,6,194,41,3
61,6,0,6,193,38,12
62,7,0,7,190,37,5
60,5,0,5,188,37,12
63,7,0,7,187,39,10
61,6,0,6,193,36,10
53,5,0,5,205,36,18
48,4,0,4,215,44,18
41,5,0,5,232,42,13
38,4,0,4,235,41,20
41,5,0,5,238,43,18
43,5,0,5,236,39,12
39,5,0,5,244,44,16
45,6,0,6,228,48,8
41,7,0,7,232,46,1
46,6,0,6,226,47,12
45,6,0,6,219,48,8
49,5,0,5,210,50,0
52,6,0,6,203,49,10
57,7,0,7,199,48,2
59,8,0,8,196,45,12
62,12,0,12,192,40,9
62,6,0,6,189,38,11
63,3,0,3,191,42,10
65,16.96049247,3.325304696,13.63518778,189,38,9
69,16.96049247,3.325304696,13.63518778,185,39,10
71,3,0,3,183,42,6
74,4,0,4,181,40,5
69,7,0,7,187,33,8
60,10,0,10,203,33,16
57,7,0,7,209,42,31
50,7,0,7,215,40,13
46,6,0,6,227,25.05377488,13
45,6,0,6,230,43,12
45,16.95737295,3.324336172,13.63303678,234,44,6
45,7,0,7,225,44,8
53,8,0,8,220,41,4
54,8,0,8,220,37,8
58,5,0,5,217,37,19
57,7,0,7,219,37,1
62,7,0,7,213,37,12
65,6,0,6,209,38,4
66,7,0,7,207,38,12
69,7,0,7,206,38,7
69,5,0,5,206,39,12
75,4,0,4,200,37,4
75,4,0,4,200,34,10
79,4,0,4,200,34,12
86,5,0,5,194,37,8
88,4,0,4,192,35,3
81,3,0,3,200,36,0
86,3,0,3,197,36,11
87,5,0,5,198,36,10
89,5,0,5,197,34,8
90,6,0,6,199,33,6
89,5,0,5,203,32,6
88,4,0,4,207,34,5
88,5,0,5,208,33,4
89,8,0,8,207,32,3
90,8,0,8,209,31,3
91,9,0,9,211,32,0
91,11,0,11,211,30,0
90,11,0,11,213,29,2
91,12,0,12,213,21,6
90,14,0,14,206,22,8
90,13,0,13,200,21,0
89,12,0,12,194,21,1
87,8,0,8,185,25,0
85,7,0,7,182,28,2
90,5,0,5,182,27,5
80,3,0,3,170,35,6
79,4,0,4,163,36,4
81,4,0,4,159,34,3
83,5,0,5,157,31,0
83,5,0,5,151,33,5
85,5,0,5,149,30,4
83,7,0,7,152,30,5
76,6,0,6,163,28,6
65,4,0,4,178,28,22
59,4,0,4,195,30,24
49,5,0,5,210,31,23
44,4,0,4,223,35,10
40,4,0,4,230,38,18
36,5,0,5,239,41,17
32,5,0,5,238,45,19
34,6,0,6,244,46,9
37,6,0,6,238,46,13
36,6,0,6,222,44,3
35,6,0,6,210,44,0
41,7,0,7,199,44,0
47,7,0,7,193,42,5
52,7,0,7,188,40,6
58,6,0,6,184,39,7
60,5,0,5,180,41,10
61,6,0,6,177,39,6
59,7,0,7,174,34,6
59,9,0,9,172,30,6
59,10,0,10,170,30,3
60,9,0,9,165,27,9
62,14,0,14,162,19,14
58,20,1,19,164,11,11
57,25,5,20,173,13,13
49,19,4,15,194,19,22
42,11,1,10,221,28,32
27,6,0,6,239,32,29
25,6,0,6,251,36,17
26,6,0,6,258,39,17
28,5,0,5,263,42,17
26,5,0,5,267,43,19
25,5,0,5,269,47,11
24,6,0,6,270,51,6
26,8,0,8,261,56,7
33,14,0,14,242,68,14
35,19,0,19,231,71,5
37,15,0,15,223,62,0
24,10,0,10,212,43,18
29,10,0,10,203,35,0
39,11,0,11,198,30,12
48,11,0,11,194,26,6
51,10,0,10,190,27,7
51,12,0,12,189,25,10
54,14,0,14,187,15,11
57,16,0,16,183,8,15
60,17,1,16,178,3,12
60,28,5,23,177,4,8
52,26,5,21,188,8,12
43,24,4,20,207,18,28
40,17,2,15,230,29,25
33,13,1,12,249,35,18
21,10,0,10,277,46,25
15,9,0,9,292,52,35
14,6,0,6,297,46,27
13,5,0,5,304,47,13
10,6,0,6,312,48,10
17,9,0,9,304,61,9
17,14,0,14,289,78,15
19,16,0,16,284,79,11
48,27,0,27,249,60,17
46,22,0,22,240,54,16
54,21,1,20,229,56,8
62,19,0,19,221,64,24
70,17,0,17,216,57,18
69,19,0,19,215,42,27
70,24,0,24,213,30,35
68,28,1,27,213,29,35
58,26,1,25,210,33,32
59,23,1,22,201,23,16
66,29,1,28,193,7,28
54,27,2,25,193,13,23
43,23,2,21,206,17,25
37,17,1,16,224,36,37
29,12,1,11,257,41,27
25,10,0,10,276,45,26
20,9,0,9,294,56,25
19,10,0,10,308,70,18
19,10,0,10,311,85,21
13,8,0,8,315,80,30
17,9,0,9,315,74,21
21,11,0,11,307,77,17
25,9,0,9,295,73,10
33,11,0,11,285,71,15
41,13,0,13,265,64,21
56,10,0,10,248,74,18
60,11,0,11,239,75,17
64,21,1,20,231,64,29
68,16,0,16,228,50,26
68,13,0,13,223,54,42
71,11,0,11,221,54,30
72,13,0,13,220,44,40
72,13,0,13,219,32,37
73,13,0,13,216,24,35
75,14,0,14,213,20,39
73,17,1,16,216,24,35
60,17,1,16,226,32,36
34,13,1,12,250,48,51
29,9,0,9,280,60,30
26,10,0,10,294,66,3
24,9,0,9,308,78,0
26,12,0,12,318,81,17
21,11,0,11,324,96,17
18,12,0,12,333,97,27
18,13,0,13,321,101,6
28,15,0,15,307,84,0
37,16,0,16,304,73,22
38,25,1,24,298,62,31
41,30,0,30,281,59,42
43,30,0,30,270,52,35
50,19,0,19,261,36,38
56,21,1,20,250,34,39
65,25,1,24,240,43,39
72,13,0,13,234,42,40
74,11,0,11,231,40,40
74,16.92557901,3.30714447,13.61843454,231,33,47
74,16.92557901,3.30714447,13.61843454,229,22,40
76,16,1,15,224,11,56
80,23,1,22,221,4,36
80,27,3,24,224,6,55
72,33,6,27,235,10,51
44,37,8,29,257,27,59
38,28,3,25,286,48,51
38,16.92783887,3.307222533,13.62061633,303,25.14884308,55
26,25,1,24,315,53,50
20,23,1,22,323,56,53
21,18,0,18,321,70,7
20,12,0,12,326,69,0
26,15,0,15,322,69,0
28,15,0,15,310,67,19
36,11,0,11,298,72,27
33,10,0,10,286,81,35
44,10,0,10,269,77,34
51,16,0,16,253,58,34
53,14,0,14,249,59,29
51,17,0,17,245,53,29
42,20,0,20,246,54,27
44,12,0,12,242,56,25
45,9,0,9,238,50,12
41,10,0,10,240,45,26
45,8,0,8,236,45,8
45,9,0,9,238,44,23
52,10,0,10,234,40,14
50,14,0,14,240,39,20
53,16,1,15,244,35,22
45,17,1,16,256,32,20
46,19,2,17,261,32,18
48,15,1,14,264,35,17
48,9,1,8,265,35,16
49,11,1,10,262,36,17
49,13,1,12,260,38,14
50,19,2,17,256,38,11
44,21,2,19,256,34,14
39,20,1,19,251,42,12
43,18,1,17,241,44,2
54,13,0,13,229,46,4
50,19,0,19,236,41,3
46,15,0,15,238,44,19
52,13,0,13,230,44,2
76,11,0,11,208,45,15
64,10,0,10,215,45,0
73,7,0,7,208,45,7
75,4,0,4,203,41,8
73,4,0,4,206,42,2
81,3,0,3,199,47,6
76,3,0,3,202,46,4
86,4,0,4,192,44,6
88,5,0,5,190,42,7
87,10,0,10,191,37,4
89,12,0,12,195,34,13
89,11,0,11,197,32,12
83,12,1,11,212,30,8
70,13,2,11,226,27,22
73,9,1,8,229,31,20
65,5,0,5,233,28,12
66,5,0,5,223,30,6
63,5,0,5,222,35,0
61,5,0,5,220,37,5
58,4,0,4,209,40,1
60,7,0,7,204,41,3
66,6,0,6,198,41,0
66,6,0,6,193,41,3
67,6,0,6,190,40,3
66,8,0,8,190,38,5
65,8,0,8,194,33,7
64,8,0,8,194,30,5
63,8,0,8,194,32,8
64,9,0,9,192,31,5
71,9,0,9,189,27,7
75,8,0,8,185,27,1
73,8,0,8,178,24,5
72,12,1,11,178,23,2
46,9,1,8,186,23,12
44,16,3,13,203,22,26
41,20,4,16,226,28,8
37,17,3,14,235,34,13
38,17,2,15,245,35,15
35,18,2,16,250,40,12
34,15,0,15,249,53,12
32,12,0,12,257,60,15
31,10,0,10,257,60,12
34,8,0,8,253,54,9
34,6,0,6,248,50,4
35,6,0,6,238,48,1
43,9,0,9,229,44,0
48,11,0,11,220,45,0
53,13,0,13,218,47,1
58,8,0,8,215,43,9
60,9,0,9,213,39,0
61,6,0,6,209,38,11
62,6,0,6,208,38,3
61,6,0,6,208,38,7
61,6,0,6,206,37,5
62,7,0,7,204,36,3
64,7,0,7,207,37,4
64,8,0,8,211,35,5
61,8,0,8,216,31,11
58,10,0,10,221,34,8
57,12,1,11,230,32,8
55,7,0,7,233,34,11
53,7,0,7,240,34,6
49,6,0,6,241,36,9
50,6,0,6,244,36,4
49,7,0,7,241,36,11
53,7,0,7,237,37,6
51,9,0,9,234,37,10
60,7,0,7,228,38,0
61,12,0,12,225,37,6
64,11,0,11,223,35,7
66,13,0,13,220,36,3
66,10,0,10,217,38,16
67,10,0,10,216,37,0
65,12,0,12,217,36,15
66,10,0,10,216,37,0
66,10,0,10,216,34,13
67,11,0,11,214,29,5
69,10,0,10,207,23,9
70,8,0,8,201,20,9
73,5,0,5,198,26,11
71,4,0,4,192,45,0
67,7,0,7,200,41,9
62,6,0,6,209,41,24
56,5,0,5,219,44,17
53,5,0,5,232,48,10
49,4,0,4,239,49,22
47,4,0,4,248,48,17
44,6,0,6,252,56,21
44,6,0,6,250,61,26
43,4,0,4,252,57,17
42,4,0,4,249,55,14
45,4,0,4,243,56,15
56,4,0,4,236,51,11
60,9,0,9,232,46,8
65,13,0,13,226,40,9
66,7,0,7,223,42,12
67,9,0,9,217,45,16
67,7,0,7,217,55,11
73,7,0,7,213,43,22
77,9,0,9,206,27,5
79,9,0,9,203,24,16
80,6,0,6,200,26,14
81,5,0,5,199,27,11
81,4,0,4,198,30,11
78,4,0,4,199,34,9
75,5,0,5,204,35,16
72,6,0,6,215,36,15
64,5,0,5,226,37,16
57,5,0,5,237,43,29
54,5,0,5,241,51,28
52,5,0,5,247,58,28
50,7,0,7,248,68,30
44,8,0,8,254,74,28
47,8,0,8,248,68,25
46,15,0,15,247,59,18
57,14,0,14,239,60,20
60,16,0,16,236,50,20
60,14,0,14,234,43,33
63,15,0,15,229,33,27
67,9,0,9,225,40,25
64,8,0,8,224,42,12
69,9,0,9,220,41,14
71,13,0,13,215,36,15
69,14,0,14,215,32,9
71,16.88683839,3.28963363,13.59720475,213,33,15
72,16.88683839,3.28963363,13.59720475,212,38,7
72,9,0,9,211,33,5
74,9,0,9,211,28,12
75,6,0,6,203,28,1
72,6,0,6,205,37,5
61,7,0,7,215,38,7
54,6,0,6,229,25.24716294,22
50,4,0,4,242,40,8
47,16.88427714,3.288805365,13.59547177,247,41,9
50,4,0,4,250,40,12
44,4,0,4,255,41,14
43,3,0,3,262,47,16
41,4,0,4,265,50,7
45,4,0,4,261,51,10
48,4,0,4,254,48,11
52,4,0,4,243,45,0
53,5,0,5,233,45,0
60,7,0,7,223,45,0
65,5,0,5,218,44,4
69,5,0,5,210,45,0
71,6,0,6,208,40,6
73,8,0,8,204,38,5
74,9,0,9,201,34,9
76,7,0,7,198,34,6
77,6,0,6,197,30,9
79,6,0,6,194,29,10
79,7,0,7,193,25,6
79,11,1,10,195,30,10
75,11,1,10,205,29,15
66,7,0,7,226,27,29
55,10,1,9,243,36,20
48,12,1,11,253,41,17
47,9,0,9,258,47,21
45,8,0,8,265,54,19
42,8,0,8,274,57,13
46,8,0,8,271,55,13
47,9,0,9,271,61,12
49,11,0,11,264,62,12
52,9,0,9,254,46,11
57,9,0,9,247,40,0
59,13,0,13,238,39,0
62,11,0,11,232,39,0
64,11,0,11,226,38,7
64,9,0,9,224,36,0
64,11,0,11,221,33,1
64,9,0,9,219,36,9
65,8,0,8,218,38,3
67,6,0,6,218,38,8
69,6,0,6,216,36,2
70,9,0,9,215,32,4
71,10,0,10,214,30,11
70,15,1,14,218,29,0
70,13,0,13,221,30,14
67,13,1,12,226,31,0
62,13,1,12,233,31,19
60,13,1,12,238,31,5
58,14,1,13,241,28,13
54,15,1,14,247,32,9
52,12,1,11,251,35,13
49,10,0,10,254,42,18
46,8,0,8,256,42,11
48,7,0,7,257,41,8
48,10,0,10,253,40,3
55,8,0,8,248,42,8
59,9,0,9,237,41,1
58,11,0,11,234,39,0
62,8,0,8,232,36,9
73,12,0,12,225,23,2
75,6,0,6,221,31,8
77,7,0,7,220,32,0
78,8,0,8,217,31,12
80,12,0,12,214,27,0
82,10,0,10,215,21,12
82,11,0,11,214,17,4
81,15,1,14,214,10,14
79,22,4,18,219,8,6
76,25,5,20,226,9,18
68,23,5,18,242,14,11
56,13,1,12,262,30,25
45,10,0,10,278,45,33
38,7,0,7,294,54,36
29,7,0,7,302,55,27
29,8,0,8,314,56,22
30,7,0,7,319,67,0
33,6,0,6,318,67,0
34,6,0,6,306,56,0
37,5,0,5,297,55,8
46,6,0,6,278,51,15
55,6,0,6,267,53,16
57,9,0,9,261,52,15
63,8,0,8,251,53,18
67,6,0,6,243,65,21
70,6,0,6,239,64,19
73,6,0,6,235,64,29
75,4,0,4,232,61,26
77,6,0,6,228,56,20
79,7,0,7,226,52,35
81,6,0,6,223,42,15
81,5,0,5,221,41,35
81,6,0,6,220,40,18
80,6,0,6,222,42,38
76,6,0,6,229,40,30
74,7,0,7,233,36,54
73,7,0,7,232,35,37
79,8,0,8,230,39,32
84,8,0,8,220,38,29
87,9,0,9,218,36,30
88,11,0,11,216,28,23
87,11,0,11,212,32,17
88,12,0,12,208,34,20
82,15,0,15,209,36,17
86,10,0,10,201,43,17
88,11,0,11,198,39,13
89,8,0,8,198,38,11
89,6,0,6,197,38,12
89,5,0,5,197,42,11
88,4,0,4,196,39,3
89,4,0,4,196,40,8
88,4,0,4,196,38,8
88,3,0,3,197,37,7
88,3,0,3,197,38,0
88,3,0,3,197,34,11
88,5,0,5,196,31,12
86,6,0,6,197,24,12
85,7,0,7,200,28,14
84,9,0,9,201,28,11
81,11,1,10,206,30,1
79,8,0,8,213,28,13
78,6,0,6,219,33,23
77,5,0,5,222,35,6
78,5,0,5,223,35,13
76,4,0,4,226,39,5
76,5,0,5,227,35,8
71,5,0,5,229,40,6
73,4,0,4,218,46,6
74,4,0,4,210,50,0
76,4,0,4,203,52,0
76,5,0,5,202,52,0
78,5,0,5,199,53,0
78,6,0,6,198,54,6
80,4,0,4,197,51,3
82,3,0,3,189,45,8
77,2,0,2,184,41,5
76,2,0,2,182,38,2
75,2,0,2,177,39,4
78,2,0,2,176,39,1
83,2,0,2,171,39,1
84,2,0,2,172,38,0
80,3,0,3,174,37,3
79,2,0,2,178,37,4
72,2,0,2,183,36,7
72,2,0,2,185,38,10
68,2,0,2,187,38,7
64,3,0,3,197,37,9
63,3,0,3,198,35,14
66,3,0,3,198,37,11
63,4,0,4,197,37,0
69,3,0,3,193,39,5
75,4,0,4,190,39,0
80,5,0,5,183,38,6
82,4,0,4,179,37,0
83,5,0,5,172,34,6
87,6,0,6,167,32,0
89,5,0,5,164,32,0
90,5,0,5,166,28,4
90,3,0,3,165,30,5
91,3,0,3,166,30,1
91,16.83014045,3.271222616,13.55891784,168,28,3
91,16.83014045,3.271222616,13.55891784,169,26,6
90,2,0,2,169,27,6
91,3,0,3,169,29,2
91,4,0,4,169,28,5
91,5,0,5,169,22,2
90,6,0,6,170,23,1
89,7,0,7,173,25.32749489,2
89,7,0,7,175,26,6
89,16.82714399,3.270403933,13.55674006,175,25,7
87,6,0,6,174,28,5
89,6,0,6,174,28,3
90,5,0,5,173,30,2
90,5,0,5,173,32,0
90,5,0,5,166,36,3
90,6,0,6,163,36,0
90,7,0,7,161,37,0
91,6,0,6,158,32,0
90,7,0,7,154,28,2
90,8,0,8,153,29,3
90,6,0,6,153,29,2
90,6,0,6,153,28,2
91,4,0,4,153,28,3
91,3,0,3,155,28,3
90,2,0,2,154,28,2
89,4,0,4,154,27,1
87,4,0,4,155,27,0
86,4,0,4,155,27,1
84,5,0,5,158,26,2
80,6,0,6,163,24,4
68,6,1,5,179,22,7
59,6,1,5,193,25,11
58,4,0,4,199,28,19
55,3,0,3,206,30,19
50,3,0,3,219,30,0
50,3,0,3,218,32,13
50,3,0,3,224,32,2
51,3,0,3,222,31,9
52,4,0,4,222,32,8
52,4,0,4,216,33,0
55,7,0,7,209,35,0
57,10,1,9,200,37,0
60,6,0,6,191,38,4
59,7,0,7,188,37,1
61,7,0,7,187,36,4
69,8,0,8,180,33,9
69,8,0,8,179,30,3
70,7,0,7,176,29,5
76,6,0,6,169,28,3
78,6,0,6,165,27,0
79,7,0,7,163,23,2
78,11,0,11,163,18,2
77,12,1,11,166,15,5
67,13,2,11,173,20,6
64,7,1,6,182,27,13
61,4,0,4,187,28,15
61,6,0,6,187,29,11
57,6,0,6,199,25,0
54,5,0,5,207,27,16
52,4,0,4,215,34,17
53,3,0,3,217,35,9
53,3,0,3,215,37,0
53,4,0,4,215,37,7
55,4,0,4,211,38,5
55,4,0,4,202,41,1
59,8,0,8,196,43,1
63,7,0,7,187,41,2
65,6,0,6,180,39,0
66,10,0,10,176,31,5
67,7,0,7,173,28,4
69,10,0,10,171,30,5
70,13,0,13,168,27,4
71,14,0,14,167,24,6
72,13,0,13,166,24,6
72,13,0,13,167,19,5
74,14,1,13,164,19,4
71,18,4,14,166,19,6
63,11,1,10,178,26,15
56,8,1,7,199,28,29
53,19,3,16,218,30,15
50,18,2,16,231,33,15
46,17,1,16,236,41,18
44,10,0,10,247,47,18
42,10,0,10,254,56,19
41,8,0,8,258,54,11
41,8,0,8,262,55,13
43,7,0,7,259,53,13
49,8,0,8,248,49,9
54,8,0,8,240,42,5
54,9,0,9,228,39,0
56,12,0,12,222,35,0
60,9,0,9,217,35,2
62,12,0,12,213,30,6
65,13,0,13,209,29,6
67,9,0,9,206,30,6
68,8,0,8,205,30,4
71,8,0,8,202,26,8
72,8,0,8,200,26,4
76,10,0,10,196,17,8
77,12,0,12,195,13,7
77,20,3,17,199,8,7
69,22,3,19,212,17,24
62,15,2,13,231,28,17
54,11,1,10,241,34,16
49,8,0,8,243,37,13
47,8,0,8,251,40,5
45,7,0,7,256,43,15
46,7,0,7,258,44,12
40,6,0,6,259,36,8
40,6,0,6,256,37,11
41,7,0,7,249,37,7
48,8,0,8,241,37,0
49,9,0,9,234,35,0
56,7,0,7,226,32,0
60,8,0,8,221,29,10
61,8,0,8,221,23,0
62,8,0,8,218,22,11
67,7,0,7,214,25,7
65,6,0,6,212,24,5
70,4,0,4,209,27,8
83,4,0,4,199,27,7
85,3,0,3,198,24,0
87,6,0,6,196,23,8
85,3,0,3,181,29,8
86,3,0,3,182,34,4
87,6,0,6,180,32,5
87,3,0,3,173,37,4
89,3,0,3,174,36,0
88,4,0,4,175,39,2
89,6,0,6,175,34,8
90,4,0,4,177,34,2
89,4,0,4,176,39,0
90,3,0,3,179,37,2
90,2,0,2,178,39,3
90,3,0,3,182,38,0
91,3,0,3,183,34,1
91,3,0,3,186,33,1
91,6,0,6,176,29,2
90,6,0,6,174,32,0
90,5,0,5,175,33,0
89,6,0,6,177,29,3
89,7,0,7,177,26,7
90,5,0,5,178,23,6
90,5,0,5,179,25,2
92,6,0,6,180,22,0
92,6,0,6,184,19,5
92,11,0,11,186,16,9
91,10,0,10,185,13,8
90,13,0,13,186,16,8
88,10,1,9,189,18,9
81,10,2,8,208,18,20
68,9,2,7,235,24,24
50,8,1,7,261,34,7
44,7,0,7,272,37,8
41,7,0,7,283,39,12
44,7,0,7,285,41,8
42,7,0,7,289,40,4
38,8,0,8,298,43,5
38,12,0,12,291,44,7
28,14,0,14,294,40,8
33,5,0,5,280,40,3
35,3,0,3,266,38,0
37,4,0,4,252,35,0
38,4,0,4,239,33,0
40,4,0,4,230,31,2
41,4,0,4,224,29,0
42,3,0,3,221,30,4
41,3,0,3,219,29,0
42,16.77329605,3.25327841,13.52001764,216,30,1
46,16.77329605,3.25327841,13.52001764,207,28,0
45,6,0,6,204,25,1
45,6,0,6,204,30,0
41,7,0,7,212,27,0
36,8,0,8,223,34,4
35,5,0,5,229,38,9
33,4,0,4,243,25.36155475,12.34276499
31,16.77099873,3.252584674,13.51841405,253,40,0
30,4,0,4,260,39,0
28,4,0,4,265,39,6
28,4,0,4,268,36,3
26,3,0,3,282,37,7
24,3,0,3,282,37,10
25,3,0,3,283,40,15
24,3,0,3,280,40,6
24,4,0,4,272,41,1
25,7,0,7,268,39,0
53,7,0,7,243,44,1
51,13,0,13,238,52,0
48,12,0,12,232,52,0
47,14,0,14,226,46,9
51,12,0,12,224,37,7
58,9,0,9,218,36,2
64,8,0,8,213,32,8
63,7,0,7,213,29,0
63,8,0,8,214,30,10
65,9,0,9,211,30,0
64,11,1,10,210,27,9
60,9,1,8,222,24,4
53,5,0,5,237,29,13
49,8,1,7,246,34,13
44,6,0,6,258,36,15
38,7,0,7,269,40,16
39,6,0,6,275,45,18
45,4,0,4,277,43,12
50,4,0,4,266,35,12
50,4,0,4,266,40,6
53,7,0,7,261,51,13
54,10,0,10,259,50,22
55,13,0,13,249,43,6
57,16,0,16,243,42,0
63,12,0,12,234,45,0
67,12,0,12,230,46,12
70,11,0,11,229,41,5
70,14,0,14,226,38,21
70,15,0,15,224,36,3
68,16,0,16,221,34,19
69,13,0,13,219,34,6
72,13,0,13,216,31,13
74,12,0,12,214,24,8
77,15,0,15,205,14,12
78,15,2,13,205,16,7
75,17,2,15,213,21,24
66,19,3,16,232,24,16
59,12,1,11,240,33,22
55,10,0,10,253,38,18
50,12,0,12,266,39,26
47,13,0,13,272,52,33
47,18,0,18,277,62,26
44,12,0,12,279,76,21
44,10,0,10,281,69,22
51,9,0,9,274,55,18
54,7,0,7,270,47,18
64,6,0,6,254,40,23
66,8,0,8,248,37,20
67,7,0,7,243,36,18
70,7,0,7,240,36,22
72,9,0,9,238,32,18
74,12,0,12,235,30,24
75,10,0,10,233,29,19
75,9,0,9,233,27,28
76,5,0,5,227,26,14
78,3,0,3,220,34,21
79,3,0,3,214,38,5
79,4,0,4,212,39,20
79,4,0,4,214,37,11
78,5,0,5,217,35,24
75,5,0,5,224,32,21
71,4,0,4,231,31,24
67,4,0,4,239,32,37
62,4,0,4,249,34,29
54,4,0,4,264,36,31
50,4,0,4,272,40,41
50,4,0,4,280,41,33
48,4,0,4,281,49,26
50,6,0,6,277,51,30
57,6,0,6,273,47,31
61,9,0,9,263,48,32
62,9,0,9,254,42,28
65,7,0,7,250,33,24
67,5,0,5,244,30,21
73,5,0,5,234,28,15
76,4,0,4,228,28,14
77,4,0,4,226,28,13
79,5,0,5,223,27,11
80,6,0,6,223,23,21
79,5,0,5,225,19,13
80,4,0,4,223,22,23
82,6,0,6,220,19,8
81,7,0,7,222,17,14
80,10,1,9,226,15,22
75,13,2,11,239,16,18
67,16,2,14,255,28,31
60,12,1,11,264,38,28
53,13,1,12,272,41,34
47,10,0,10,280,51,32
45,9,0,9,289,59,33
46,6,0,6,287,56,29
50,6,0,6,284,52,26
55,6,0,6,276,40,26
58,8,0,8,269,32,17
62,9,0,9,256,32,11
67,9,0,9,248,33,4
67,12,0,12,248,33,0
68,10,0,10,242,27,13
70,9,0,9,237,23,8
72,9,0,9,234,24,12
74,8,0,8,232,24,2
74,9,0,9,231,23,15
76,8,0,8,229,23,5
78,8,0,8,226,21,10
78,5,0,5,223,24,8
79,5,0,5,221,25,2
78,6,0,6,222,30,12
76,7,0,7,227,29,0
68,4,0,4,239,34,22
62,4,0,4,252,36,7
60,4,0,4,255,38,9
61,4,0,4,257,38,5
64,4,0,4,254,40,3
63,3,0,3,252,40,1
66,4,0,4,247,39,0
81,4,0,4,228,43,0
82,4,0,4,227,44,0
84,4,0,4,226,40,4
80,4,0,4,224,40,0
79,6,0,6,224,37,13
83,5,0,5,221,36,0
86,4,0,4,218,34,4
85,5,0,5,218,30,0
85,5,0,5,218,27,5
83,5,0,5,217,24,2
83,5,0,5,215,25,5
84,5,0,5,212,28,0
84,5,0,5,212,25,0
85,5,0,5,211,21,11
84,6,0,6,209,18,4
83,6,0,6,210,19,9
82,6,0,6,213,15,7
79,10,1,9,218,16,5
77,10,1,9,223,17,5
75,11,1,10,226,19,14
72,10,1,9,232,22,3
70,8,1,7,233,25,12
70,4,0,4,232,28,4
71,3,0,3,228,27,3
70,3,0,3,228,24,2
73,2,0,2,220,26,9
74,4,0,4,220,26,0
75,7,0,7,218,26,17
76,5,0,5,215,27,1
78,4,0,4,213,29,11
80,3,0,3,209,29,0
81,4,0,4,207,29,14
80,5,0,5,207,28,0
80,4,0,4,205,26,10
80,3,0,3,205,26,2
84,16.71839284,3.235121304,13.48327154,203,26,7
88,16.71839284,3.235121304,13.48327154,196,28,0
89,2,0,2,193,28,0
90,2,0,2,190,29,0
89,2,0,2,186,29,0
90,3,0,3,187,27,0
89,4,0,4,186,26,2
89,4,0,4,186,25,0
89,5,0,5,190,25.41102512,2
89,16.71503565,3.234321267,13.48071438,190,20,4
87,6,1,5,194,21,5
82,5,1,4,203,21,5
82,3,0,3,203,23,19
85,4,0,4,203,23,0
80,4,0,4,208,25,10
82,5,0,5,210,26,16
80,4,0,4,207,29,0
81,5,0,5,205,29,2
80,7,0,7,201,24,0
83,6,0,6,195,23,0
83,6,0,6,192,25,7
84,9,1,8,188,23,3
85,5,0,5,183,24,3
86,4,0,4,181,26,1
86,4,0,4,181,23,0
87,5,0,5,181,24,5
87,6,0,6,182,21,9
86,6,0,6,184,15,7
85,10,1,9,189,12,8
84,12,1,11,193,9,11
80,10,1,9,197,15,14
77,9,1,8,208,19,11
64,10,1,9,234,21,15
61,8,0,8,239,33,34
57,7,0,7,252,40,28
53,9,0,9,258,52,26
45,7,0,7,267,57,31
47,8,0,8,273,57,25
48,8,0,8,273,61,18
53,9,0,9,264,67,20
62,8,0,8,255,55,21
63,14,0,14,246,43,10
68,16,0,16,239,38,0
68,13,0,13,235,36,0
72,12,0,12,230,33,14
75,10,0,10,226,24,3
77,12,0,12,223,26,12
79,13,0,13,221,24,5
79,11,0,11,218,25,3
81,11,0,11,217,22,17
82,17,1,16,212,11,4
83,17,1,16,211,5,16
83,19,4,15,215,6,8
81,23,5,18,225,14,29
72,20,3,17,240,22,21
62,24,4,20,255,26,22
56,24,3,21,268,30,32
51,18,2,16,274,34,37
49,11,0,11,276,47,28
39,7,0,7,286,47,21
40,7,0,7,288,44,15
48,7,0,7,282,42,18
55,7,0,7,272,37,22
59,6,0,6,268,34,24
63,7,0,7,259,34,25
68,10,0,10,250,31,21
72,7,0,7,246,31,7
73,8,0,8,244,27,14
73,9,0,9,243,25,14
70,7,0,7,243,27,21
64,9,0,9,245,29,9
74,10,0,10,241,25,25
74,8,0,8,240,24,8
74,9,0,9,238,23,16
70,10,0,10,239,24,9
70,12,0,12,240,22,16
68,9,0,9,242,21,12
65,10,1,9,251,21,20
59,14,2,12,271,24,22
64,18,2,16,266,22,26
62,16,2,14,274,17,6
59,13,2,11,288,19,3
57,16,3,13,286,20,12
62,18,3,15,278,17,11
55,20,4,16,287,15,2
58,19,4,15,284,13,2
59,16,3,13,280,12,2
62,16,3,13,276,10,0
69,14,2,12,266,7,3
79,14,1,13,255,6,4
86,11,1,10,249,2,0
87,9,1,8,249,2,6
87,8,1,7,250,1,3
89,6,1,5,247,2,13
89,6,1,5,250,2,0
90,4,0,4,248,2,18
88,4,0,4,250,1,0
83,5,0,5,250,1,11
81,11,1,10,245,4,2
86,13,1,12,236,5,2
88,13,2,11,235,4,5
88,19,7,12,240,4,2
85,14,5,9,247,4,15
77,22,11,11,254,4,7
71,15,6,9,269,8,6
68,14,3,11,275,25,22
60,13,1,12,286,28,38
58,15,1,14,287,33,25
62,33,4,29,290,34,17
60,24,2,22,294,40,21
59,15,1,14,295,31,10
58,14,1,13,296,40,10
66,16,1,15,287,27,12
74,4,0,4,239,36,12
77,3,0,3,222,42,0
78,4,0,4,216,44,0
78,4,0,4,216,43,10
82,2,0,2,212,43,7
82,2,0,2,212,43,2
82,2,0,2,210,42,6
83,2,0,2,208,42,7
82,1,0,1,207,42,2
88,2,0,2,205,41,9
88,2,0,2,200,38,0
88,4,0,4,197,32,4
87,5,0,5,194,29,1
89,5,0,5,196,28,5
89,5,0,5,197,28,0
90,5,0,5,199,26,10
90,6,0,6,201,24,4
90,7,0,7,203,26,0
89,6,0,6,204,29,10
89,6,0,6,207,27,0
86,7,0,7,209,28,0
86,5,0,5,212,30,10
85,6,0,6,213,31,0
88,8,0,8,212,27,10
88,8,0,8,211,27,0
89,7,0,7,211,27,3
90,8,0,8,211,25,2
90,8,0,8,211,25,3
90,7,0,7,211,21,3
90,7,0,7,211,18,9
90,7,0,7,211,19,2
90,6,0,6,211,19,5
91,5,0,5,211,18,6
91,4,0,4,209,20,0
91,4,0,4,209,22,10
91,4,0,4,208,22,0
92,4,0,4,210,18,8
91,5,0,5,213,15,2
92,8,1,7,215,12,11
92,12,2,10,219,9,3
91,18,4,14,224,7,12
90,20,6,14,223,10,11
88,12,3,9,225,15,2
87,7,1,6,230,21,5
86,5,0,5,231,20,10
89,6,0,6,231,21,5
90,9,1,8,230,18,7
90,8,1,7,227,15,4
90,8,0,8,225,14,6
90,6,0,6,223,15,0
91,5,0,5,223,17,9
91,4,0,4,220,21,0
91,3,0,3,221,24,8
91,2,0,2,219,25,0
91,3,0,3,217,25,7
91,16.67403879,3.221076132,13.45296265,216,25,0
91,16.67403879,3.221076132,13.45296265,215,22,6
91,4,0,4,215,19,0
91,5,0,5,214,14,1
91,8,1,7,216,15,7
91,9,1,8,219,14,0
90,12,2,10,222,11,14
91,11,2,9,226,9,4
91,13,3,10,231,25.40239796,11
90,16.67211709,3.220600346,13.45151675,231,9,4
90,8,1,7,233,13,16
89,11,2,9,235,12,3
89,15,2,13,235,11,27
89,14,1,13,236,15,26
89,13,1,12,236,15,26
89,10,1,9,233,14,23
90,7,0,7,231,17,18
90,9,1,8,229,19,8
90,7,0,7,226,20,15
90,6,0,6,225,21,3
90,6,0,6,224,22,16
90,4,0,4,223,22,2
90,4,0,4,222,23,15
90,6,0,6,222,19,12
91,4,0,4,220,21,10
91,4,0,4,218,28,13
92,3,0,3,217,22,0
92,4,0,4,216,18,17
92,7,0,7,216,12,0
92,11,1,10,221,12,13
92,13,2,11,225,13,3
91,20,4,16,229,10,21
91,21,4,17,231,8,10
89,25,7,18,240,10,18
84,22,4,18,251,26,30
78,21,1,20,260,38,47
73,25,1,24,264,44,40
72,17,1,16,265,46,28
72,16,1,15,263,42,23
76,20,1,19,254,44,21
80,18,0,18,248,42,8
82,18,0,18,244,37,10
85,19,0,19,241,34,9
85,14,0,14,240,26,17
86,13,0,13,238,25,16
87,15,0,15,237,21,20
88,16,0,16,235,15,16
89,17,0,17,233,10,26
89,16,0,16,233,11,14
90,15,1,14,231,11,29
90,17,1,16,230,10,20
90,16,1,15,229,4,27
90,20,4,16,230,4,24
85,19,4,15,238,9,24
77,12,2,10,243,21,33
68,8,1,7,258,22,26
63,6,0,6,270,30,26
55,5,0,5,279,32,25
53,5,0,5,285,35,14
55,6,0,6,288,44,20
59,5,0,5,278,49,28
57,5,0,5,273,45,17
65,9,1,8,269,39,9
70,8,0,8,263,41,15
71,10,0,10,260,40,16
73,8,0,8,257,41,20
76,6,0,6,252,42,22
82,5,0,5,250,33,21
88,7,0,7,242,33,18
90,9,0,9,243,23,24
89,10,0,10,243,18,7
88,8,0,8,242,15,5
89,5,0,5,241,17,0
89,6,0,6,242,18,10
90,4,0,4,242,15,0
90,7,0,7,242,7,13
88,9,0,9,242,8,0
88,10,1,9,240,8,11
88,16,3,13,243,7,1
90,12,2,10,243,10,1
89,10,3,7,252,6,8
87,11,3,8,245,8,5
84,10,1,9,223,31,0
80,6,0,6,225,47,0
87,6,0,6,223,45,10
86,5,0,5,220,43,0
85,3,0,3,219,49,4
83,4,0,4,221,51,6
82,4,0,4,222,54,1
82,7,0,7,218,55,4
83,6,0,6,215,59,0
84,5,0,5,213,53,12
85,7,0,7,211,45,0
85,9,0,9,208,45,8
84,9,0,9,207,42,0
85,10,0,10,205,42,13
85,10,0,10,203,36,3
88,9,0,9,200,27,8
84,4,0,4,200,40,6
87,5,0,5,199,41,8
87,8,0,8,202,38,11
82,7,0,7,210,40,11
77,5,0,5,215,44,13
72,4,0,4,222,44,9
68,3,0,3,228,44,11
66,4,0,4,236,42,7
63,4,0,4,240,42,10
64,5,0,5,242,45,11
63,4,0,4,241,45,5
65,5,0,5,239,43,6
66,5,0,5,235,41,6
65,6,0,6,234,40,2
68,9,0,9,229,41,8
72,10,0,10,222,38,6
75,15,1,14,218,30,10
77,9,0,9,213,32,13
82,7,0,7,209,31,4
83,7,0,7,207,30,7
86,4,0,4,204,39,9
89,5,0,5,201,43,1
89,3,0,3,201,38,2
90,4,0,4,200,33,6
89,3,0,3,198,39,4
89,4,0,4,198,39,4
89,5,0,5,199,34,5
88,5,0,5,201,29,6
89,8,0,8,203,24,0
87,10,1,9,206,25,8
86,6,0,6,210,27,16
77,7,0,7,219,31,6
76,5,0,5,224,32,11
71,5,0,5,231,33,10
68,4,0,4,236,36,13
72,3,0,3,233,34,6
72,3,0,3,231,33,2
73,4,0,4,228,33,1
74,5,0,5,228,33,4
77,4,0,4,223,38,0
78,2,0,2,220,42,0
78,2,0,2,218,44,10
81,2,0,2,215,46,0
86,3,0,3,211,43,11
88,2,0,2,209,43,0
88,1,0,1,207,45,7
90,1,0,1,203,51,0
91,1,0,1,199,40,2
91,1,0,1,194,33,0
92,1,0,1,192,31,0
92,1,0,1,192,29,0
92,2,0,2,192,29,1
92,3,0,3,194,29,0
90,3,0,3,198,28,3
86,2,0,2,204,26,3
88,2,0,2,208,26,5
86,2,0,2,209,30,4
89,3,0,3,207,30,4
91,2,0,2,208,29,0
90,2,0,2,206,29,0
90,2,0,2,205,28,0
90,2,0,2,203,27,5
89,2,0,2,199,27,0
90,2,0,2,195,27,0
91,4,0,4,190,26,0
91,6,0,6,186,26,0
91,5,0,5,184,26,0
91,6,0,6,183,24,0
89,6,0,6,184,22,2
87,6,0,6,183,23,1
84,16.62272672,3.205133757,13.41759296,183,21,2
83,16.62272672,3.205133757,13.41759296,182,21,3
82,4,0,4,182,21,2
82,4,0,4,182,20,1
80,7,0,7,184,19,5
78,6,0,6,189,19,0
73,4,0,4,196,19,5
71,4,0,4,202,22,9
70,5,0,5,206,25.42609823,12
70,16.61985126,3.204350434,13.41550082,209,24,0
64,4,0,4,220,27,10
60,4,0,4,237,28,7
56,3,0,3,246,29,11
58,3,0,3,244,28,11
58,3,0,3,241,29,10
59,3,0,3,232,29,3
64,4,0,4,218,30,0
68,5,0,5,209,31,0
71,4,0,4,203,31,1
72,3,0,3,198,31,0
73,3,0,3,196,31,4
74,3,0,3,194,31,3
75,3,0,3,193,30,3
73,3,0,3,192,30,1
72,2,0,2,192,31,4
72,2,0,2,191,29,9
71,3,0,3,189,27,4
71,4,0,4,188,26,5
71,6,0,6,190,24,4
70,7,0,7,192,20,5
67,8,1,7,197,22,8
65,7,1,6,204,22,5
66,5,0,5,204,24,9
65,5,0,5,206,25,7
65,4,0,4,211,28,9
64,4,0,4,215,31,6
64,3,0,3,213,32,15
59,3,0,3,215,31,2
62,3,0,3,213,31,17
63,4,0,4,213,30,0
65,5,0,5,210,30,11
68,7,1,6,205,31,0
69,6,0,6,199,30,3
72,6,0,6,196,31,1
75,5,0,5,193,30,4
77,5,0,5,190,29,3
78,5,0,5,188,29,5
77,5,0,5,188,29,2
76,5,0,5,188,29,3
74,3,0,3,189,29,5
74,3,0,3,188,29,6
74,5,0,5,187,26,2
73,7,0,7,188,22,5
69,8,1,7,193,22,8
65,8,1,7,199,25,11
58,6,1,5,225,23,11
55,5,0,5,230,26,20
57,4,0,4,237,29,10
53,3,0,3,244,30,6
55,3,0,3,248,30,8
56,4,0,4,248,29,6
56,4,0,4,246,28,0
57,4,0,4,239,29,4
58,3,0,3,236,28,0
60,5,0,5,230,29,0
63,4,0,4,216,32,2
66,5,0,5,208,31,1
68,5,0,5,201,31,0
70,4,0,4,197,30,2
71,4,0,4,194,30,0
72,3,0,3,191,30,0
73,3,0,3,190,31,4
71,3,0,3,189,31,4
71,3,0,3,189,31,5
70,3,0,3,190,32,5
70,5,0,5,191,31,8
70,5,0,5,193,29,8
68,4,0,4,198,27,8
62,4,0,4,207,27,13
58,4,0,4,222,26,12
57,4,0,4,228,28,19
58,4,0,4,228,31,11
59,4,0,4,232,31,5
57,4,0,4,234,31,13
57,5,0,5,238,37,15
60,6,0,6,236,39,21
62,8,0,8,234,38,13
68,10,1,9,225,34,10
75,9,0,9,217,26,4
76,9,0,9,209,22,9
80,8,0,8,204,22,8
80,12,0,12,201,20,8
80,12,0,12,202,16,11
80,12,0,12,201,16,15
85,10,0,10,199,15,1
88,9,0,9,198,14,8
87,8,0,8,195,17,11
88,6,0,6,194,24,7
89,5,0,5,193,24,4
90,5,0,5,192,25,6
91,8,0,8,194,20,4
91,9,0,9,197,19,4
89,6,0,6,200,28,9
88,5,0,5,206,31,2
89,5,0,5,210,31,19
90,7,0,7,215,30,1
90,7,0,7,220,27,14
89,7,1,6,221,33,3
89,4,0,4,219,33,1
87,6,0,6,217,30,0
83,8,0,8,218,34,11
84,4,0,4,217,31,5
87,5,0,5,214,30,3
89,6,0,6,211,29,0
90,9,0,9,211,29,4
89,13,0,13,212,23,1
87,14,0,14,212,16,7
87,13,0,13,211,17,4
86,17,1,16,211,13,5
86,11,0,11,212,13,10
86,11,0,11,213,9,2
87,15,1,14,213,6,12
89,16,1,15,213,2,1
89,21,3,18,213,1,10
89,37,18,19,215,3,10
84,34,12,22,220,5,19
80,29,7,22,229,12,18
73,24,4,20,237,20,17
68,18,2,16,251,29,19
63,13,1,12,261,33,26
58,16,1,15,270,38,16
58,18,1,17,274,57,13
60,15,0,15,272,68,20
64,18,0,18,268,56,20
69,19,1,18,263,46,23
74,17,0,17,256,44,16
76,23,0,23,253,42,19
82,25,0,25,248,35,19
84,20,0,20,246,27,13
86,14,0,14,244,23,17
86,14,0,14,242,27,16
88,10,0,10,239,38,20
87,11,0,11,238,33,9
87,12,0,12,236,31,23
88,14,0,14,233,32,13
86,9,0,9,224,36,16
89,4,0,4,213,47,13
91,5,0,5,211,50,3
92,3,0,3,206,51,8
92,5,0,5,206,52,2
92,3,0,3,208,54,5
92,4,0,4,211,47,7
92,4,0,4,211,47,12
92,4,0,4,213,48,0
92,3,0,3,216,45,5
91,3,0,3,218,46,7
91,4,0,4,221,45,0
88,3,0,3,222,47,0
86,3,0,3,225,48,11
88,3,0,3,226,44,0
87,4,0,4,225,41,4
89,8,0,8,224,40,0
88,7,0,7,223,39,6
88,5,0,5,221,39,5
88,5,0,5,218,39,5
88,4,0,4,216,33,8
87,4,0,4,213,30,0
89,5,0,5,211,27,13
89,16.56968159,3.188889604,13.38079199,208,24,3
89,16.56968159,3.188889604,13.38079199,206,24,14
89,2,0,2,204,25,1
90,2,0,2,203,25,4
90,2,0,2,203,23,3
89,2,0,2,205,23,2
88,3,0,3,208,23,6
88,3,0,3,212,23,5
85,3,0,3,221,23,0
78,3,0,3,232,25,12
77,3,0,3,231,27,9
72,3,0,3,239,25,0
68,2,0,2,247,22,8
67,2,0,2,247,22,11
70,3,0,3,240,23,3
71,3,0,3,232,23,0
72,3,0,3,228,24,0
75,5,1,4,221,23,2
83,4,0,4,212,21,0
85,3,0,3,207,20,3
86,3,0,3,205,20,0
88,3,0,3,203,20,8
89,2,0,2,200,20,2
89,2,0,2,199,21,1
91,2,0,2,196,21,1
91,2,0,2,196,21,0
92,2,0,2,196,21,1
92,3,0,3,196,19,0
92,6,0,6,196,14,0
92,9,1,8,199,11,3
92,10,2,8,204,10,4
91,9,2,7,207,9,6
89,8,2,6,210,25.44623541,13
90,16.5557515,3.185738616,13.37001289,214,10,0
90,8,2,6,216,12,18
91,6,1,5,216,15,0
90,3,0,3,216,16,5
90,6,1,5,217,18,1
88,5,0,5,217,20,3
87,5,0,5,218,20,9
89,10,1,9,218,20,0
90,11,1,10,217,18,6
90,8,0,8,215,16,0
90,7,0,7,214,16,10
90,6,0,6,214,18,0
91,5,0,5,214,17,7
91,6,0,6,213,13,0
91,8,0,8,212,10,3
91,10,0,10,212,13,3
92,8,0,8,213,8,7
92,10,0,10,212,5,0
92,12,0,12,213,5,8
92,16,2,14,214,5,1
92,18,3,15,215,4,12
91,21,7,14,221,6,9
89,16,3,13,223,6,22
84,17,5,12,238,9,8
80,9,1,8,241,19,23
77,8,1,7,249,21,18
71,9,1,8,260,26,12
67,6,0,6,269,29,14
65,5,0,5,274,40,8
64,5,0,5,279,43,13
60,6,0,6,279,43,8
64,7,0,7,275,43,6
70,18,1,17,267,44,17
76,14,0,14,256,34,8
79,14,0,14,247,39,12
80,15,0,15,244,39,5
82,14,0,14,242,29,15
82,10,0,10,239,22,9
84,9,0,9,237,19,21
85,8,0,8,234,12,14
86,8,0,8,231,11,18
87,8,0,8,226,11,14
87,9,0,9,224,10,6
88,11,2,9,224,8,16
86,12,3,9,232,11,5
84,13,2,11,238,13,30
82,14,2,12,245,11,12
79,18,3,15,253,13,14
71,18,2,16,266,22,22
69,24,2,22,274,31,37
65,21,1,20,283,40,37
59,21,1,20,296,42,27
61,13,1,12,300,38,19
66,11,1,10,287,25,14
69,14,2,12,283,18,7
71,9,1,8,276,18,0
75,13,1,12,271,13,5
79,9,0,9,268,13,5
84,12,0,12,262,8,9
87,15,1,14,260,5,7
90,12,1,11,257,3,1
91,13,2,11,254,2,4
89,8,1,7,248,3,0
91,8,0,8,248,3,5
88,9,0,9,243,5,0
87,10,0,10,241,7,5
90,10,0,10,241,4,3
89,11,4,7,244,3,1
87,14,6,8,250,3,12
84,13,5,8,258,3,3
85,21,11,10,262,4,18
79,18,9,9,269,4,12
72,23,10,13,275,6,14
64,28,10,18,291,8,14
60,22,5,17,299,17,6
58,15,3,12,305,22,6
57,14,2,12,305,23,9
60,17,3,14,298,22,5
63,16,3,13,292,20,5
66,23,2,21,288,24,8
72,26,1,25,283,10,11
75,35,2,33,280,3,10
75,42,4,38,278,5,12
78,36,3,33,276,23,15
82,36,3,33,274,22,9
82,37,4,33,269,12,16
83,37,7,30,263,11,12
85,25,2,23,259,11,9
87,17,1,16,257,7,12
87,11,0,11,258,5,13
87,8,0,8,258,6,19
86,8,1,7,257,6,15
85,11,3,8,260,10,12
83,9,2,7,267,11,16
77,8,1,7,275,16,26
72,7,1,6,278,25,21
71,9,1,8,282,30,18
70,10,1,9,284,31,16
70,10,1,9,289,38,14
63,9,0,9,300,42,13
62,9,0,9,302,54,24
67,17,1,16,294,53,21
67,11,0,11,286,34,24
69,6,0,6,279,27,13
71,6,0,6,272,26,5
74,6,0,6,270,26,4
76,6,0,6,267,27,10
79,5,0,5,261,25,8
81,7,0,7,256,20,9
83,7,0,7,254,16,9
86,7,0,7,252,12,10
87,7,0,7,251,10,12
87,8,0,8,249,11,14
88,7,0,7,247,9,7
88,6,0,6,243,11,13
89,5,0,5,244,12,8
88,7,1,6,248,15,19
89,5,0,5,249,15,16
86,9,1,8,246,18,21
87,11,1,10,248,19,18
85,12,1,11,252,19,42
83,8,1,7,258,24,39
80,8,1,7,263,24,26
75,5,0,5,273,25,24
75,4,0,4,275,28,25
75,6,1,5,266,28,22
78,3,0,3,255,27,9
80,3,0,3,245,25,9
82,3,0,3,237,25,0
86,2,0,2,229,26,11
88,2,0,2,226,26,0
89,3,0,3,225,24,10
90,3,0,3,223,22,0
89,3,0,3,222,21,14
89,2,0,2,222,20,0
90,16.53326296,3.177147054,13.3561159,222,20,13
90,16.53326296,3.177147054,13.3561159,221,19,6
91,2,0,2,220,19,3
91,2,0,2,219,19,8
91,4,0,4,219,18,0
91,4,0,4,219,15,10
91,4,0,4,220,14,0
91,4,0,4,221,25.41129734,12.26647496
90,16.53052977,3.176489191,13.35404058,224,12,0
88,6,1,5,227,10,20
87,6,1,5,230,11,6
87,7,1,6,232,11,6
85,7,1,6,235,12,10
85,7,1,6,238,13,10
85,8,1,7,239,13,11
85,10,3,7,240,13,14
87,8,0,8,239,12,19
89,7,0,7,234,11,17
90,9,1,8,232,12,14
90,10,1,9,230,13,7
91,6,0,6,229,13,9
91,6,0,6,228,13,5
91,7,0,7,228,12,0
91,5,0,5,227,12,12
92,4,0,4,227,12,3
92,4,0,4,226,11,12
92,3,0,3,226,9,5
93,4,0,4,227,7,7
93,8,1,7,228,4,13
93,12,3,9,230,4,0
92,7,1,6,233,6,10
92,9,2,7,236,6,6
92,10,2,8,236,6,11
92,11,2,9,238,7,1
91,13,4,9,245,9,9
89,11,3,8,253,10,12
84,7,1,6,262,16,15
80,6,0,6,270,24,21
79,6,0,6,270,27,13
82,6,1,5,265,12,8
84,6,0,6,260,11,0
86,11,2,9,258,14,0
88,9,1,8,253,12,0
88,7,0,7,249,16,0
89,8,0,8,250,11,6
89,6,0,6,249,8,0
89,6,0,6,247,8,9
90,5,0,5,244,6,2
91,6,0,6,243,5,5
91,7,0,7,241,4,2
91,7,0,7,241,4,0
91,7,0,7,240,4,14
91,10,3,7,243,4,2
89,7,2,5,247,6,6
82,8,3,5,262,7,9
75,8,3,5,272,11,19
74,7,2,5,274,14,22
66,4,0,4,287,16,4
62,3,0,3,293,22,3
62,4,0,4,299,24,8
64,7,1,6,303,23,6
63,7,1,6,299,24,10
61,5,0,5,305,25,2
62,7,1,6,295,25,12
66,9,1,8,289,23,10
70,9,1,8,284,21,7
69,7,0,7,280,17,4
68,6,0,6,278,23,5
74,8,0,8,274,23,7
79,7,0,7,268,11,7
80,9,1,8,266,9,1
83,7,0,7,262,9,5
84,7,0,7,259,7,7
86,8,0,8,256,6,6
88,7,0,7,251,5,6
88,8,1,7,251,3,5
88,12,4,8,251,3,7
86,16,7,9,259,5,14
76,21,8,13,276,10,21
71,19,3,16,284,19,35
74,22,3,19,282,15,26
66,18,2,16,298,18,20
59,15,1,14,307,37,31
55,11,0,11,319,58,42
51,10,0,10,323,59,39
52,8,0,8,318,48,23
56,9,0,9,312,45,22
61,8,0,8,303,36,13
69,12,1,11,291,24,18
76,10,0,10,283,14,20
77,8,0,8,280,7,19
78,9,0,9,278,6,24
78,10,0,10,275,6,25
79,12,0,12,273,3,32
77,13,1,12,270,3,31
77,8,0,8,269,2,26
79,11,1,10,267,3,13
82,8,0,8,265,2,10
81,11,1,10,263,2,9
83,13,1,12,261,2,4
82,20,8,12,265,3,10
78,16,7,9,273,4,8
73,21,11,10,284,5,16
64,11,4,7,301,8,19
56,10,3,7,308,11,7
49,8,2,6,314,14,1
47,6,1,5,325,15,1
45,8,1,7,332,18,7
48,7,1,6,327,16,11
52,8,2,6,314,14,3
54,8,2,6,309,13,0
46,7,1,6,307,13,0
56,6,1,5,299,11,0
62,14,2,12,288,8,3
66,19,4,15,287,6,2
72,16,4,12,283,6,5
78,7,0,7,281,4,6
79,7,0,7,278,3,4
79,6,0,6,279,2,5
80,6,0,6,277,1,9
80,7,1,6,277,2,8
79,12,4,8,277,2,8
78,11,3,8,278,4,7
81,10,3,7,276,5,8
87,10,3,7,261,6,4
88,9,3,6,268,6,0
86,11,5,6,274,5,5
87,14,6,8,269,5,16
76,10,5,5,284,7,8
71,7,2,5,293,10,14
77,7,2,5,287,9,16
67,6,2,4,300,10,11
65,5,1,4,304,12,11
65,7,2,5,305,12,7
66,7,2,5,299,12,7
70,6,1,5,294,12,11
74,8,2,6,288,12,13
77,6,1,5,281,11,7
79,7,0,7,279,12,4
81,9,1,8,277,10,6
82,6,0,6,275,9,11
82,3,0,3,273,9,15
81,4,0,4,272,8,12
80,5,0,5,273,9,24
80,3,0,3,273,7,28
80,5,0,5,273,7,28
87,8,0,8,263,14,31
89,4,0,4,261,14,18
89,4,0,4,259,15,29
87,5,0,5,257,15,16
90,4,0,4,257,14,18
88,11,2,9,259,13,11
85,13,3,10,269,10,21
77,9,2,7,284,11,33
68,12,3,9,296,19,41
58,8,1,7,313,21,36
59,8,1,7,319,25,34
57,7,0,7,321,30,39
60,6,0,6,314,29,34
65,9,1,8,300,23,20
74,9,1,8,288,20,25
78,8,0,8,281,17,26
80,8,0,8,278,14,28
81,8,0,8,273,11,31
82,8,0,8,272,8,33
82,9,0,9,271,6,34
82,12,0,12,271,3,26
83,13,1,12,270,2,30
84,16.48723931,3.166190884,13.32104842,269,2,29
84,16.48723931,3.166190884,13.32104842,268,2,30
86,19,6,13,266,2,26
86,17,5,12,265,2,19
86,26,12,14,268,2,21
81,38,20,18,279,3,28
74,34,15,19,286,7,37
65,19,6,13,305,25.33407093,26
61,14,3,11,317,18,12
59,16.48900934,3.167729231,13.32128011,326,28,12
56,18,2,16,328,32,0
52,11,1,10,335,41,30
56,10,1,9,325,35,27
59,8,1,7,321,30,20
61,8,1,7,315,28,22
64,13,1,12,306,29,10
67,13,2,11,295,11,12
75,9,1,8,287,6,8
76,8,0,8,285,5,3
77,13,1,12,283,6,8
79,19,2,17,280,3,12
79,23,5,18,279,2,15
81,17,1,16,277,3,16
79,19,2,17,282,2,15
78,28,10,18,280,2,21
79,29,11,18,276,4,19
79,27,8,19,274,3,15
84,31,15,16,274,2,17
81,31,14,17,277,2,17
77,33,14,19,282,5,23
73,36,14,22,294,7,28
65,31,9,22,309,12,26
58,29,8,21,319,17,29
58,13,2,11,326,21,42
56,12,1,11,331,27,33
57,8,1,7,329,36,26
58,9,1,8,331,30,18
60,8,1,7,323,23,17
63,10,2,8,317,18,6
66,10,2,8,308,17,6
71,12,2,10,299,15,9
75,11,1,10,290,10,13
76,10,1,9,288,5,3
78,11,1,10,284,2,9
80,10,0,10,280,5,11
80,12,0,12,279,8,15
81,12,0,12,278,9,16
82,10,0,10,275,8,20
81,15,0,15,276,5,16
80,16,0,16,278,4,19
80,23,1,22,279,3,21
79,26,3,23,280,2,24
81,25,6,19,279,3,24
79,40,16,24,284,3,21
72,40,16,24,299,7,25
64,30,7,23,317,18,19
63,28,4,24,321,26,25
58,26,2,24,331,28,24
54,16,1,15,339,42,34
52,10,0,10,342,47,31
52,9,0,9,339,42,26
53,11,1,10,334,35,23
55,10,1,9,331,31,18
58,10,1,9,328,28,18
61,13,1,12,318,26,16
64,16,1,15,305,17,14
71,10,0,10,296,25,27
76,10,0,10,290,19,19
80,9,0,9,283,16,15
81,6,0,6,281,11,11
83,8,0,8,279,8,16
82,10,0,10,279,10,15
83,11,0,11,278,8,20
83,12,0,12,277,6,23
83,18,1,17,278,3,21
82,26,3,23,278,2,27
82,30,8,22,282,3,29
78,39,15,24,290,4,31
72,30,9,21,302,8,37
64,22,3,19,318,19,22
58,19,2,17,335,27,32
52,9,0,9,345,44,41
47,7,0,7,350,51,36
47,6,0,6,356,54,41
45,6,0,6,355,64,41
41,5,0,5,365,48,31
48,6,0,6,358,62,32
54,16,0,16,345,100,30
59,23,0,23,330,96,20
61,24,1,23,318,40,12
65,21,1,20,308,14,20
74,20,1,19,298,5,23
77,19,1,18,293,3,17
79,17,0,17,289,6,19
80,14,0,14,286,6,17
82,9,0,9,284,8,14
82,11,0,11,284,5,16
83,18,1,17,283,1,16
83,16,1,15,281,1,16
84,19,1,18,281,1,17
82,27,9,18,284,2,17
79,34,14,20,291,4,21
73,26,8,18,302,8,24
64,24,5,19,322,18,25
62,21,2,19,323,37,35
59,18,1,17,327,52,25
56,13,0,13,337,65,36
49,9,0,9,352,73,45
47,10,0,10,355,82,54
49,14,0,14,351,101,36
58,13,0,13,335,62,31
59,10,1,9,324,38,15
62,15,1,14,314,27,8
71,18,1,17,301,14,14
74,14,0,14,294,4,16
73,15,1,14,289,2,8
73,12,1,11,284,3,7
76,8,0,8,282,3,5
78,15,4,11,280,1,7
79,10,1,9,279,1,10
79,9,1,8,276,2,9
79,11,2,9,275,2,7
80,12,2,10,273,2,8
81,12,2,10,273,2,6
80,14,5,9,274,2,7
75,21,12,9,282,3,11
69,17,9,8,294,5,17
61,19,8,11,313,8,16
58,17,5,12,324,15,21
53,7,1,6,330,27,24
50,7,0,7,333,34,27
48,8,0,8,340,43,26
46,8,0,8,343,47,21
47,7,0,7,340,44,22
53,9,1,8,328,34,16
59,10,1,9,315,28,7
62,11,1,10,308,20,3
63,22,2,20,301,11,8
68,18,1,17,294,10,11
74,10,0,10,285,10,12
74,7,0,7,283,10,5
73,5,0,5,281,8,4
76,7,0,7,278,3,1
75,9,0,9,278,2,6
78,12,0,12,277,2,11
79,8,0,8,275,3,10
80,9,0,9,274,3,6
80,12,1,11,273,2,7
80,13,3,10,273,4,11
76,10,3,7,279,6,9
69,12,5,7,290,7,20
61,11,3,8,309,13,16
54,12,3,9,316,16,13
47,8,0,8,328,24,16
40,7,0,7,333,36,25
39,6,0,6,343,31,14
43,6,0,6,348,39,20
47,7,0,7,345,54,29
49,9,0,9,337,61,20
51,6,0,6,327,54,9
53,4,0,4,319,33,1
54,4,0,4,309,17,0
61,8,1,7,297,8,3
67,3,0,3,291,6,1
69,3,0,3,285,6,1
70,3,0,3,282,6,0
75,8,2,6,277,7,4
75,5,0,5,279,6,3
75,16.47862669,3.163310148,13.31531654,278,5,2
77,16.47862669,3.163310148,13.31531654,275,3,4
78,5,0,5,271,3,4
80,8,2,6,267,2,3
80,15,8,7,268,3,1
74,9,5,4,277,3,5
63,8,4,4,291,5,19
52,4,1,3,314,7,13
48,16.47692534,3.16334495,13.31358039,324,10,10
49,3,0,3,331,25.29601887,10
46,6,1,5,340,16,9
46,5,0,5,343,22,17
45,5,0,5,351,22,8
46,8,1,7,350,28,11
51,9,1,8,345,34,9
58,10,1,9,328,28,8
61,12,1,11,321,19,0
64,17,2,15,313,9,0
66,14,2,12,305,4,4
71,12,2,10,299,3,7
72,14,4,10,294,2,1
73,15,6,9,294,2,2
74,10,2,8,291,1,4
79,6,1,5,287,2,4
78,4,0,4,285,3,5
81,4,0,4,284,2,6
82,11,3,8,284,1,6
81,14,6,8,286,1,9
76,15,7,8,288,1,11
71,18,10,8,295,2,12
66,22,14,8,306,3,15
59,19,10,9,325,6,8
57,22,6,16,331,12,13
54,18,4,14,334,18,16
51,12,3,9,335,20,16
48,10,2,8,342,18,9
49,7,2,5,341,16,9
50,8,2,6,336,14,2
52,8,3,5,332,11,0
57,7,2,5,321,8,0
63,9,2,7,311,7,0
69,12,2,10,299,4,8
76,6,1,5,294,2,6
77,5,0,5,291,3,4
76,8,1,7,289,1,6
73,9,1,8,290,1,5
71,13,5,8,289,1,7
72,11,3,8,288,1,10
73,12,5,7,285,1,9
73,13,5,8,284,1,4
72,18,10,8,286,1,7
72,19,12,7,285,1,6
75,23,15,8,286,1,4
73,24,15,9,292,2,11
64,25,13,12,305,6,10
56,19,6,13,328,16,18
52,19,5,14,339,29,22
50,23,5,18,343,23,21
48,16,2,14,348,30,15
49,10,1,9,344,32,13
48,10,1,9,344,32,10
48,10,1,9,341,28,8
54,9,1,8,330,23,6
60,12,2,10,315,13,0
64,16,3,13,307,5,3
67,12,2,10,296,2,7
69,9,1,8,291,2,2
73,9,1,8,289,2,5
74,9,1,8,288,1,8
74,10,1,9,285,1,9
76,12,2,10,283,1,10
78,12,2,10,282,1,11
79,12,2,10,279,1,9
79,12,3,9,279,1,10
79,13,4,9,278,1,8
78,18,8,10,277,1,10
77,23,13,10,280,1,9
74,27,15,12,287,2,15
68,28,14,14,300,5,21
60,27,10,17,322,11,13
57,29,7,22,330,19,22
54,25,4,21,341,29,23
52,18,1,17,335,38,27
50,11,1,10,338,28,12
54,10,2,8,328,24,9
57,10,2,8,317,18,4
59,10,2,8,314,16,0
62,12,2,10,307,14,5
63,16,3,13,304,10,8
66,16,2,14,296,7,10
68,13,1,12,293,3,7
70,13,1,12,290,2,5
74,12,1,11,285,2,10
77,10,0,10,282,2,6
79,10,0,10,279,1,7
80,10,0,10,276,1,6
80,11,1,10,276,1,8
80,11,1,10,277,1,5
80,11,1,10,275,1,12
80,12,2,10,276,1,8
79,15,5,10,278,2,10
74,21,11,10,287,3,15
68,21,10,11,298,5,26
62,25,11,14,315,7,14
56,24,9,15,330,10,20
51,23,6,17,339,18,26
49,17,2,15,344,37,25
48,11,0,11,343,48,22
46,10,0,10,346,47,13
48,9,0,9,340,38,8
49,9,1,8,333,28,2
56,8,1,7,315,21,0
60,10,1,9,303,11,0
63,15,1,14,297,5,3
65,7,0,7,290,5,2
67,5,0,5,287,3,0
71,6,0,6,284,1,1
71,8,0,8,285,2,5
73,9,1,8,285,2,6
76,6,0,6,282,2,8
77,9,1,8,280,1,6
78,9,1,8,278,1,6
77,10,1,9,278,1,4
78,13,4,9,275,1,6
79,16,8,8,277,2,9
73,20,11,9,285,3,13
69,16,7,9,294,5,20
66,17,7,10,301,6,9
62,17,5,12,310,13,14
60,15,1,14,320,35,22
56,13,1,12,325,37,27
53,10,0,10,332,47,29
50,10,0,10,332,62,26
44,8,0,8,333,48,18
51,5,0,5,325,28,6
45,6,1,5,319,22,1
47,5,1,4,311,11,0
55,9,1,8,303,7,0
58,8,1,7,299,7,1
68,10,1,9,291,6,1
73,11,2,9,288,4,2
75,10,2,8,284,4,2
76,10,2,8,283,5,1
78,7,0,7,282,4,3
79,8,1,7,280,4,2
79,7,0,7,279,2,2
79,7,0,7,278,2,4
79,8,0,8,278,2,8
80,11,4,7,278,2,7
76,13,6,7,283,4,11
67,10,4,6,294,7,18
63,7,1,6,309,15,6
58,7,1,6,319,18,9
55,6,0,6,331,27,15
55,5,0,5,331,35,23
56,4,0,4,329,34,19
57,4,0,4,327,33,17
58,4,0,4,324,35,22
61,4,0,4,318,35,23
62,8,0,8,314,22,24
65,7,0,7,308,30,18
68,9,0,9,295,30,23
74,6,0,6,279,27,23
77,5,0,5,272,23,20
78,5,0,5,270,23,19
79,4,0,4,269,22,20
80,3,0,3,268,22,20
79,2,0,2,268,23,21
81,16.45168762,3.161954801,13.28973282,268,22,18
82,16.45168762,3.161954801,13.28973282,265,16,24
84,4,0,4,262,15,24
84,4,0,4,263,14,21
84,3,0,3,263,17,20
82,4,0,4,267,13,22
79,5,1,4,274,11,27
67,5,1,4,299,10,29
62,4,1,3,306,10,22
65,4,1,3,303,12,14
76,5,1,4,294,15,10
66,6,1,5,300,13,9
50,5,0,5,324,18,3
50,4,0,4,334,23,17
50,3,0,3,335,20,16
55,3,0,3,326,15,8
57,3,0,3,320,10,0
62,7,1,6,306,8,0
66,3,0,3,300,5,9
71,3,0,3,295,5,7
74,3,0,3,291,5,8
73,3,0,3,292,2,8
76,3,0,3,290,3,10
78,4,0,4,287,4,7
79,4,0,4,286,3,5
80,6,1,5,282,2,8
81,6,1,5,280,2,6
83,6,1,5,277,2,7
83,8,3,5,278,3,7
80,5,2,3,287,3,8
72,3,1,2,295,4,13
75,3,1,2,296,25.21125248,9
82,16.43933207,3.159315972,13.2800161,287,6,13
68,4,1,3,310,6,2
58,5,1,4,327,12,11
56,4,0,4,333,19,17
60,4,0,4,338,25,11
84,5,0,5,281,19,8
80,11,2,9,294,12,0
75,11,2,9,297,8,0
77,10,2,8,297,11,7
74,12,1,11,299,9,14
75,10,1,9,299,7,14
76,4,0,4,294,6,13
79,6,0,6,291,7,15
80,5,0,5,288,5,14
81,5,0,5,287,4,16
83,5,0,5,285,5,12
84,5,0,5,283,6,11
84,4,0,4,281,6,13
87,4,0,4,278,6,13
88,4,0,4,276,5,13
88,6,1,5,277,5,12
83,6,2,4,287,5,17
74,4,1,3,298,8,25
70,4,1,3,304,12,19
85,4,1,3,283,14,15
72,4,1,3,302,12,0
69,4,1,3,311,20,7
70,3,0,3,311,18,11
68,3,0,3,312,11,10
59,5,1,4,320,15,7
60,6,1,5,320,14,13
60,12,3,9,315,11,7
63,10,3,7,308,10,9
67,9,1,8,302,10,19
70,6,0,6,298,8,14
74,6,0,6,293,3,10
77,5,0,5,292,3,16
78,5,0,5,292,4,18
79,5,0,5,291,5,19
78,8,1,7,289,10,19
78,8,1,7,288,12,19
78,8,0,8,287,13,21
78,11,1,10,287,13,23
76,9,0,9,288,14,22
76,8,0,8,289,14,23
72,7,1,6,293,13,22
70,9,2,7,299,14,23
63,8,2,6,313,13,19
61,6,1,5,316,14,16
59,3,0,3,322,16,12
65,6,1,5,320,15,11
67,7,1,6,307,17,12
70,6,1,5,308,15,5
78,11,2,9,299,15,11
72,6,1,5,303,15,9
74,5,1,4,295,13,18
77,9,1,8,288,14,14
74,8,1,7,291,15,4
74,10,1,9,290,15,15
74,7,0,7,289,14,18
75,6,0,6,289,12,16
74,7,0,7,291,14,16
73,6,0,6,291,16,20
72,6,0,6,292,17,21
75,2,0,2,290,21,21
79,4,0,4,285,23,20
78,4,0,4,284,26,26
79,5,0,5,282,31,30
81,5,0,5,281,35,39
82,4,0,4,281,35,39
79,3,0,3,282,37,39
76,4,0,4,287,40,36
75,4,0,4,290,40,40
74,4,0,4,290,41,41
73,5,0,5,292,40,39
71,4,0,4,295,40,46
71,4,0,4,296,40,39
70,4,0,4,298,39,37
68,4,0,4,301,35,38
67,4,0,4,302,32,37
67,5,0,5,299,30,31
72,5,0,5,288,29,28
69,5,0,5,290,27,24
67,6,0,6,291,27,27
68,6,0,6,289,30,26
63,8,0,8,291,34,24
64,7,0,7,290,35,18
66,8,0,8,289,36,26
66,7,0,7,287,35,24
66,6,0,6,286,36,23
67,6,0,6,285,36,21
68,7,0,7,283,35,21
68,7,0,7,283,32,20
66,8,0,8,290,31,22
60,6,0,6,303,32,28
52,7,0,7,322,34,24
50,10,1,9,333,40,29
49,12,1,11,336,42,30
48,10,0,10,339,48,29
49,9,0,9,338,51,24
51,9,0,9,336,54,22
49,8,0,8,336,49,22
52,9,0,9,334,51,21
59,11,0,11,318,45,24
64,21,1,20,305,42,15
67,22,1,21,301,36,22
69,18,0,18,297,27,27
70,18,0,18,293,24,33
70,26,6,20,292,17,31
73,19,0,19,289,16,32
74,13,1,12,287,21,30
76,12,0,12,282,23,28
77,11,0,11,283,23,31
77,9,0,9,281,16,34
77,8,0,8,278,14,36
78,9,0,9,275,13,29
77,10,1,9,277,13,30
75,10,1,9,285,14,30
67,9,1,8,297,20,43
55,5,0,5,318,34,26
47,4,0,4,331,39,24
47,4,0,4,337,42,28
45,3,0,3,339,42,22
44,3,0,3,346,39,15
45,3,0,3,342,40,12
44,2,0,2,340,40,9
46,3,0,3,332,41,6
51,2,0,2,320,42,5
56,5,0,5,312,40,9
63,6,0,6,300,34,24
68,4,0,4,295,33,28
73,3,0,3,287,32,33
74,2,0,2,284,31,34
76,3,0,3,282,31,33
76,3,0,3,282,30,32
77,3,0,3,280,31,36
78,16.39580082,3.146951084,13.24884973,279,30,35
76,16.39580082,3.146951084,13.24884973,279,26,35
75,3,0,3,278,26,32
75,4,0,4,276,25,32
73,5,0,5,275,25,30
73,6,0,6,277,21,27
72,6,0,6,283,19,29
72,5,0,5,285,25.20065449,33
71,16.39346095,3.146314243,13.24714671,289,26,31
68,4,0,4,295,23,21
62,6,1,5,307,23,19
61,3,0,3,309,26,18
63,3,0,3,308,25,17
64,4,0,4,308,22,18
64,4,0,4,306,27,27
68,5,0,5,294,30,20
72,6,0,6,282,33,28
76,7,0,7,276,31,22
78,8,0,8,272,29,22
79,5,0,5,271,32,29
80,4,0,4,271,33,30
81,3,0,3,268,31,25
84,3,0,3,264,27,22
83,3,0,3,263,24,16
82,3,0,3,264,24,23
82,4,0,4,263,23,13
82,5,0,5,261,22,15
82,6,0,6,260,21,12
83,8,0,8,259,20,13
80,7,0,7,264,20,12
79,6,0,6,270,22,17
77,7,0,7,277,23,17
83,6,0,6,273,24,23
86,11,1,10,274,17,18
82,17,1,16,281,19,21
76,15,1,14,295,27,24
57,9,1,8,315,32,20
57,9,0,9,312,31,26
60,7,0,7,310,31,14
78,7,0,7,260,28,24
77,7,0,7,254,23,0
79,9,0,9,254,21,0
83,6,0,6,249,19,0
82,7,0,7,246,20,0
81,8,0,8,246,17,5
83,6,0,6,245,20,1
84,6,0,6,245,16,3
84,5,0,5,244,15,3
86,6,0,6,243,12,1
86,10,0,10,241,8,7
89,8,0,8,239,13,0
89,6,0,6,242,14,14
88,8,0,8,245,8,9
86,15,3,12,251,7,16
80,15,4,11,259,9,15
67,10,2,8,282,15,13
59,6,1,5,299,23,13
57,5,0,5,304,30,8
60,5,0,5,306,36,10
61,5,0,5,305,38,7
57,8,0,8,312,42,17
60,7,0,7,304,45,19
58,6,0,6,297,32,15
58,5,0,5,291,29,9
59,6,0,6,282,30,5
72,6,0,6,269,30,5
78,5,0,5,265,26,4
82,5,0,5,262,24,8
88,6,0,6,257,22,5
89,6,0,6,256,17,9
90,6,0,6,254,16,10
89,7,0,7,254,16,13
89,5,0,5,253,16,14
87,3,0,3,243,27,10
87,2,0,2,242,31,0
87,3,0,3,242,29,1
87,3,0,3,243,27,7
86,5,0,5,244,23,4
85,6,0,6,247,19,7
82,5,0,5,253,24,12
78,4,0,4,261,26,11
75,5,0,5,271,27,17
72,5,0,5,279,29,21
69,5,0,5,283,32,17
70,5,0,5,281,32,13
68,4,0,4,287,36,13
63,5,0,5,294,38,8
63,6,0,6,293,45,14
64,9,0,9,287,46,13
67,9,0,9,284,44,14
69,9,0,9,281,35,9
72,10,0,10,278,29,11
79,12,0,12,275,22,14
82,10,0,10,274,24,26
81,9,0,9,273,34,22
81,11,0,11,273,42,18
83,9,0,9,274,34,25
78,7,0,7,275,14,20
79,9,0,9,272,8,10
79,5,0,5,274,5,9
81,5,0,5,278,3,10
79,8,2,6,279,2,10
84,17,7,10,268,2,14
86,34,17,17,262,3,14
87,33,14,19,261,5,13
87,31,11,20,264,5,16
86,38,15,23,267,8,20
85,37,11,26,277,10,22
78,36,8,28,289,15,23
76,28,4,24,290,18,23
76,24,3,21,289,15,15
82,27,3,24,272,12,9
80,12,0,12,266,17,1
77,23,0,23,264,4,5
76,27,1,26,264,3,12
79,37,2,35,266,2,15
80,37,2,35,267,1,18
81,32,2,30,267,1,21
83,26,2,24,266,2,20
85,20,1,19,265,2,13
86,20,2,18,263,1,16
86,17,1,16,259,1,13
88,17,1,16,254,3,13
88,18,2,16,252,1,9
88,20,4,16,253,1,9
88,22,7,15,255,3,17
81,23,8,15,259,7,17
75,11,1,10,267,11,25
66,11,1,10,284,18,24
59,9,0,9,297,35,28
61,11,0,11,302,50,25
56,21,1,20,303,55,18
51,12,0,12,308,66,21
51,10,0,10,306,68,26
52,10,0,10,300,68,16
57,10,0,10,292,56,13
60,13,0,13,288,47,22
64,15,0,15,285,39,16
67,18,0,18,281,28,20
68,11,0,11,279,29,21
75,11,0,11,267,30,21
74,8,0,8,262,36,24
75,6,0,6,261,38,14
76,6,0,6,259,35,15
74,7,0,7,257,31,22
79,8,0,8,236,38,16
80,3,0,3,226,40,7
82,2,0,2,221,40,18
81,2,0,2,222,38,30
77,4,0,4,225,36,29
73,4,0,4,232,35,8
64,4,0,4,256,37,25
53,4,0,4,277,40,31
49,4,0,4,288,44,23
47,3,0,3,295,47,17
43,4,0,4,303,47,14
42,4,0,4,315,48,20
43,4,0,4,308,56,21
46,9,0,9,306,68,14
49,10,0,10,298,70,14
57,9,0,9,289,62,20
60,11,0,11,277,48,21
62,9,0,9,268,48,11
67,8,0,8,266,52,16
65,10,0,10,267,48,16
61,9,0,9,262,37,22
64,5,0,5,254,35,16
74,3,0,3,240,41,10
76,16.3597946,3.134496873,13.22529772,237,41,10
72,16.3597946,3.134496873,13.22529772,235,37,13
79,5,0,5,232,34,13
79,5,0,5,230,33,12
80,9,0,9,230,33,7
76,9,0,9,235,27,23
69,13,1,12,244,24,12
61,10,1,9,261,27,27
56,7,0,7,267,25.21008837,20
51,7,0,7,278,34,12.35165487
54,5,0,5,281,35,12.35165487
53,16.35720445,3.133617917,13.22358653,283,41,20
50,16.35720445,3.133617917,13.22358653,292,40,14
47,16.35720445,3.133617917,13.22358653,294,41,9
50,7,0,7,284,45,12
52,7,0,7,280,41,13
55,9,0,9,274,43,8
60,8,0,8,268,38,1
66,7,0,7,260,37,5
69,9,0,9,254,33,9
72,4,0,4,251,34,6
75,3,0,3,249,34,10
78,4,0,4,245,33,5
79,4,0,4,245,31,5
78,3,0,3,242,29,16
79,4,0,4,238,25,6
79,5,0,5,235,24,8
77,6,0,6,235,23,0
75,7,0,7,237,22,15
75,8,0,8,241,15,5
70,8,1,7,252,14,17
66,9,1,8,268,23,18
64,6,0,6,274,25,26
57,8,0,8,286,31,19
55,7,0,7,290,40,20
50,6,0,6,299,48,11
51,6,0,6,299,55,14
57,6,0,6,296,51,17
55,7,0,7,295,45,16
46,8,0,8,293,42,11
52,17,0,17,290,43,20
62,21,0,21,280,55,21
59,18,0,18,275,43,19
68,11,0,11,269,48,12
71,9,0,9,262,52,19
69,7,0,7,255,49,19
76,8,0,8,252,47,14
87,9,0,9,248,38,23
90,10,0,10,248,29,17
88,6,0,6,246,25,17
84,4,0,4,251,13,6
82,5,0,5,251,9,0
82,7,0,7,257,4,13
78,14,5,9,265,3,1
72,17,9,8,277,4,14
67,18,9,9,287,4,10
62,15,8,7,295,4,9
70,15,7,8,285,5,13
73,15,5,10,275,8,8
75,17,7,10,275,8,0
74,14,6,8,276,6,0
71,21,9,12,278,6,7
70,17,5,12,281,8,8
69,14,3,11,282,8,13
73,11,1,10,279,7,13
78,17,0,17,265,11,19
79,19,0,19,261,14,19
79,19,0,19,260,12,19
72,19,1,18,263,7,20
66,10,0,10,270,9,13
67,7,0,7,279,9,11
66,6,0,6,280,10,14
66,6,0,6,283,12,12
70,4,0,4,273,10,9
76,13,0,13,263,2,15
80,21,1,20,257,3,17
82,25,4,21,253,3,14
81,24,5,19,254,6,26
75,17,3,14,266,15,35
64,15,2,13,287,25,41
59,16,2,14,304,28,24
54,20,2,18,318,34,11
50,26,4,22,331,31,20
47,17,1,16,340,41,33
45,17,3,14,340,38,30
44,20,5,15,343,22,13
54,17,4,13,324,19,12
59,15,3,12,310,11,2
64,17,2,15,296,11,6
67,15,1,14,289,3,14
69,13,1,12,288,2,15
70,14,1,13,285,2,15
68,16,1,15,285,2,17
69,13,0,13,282,3,19
67,15,1,14,284,5,15
65,15,1,14,286,8,16
66,12,0,12,283,7,18
66,11,0,11,281,7,16
67,12,0,12,278,5,13
76,18,3,15,273,2,14
77,24,10,14,272,1,17
80,30,13,17,272,1,19
81,31,15,16,267,2,20
86,17,5,12,260,2,12
88,21,9,12,251,2,5
87,16,6,10,249,6,3
87,11,4,7,254,4,3
83,14,6,8,257,5,5
79,10,4,6,267,5,10
76,13,4,9,275,5,10
67,16,4,12,280,6,15
72,19,4,15,275,6,10
74,13,2,11,273,5,10
72,18,1,17,272,1,10
70,25,4,21,272,3,8
71,18,1,17,271,8,5
72,9,0,9,270,8,9
73,12,0,12,268,7,11
74,15,1,14,267,5,11
80,13,0,13,264,2,7
82,14,1,13,261,1,15
84,22,6,16,259,1,16
86,22,8,14,258,1,14
88,29,14,15,255,1,12
88,27,14,13,255,1,10
86,27,14,13,256,3,17
84,26,12,14,264,4,15
78,20,6,14,273,7,26
73,17,3,14,280,14,26
66,14,2,12,291,22,19
59,12,1,11,304,30,11
61,10,0,10,303,43,17
57,13,0,13,309,58,13
53,11,0,11,312,49,22
55,8,0,8,302,39,17
56,13,0,13,297,37,10
59,14,0,14,289,35,8
60,22,1,21,286,27,11
60,18,0,18,285,25,10
65,15,0,15,280,24,14
73,15,0,15,274,23,15
73,14,0,14,272,23,16
81,9,0,9,265,15,20
83,7,0,7,261,13,15
84,5,0,5,258,18,12
84,3,0,3,259,27,18
84,3,0,3,257,28,21
84,3,0,3,258,28,24
83,3,0,3,258,27,22
79,4,0,4,257,19,19
71,5,0,5,265,22,15
60,5,0,5,279,28,25
51,4,0,4,297,34,27
43,4,0,4,310,36,15
42,4,0,4,309,43,10
44,4,0,4,314,46,15
44,4,0,4,317,50,21
43,4,0,4,316,54,19
42,3,0,3,313,52,14
43,4,0,4,306,50,9
43,5,0,5,296,53,20
50,8,0,8,289,48,15
57,9,0,9,283,41,16
59,6,0,6,275,38,15
60,6,0,6,267,38,11
66,5,0,5,264,37,10
73,4,0,4,261,37,16
75,4,0,4,261,36,17
79,16.33588779,3.12759406,13.20829373,256,30,18
81,16.33588779,3.12759406,13.20829373,253,27,21
82,6,0,6,249,23,19
83,7,0,7,248,22,20
83,8,0,8,247,16,28
84,10,1,9,249,12,24
79,13,2,11,264,16,38
71,9,1,8,276,27,43
64,16.33438653,3.127101629,13.2072849,288,33,32
61,15,1,14,302,25.19233693,27
53,19,1,18,314,56,32
48,15,0,15,323,74,35
50,9,0,9,322,42,30
53,8,1,7,323,23,16
57,10,2,8,314,16,6
61,19,4,15,303,13,5
63,18,3,15,299,9,8
68,19,2,17,291,7,8
74,20,4,16,287,4,7
75,17,4,13,284,2,10
77,7,0,7,272,11,10
78,4,0,4,267,25,15
78,5,0,5,265,25,14
78,5,0,5,262,25,18
77,5,0,5,259,27,17
79,5,0,5,254,28,14
79,4,0,4,254,30,6
80,4,0,4,253,28,4
80,5,0,5,254,26,12
80,4,0,4,256,24,8
78,7,0,7,264,22,18
78,7,0,7,263,20,20
78,7,0,7,266,22,21
79,5,0,5,261,24,23
70,7,1,6,272,28,13
67,5,0,5,279,32,17
63,6,0,6,288,34,23
65,7,0,7,281,38,26
64,10,0,10,281,35,17
66,8,0,8,276,34,15
72,8,0,8,266,38,10
80,4,0,4,254,35,8
78,4,0,4,244,38,0
78,4,0,4,239,38,8
79,4,0,4,237,38,0
77,4,0,4,236,38,17
76,3,0,3,236,36,2
77,4,0,4,236,34,7
77,4,0,4,233,28,4
78,5,0,5,231,18,1
77,7,0,7,230,17,13
77,9,0,9,228,18,2
78,8,0,8,230,20,13
75,7,0,7,234,21,4
73,7,0,7,237,23,17
72,7,0,7,237,21,7
75,6,0,6,236,26,8
74,9,1,8,239,26,9
70,6,0,6,249,29,8
67,5,0,5,256,34,12
68,4,0,4,257,36,14
70,4,0,4,251,37,9
64,3,0,3,251,38,0
65,4,0,4,248,39,0
67,5,0,5,247,39,5
69,7,0,7,246,41,4
70,6,0,6,245,40,11
69,5,0,5,244,41,7
71,6,0,6,243,41,14
74,6,0,6,243,40,10
74,5,0,5,242,37,13
74,5,0,5,241,34,13
75,4,0,4,238,30,9
75,4,0,4,237,30,9
75,5,0,5,236,28,7
74,6,0,6,235,27,13
74,7,0,7,236,25,11
74,9,1,8,240,23,12
73,6,0,6,245,28,23
71,6,0,6,251,26,9
64,6,0,6,262,27,13
62,5,0,5,271,33,16
60,5,0,5,277,41,28
56,5,0,5,289,40,14
53,4,0,4,298,44,16
54,5,0,5,295,47,20
56,7,0,7,294,46,20
59,7,0,7,291,40,18
61,7,0,7,287,41,17
67,9,0,9,278,36,16
70,18,0,18,274,26,15
69,15,1,14,272,21,19
72,9,0,9,269,21,13
75,8,0,8,265,18,16
77,9,0,9,261,17,10
80,9,0,9,259,12,10
81,9,0,9,257,9,16
82,9,0,9,253,7,14
83,11,0,11,251,3,11
83,13,1,12,250,3,13
84,21,7,14,247,2,13
83,25,10,15,254,3,12
74,19,4,15,264,13,29
65,14,1,13,286,30,36
58,16,1,15,298,34,20
55,17,2,15,310,30,16
50,13,1,12,317,32,18
45,8,0,8,328,15,16
44,8,1,7,332,17,16
47,8,1,7,332,25,9
49,10,0,10,326,30,8
52,9,1,8,315,20,4
54,12,1,11,305,13,0
65,19,2,17,297,8,2
67,17,5,12,290,3,4
66,14,4,10,285,2,3
69,9,1,8,282,3,5
73,11,2,9,279,6,3
76,13,3,10,276,3,1
77,16,6,10,274,2,4
79,19,10,9,273,2,4
81,16,9,7,269,2,3
83,18,12,6,264,2,6
84,25,19,6,263,1,5
84,28,22,6,261,2,4
81,29,20,9,270,2,9
74,15,7,8,278,5,24
56,14,7,7,302,7,50
46,14,5,9,316,12,18
44,10,2,8,324,20,10
45,9,1,8,326,24,11
43,6,0,6,338,28,12
47,4,0,4,330,34,9
53,5,1,4,324,22,0
51,7,1,6,321,15,3
61,11,2,9,310,15,6
59,9,1,8,304,14,4
65,7,1,6,297,12,12
67,6,0,6,294,8,7
71,5,0,5,288,7,8
74,5,0,5,284,6,7
76,5,0,5,283,5,4
77,8,1,7,281,6,3
79,8,1,7,279,7,2
81,6,0,6,277,7,2
81,7,0,7,275,6,4
83,7,1,6,272,6,6
84,7,1,6,269,5,4
84,9,2,7,270,5,4
81,10,4,6,277,5,9
72,6,2,4,289,7,23
60,4,1,3,306,8,8
61,3,0,3,305,11,8
59,3,0,3,318,11,4
59,4,1,3,320,11,9
59,4,1,3,324,9,4
52,2,0,2,334,9,13
53,2,0,2,330,9,9
55,4,1,3,325,9,6
58,5,1,4,315,8,0
64,7,1,6,308,9,7
67,3,0,3,302,8,14
74,2,0,2,297,8,14
76,2,0,2,293,9,8
76,2,0,2,292,9,10
79,1,0,1,287,9,10
83,1,0,1,280,8,8
89,1,0,1,271,8,9
91,16.29274886,3.117839424,13.17490944,267,9,0
91,16.29274886,3.117839424,13.17490944,259,12,2
92,1,0,1,255,17,0
92,1,0,1,254,16,5
91,2,0,2,255,14,0
89,2,0,2,253,12,1
81,4,0,4,260,11,5
68,6,1,5,276,9,7
58,8,2,6,304,25.16690238,14
48,10,3,7,332,9,14
44,16.28955397,3.117211246,13.17234273,344,15,18
44,4,0,4,347,17,20
43,5,0,5,359,21,18
40,4,0,4,362,24,6
58,16,1,15,329,29,0
62,18,2,16,317,29,0
66,16,1,15,306,27,2
74,19,0,19,295,15,17
76,20,0,20,292,10,18
78,20,1,19,289,6,18
77,20,0,20,289,2,20
76,24,1,23,290,1,22
79,23,1,22,287,1,24
79,21,2,19,285,2,23
82,23,3,20,280,2,20
84,20,2,18,275,2,15
86,14,1,13,274,2,15
86,11,1,10,272,2,19
80,18,4,14,267,2,18
71,23,11,12,272,3,12
65,16,7,9,283,5,16
58,11,3,8,302,9,25
53,8,1,7,319,19,16
49,7,0,7,335,33,23
48,5,0,5,344,47,27
45,4,0,4,353,51,25
41,5,0,5,361,54,0
44,5,0,5,360,66,0
41,6,0,6,353,69,0
54,7,0,7,338,84,12
55,11,1,10,327,77,22
60,22,1,21,316,45,14
59,22,0,22,311,36,24
67,19,0,19,309,18,26
84,11,0,11,263,26,16
86,6,0,6,265,27,0
87,6,0,6,261,23,4
87,8,0,8,255,20,3
87,8,0,8,251,16,10
87,8,0,8,251,15,5
87,9,0,9,250,12,10
87,11,0,11,250,9,8
87,14,1,13,253,6,14
85,14,2,12,256,6,7
83,16,3,13,262,10,17
81,15,3,12,270,12,16
74,13,2,11,285,16,33
69,9,0,9,300,34,34
63,15,0,15,313,51,36
58,16,0,16,317,74,40
58,13,0,13,321,86,46
61,9,0,9,321,69,46
66,10,0,10,309,65,36
70,12,0,12,298,53,27
82,10,0,10,285,26,18
85,20,1,19,285,4,6
84,24,3,21,284,4,14
85,20,2,18,279,17,24
87,11,0,11,272,18,25
86,10,0,10,259,12,18
91,5,0,5,256,31,4
91,5,0,5,254,29,0
88,6,0,6,252,22,14
80,6,0,6,246,23,7
86,6,0,6,244,21,2
87,10,0,10,244,12,10
86,13,0,13,244,11,3
78,5,0,5,245,15,15
71,5,0,5,250,23,6
56,4,0,4,266,29,9
50,3,0,3,273,33,16
48,3,0,3,280,34,15
47,3,0,3,284,35,10
45,3,0,3,284,37,4
48,3,0,3,280,39,3
47,4,0,4,276,42,6
49,5,0,5,270,43,4
48,5,0,5,260,43,2
50,6,0,6,251,37,0
47,7,0,7,244,33,0
50,8,0,8,242,32,0
50,11,0,11,241,29,4
54,10,0,10,237,26,6
57,7,0,7,233,28,2
56,5,0,5,232,29,13
57,7,0,7,230,26,1
57,10,0,10,231,23,9
60,8,0,8,229,25,8
60,6,0,6,228,27,2
63,6,0,6,227,25,7
66,9,0,9,223,21,0
65,7,0,7,221,25,11
59,8,0,8,225,28,1
59,9,0,9,226,22,14
57,6,0,6,229,26,4
56,5,0,5,230,25,13
58,6,0,6,230,24,6
60,5,0,5,232,25,3
59,6,0,6,233,26,10
56,5,0,5,246,26,6
54,4,0,4,241,29,9
52,4,0,4,238,29,4
50,5,0,5,231,27,0
51,7,0,7,227,28,7
54,6,0,6,225,27,0
55,7,0,7,224,27,8
56,5,0,5,222,27,5
58,4,0,4,218,27,0
62,5,0,5,212,24,9
73,8,0,8,205,15,0
74,9,0,9,202,12,10
73,9,0,9,201,10,5
71,7,0,7,203,13,4
70,8,0,8,204,15,11
73,5,0,5,205,12,10
74,6,0,6,203,9,6
82,15,3,12,198,10,5
88,17,4,13,195,12,7
83,10,2,8,199,16,5
76,10,2,8,209,22,6
73,8,1,7,220,24,19
68,7,1,6,237,30,20
66,6,0,6,243,37,10
64,4,0,4,250,38,14
65,4,0,4,253,38,16
65,4,0,4,253,37,17
69,6,0,6,249,36,9
70,9,0,9,244,28,7
72,11,0,11,241,24,9
73,11,0,11,240,20,13
74,11,0,11,238,15,13
75,10,0,10,233,14,13
74,8,0,8,228,15,5
76,9,0,9,223,14,13
77,6,0,6,219,12,3
79,6,0,6,215,11,10
82,7,0,7,212,9,22
83,8,0,8,210,7,21
82,12,1,11,207,9,11
80,14,3,11,212,9,15
71,5,0,5,230,11,24
52,4,0,4,255,23,13
43,3,0,3,271,29,9
43,2,0,2,282,32,22
41,2,0,2,295,32,9
44,2,0,2,301,31,5
46,2,0,2,302,30,4
47,2,0,2,303,29,6
48,2,0,2,297,27,0
53,2,0,2,286,27,6
59,3,0,3,274,27,5
59,3,0,3,264,27,0
63,3,0,3,260,28,0
67,3,0,3,255,28,1
74,3,0,3,253,26,4
77,2,0,2,251,25,5
87,2,0,2,239,21,7
89,3,0,3,234,19,0
90,16.2512384,3.103639439,13.14759896,231,21,1
90,16.2512384,3.103639439,13.14759896,226,20,1
90,3,0,3,223,18,0
91,3,0,3,220,18,7
92,3,0,3,220,20,0
92,5,0,5,219,19,8
92,7,0,7,221,15,6
93,9,1,8,224,12,0
92,7,1,6,225,10,13
93,7,1,6,229,13,0
92,6,1,5,231,17,9
91,8,1,7,234,17,1
91,5,1,4,238,16,8
89,5,0,5,243,16,8
87,5,0,5,247,17,2
83,5,0,5,253,18,9
83,8,0,8,252,18,9
85,13,1,12,250,17,8
86,20,3,17,248,10,8
88,21,5,16,246,5,6
90,13,1,12,243,3,8
90,12,1,11,241,3,5
89,14,1,13,240,4,8
89,12,0,12,239,4,10
89,10,0,10,238,5,4
89,9,0,9,237,4,15
89,9,0,9,233,4,9
90,16,2,14,231,3,9
90,16,3,13,230,3,19
88,17,5,12,238,5,4
83,10,3,7,245,9,18
65,5,1,4,271,25.15132396,20
60,16.24449801,3.101625626,13.14287238,285,18,21
54,4,0,4,293,22,12
52,3,0,3,299,27,3
49,3,0,3,300,29,7
50,4,0,4,304,28,7
44,3,0,3,301,29,6
49,3,0,3,289,31,11
58,4,0,4,273,29,8
61,4,0,4,260,30,6
66,4,0,4,250,30,0
74,4,0,4,244,29,0
77,3,0,3,241,27,5
78,3,0,3,239,25,2
75,3,0,3,238,26,10
75,2,0,2,237,29,2
76,2,0,2,234,29,13
76,3,0,3,230,29,1
78,2,0,2,227,27,5
77,3,0,3,222,26,5
76,4,0,4,218,26,3
75,7,0,7,217,23,13
70,8,0,8,223,22,5
65,6,0,6,229,24,30
62,5,0,5,239,25,9
62,4,0,4,244,27,9
62,4,0,4,245,29,12
80,6,0,6,227,29,4
77,6,0,6,225,29,0
76,6,0,6,222,31,15
80,6,0,6,220,30,0
85,6,0,6,215,29,14
87,6,0,6,211,28,0
87,8,0,8,200,30,7
87,9,0,9,198,30,0
87,8,0,8,196,27,6
87,6,0,6,193,29,6
88,7,0,7,191,32,0
88,7,0,7,192,28,5
88,7,0,7,195,23,6
88,10,0,10,195,16,7
88,11,0,11,194,11,10
88,11,0,11,192,10,6
87,14,0,14,191,6,5
87,16,0,16,190,3,8
83,18,1,17,190,4,8
79,15,2,13,199,6,12
67,8,1,7,216,14,25
61,8,1,7,224,19,8
51,7,1,6,237,21,8
46,4,0,4,251,25,9
45,3,0,3,256,29,19
47,4,0,4,263,32,10
46,3,0,3,261,35,12
49,4,0,4,269,35,8
50,4,0,4,261,38,5
54,5,0,5,249,36,3
56,9,1,8,236,35,0
60,13,0,13,229,28,0
60,15,0,15,222,27,13
63,15,0,15,215,24,0
66,15,0,15,210,26,9
67,9,0,9,207,25,11
64,5,0,5,209,31,5
65,4,0,4,206,32,6
68,5,0,5,206,29,0
65,6,0,6,204,27,10
65,7,0,7,203,26,0
61,8,0,8,198,21,11
60,12,0,12,196,18,0
66,13,2,11,202,12,13
59,10,2,8,213,13,10
53,8,1,7,229,17,13
51,7,1,6,242,21,20
48,4,0,4,248,26,19
48,4,0,4,253,33,15
42,4,0,4,265,39,7
44,5,0,5,260,47,11
41,4,0,4,267,49,10
42,4,0,4,268,48,6
43,4,0,4,260,47,12
54,8,0,8,248,42,9
56,12,1,11,238,36,0
56,7,0,7,233,34,0
50,9,0,9,228,34,14
50,7,0,7,225,32,0
53,8,0,8,223,32,12
57,12,0,12,218,28,7
58,9,0,9,217,24,6
57,8,0,8,216,26,11
65,9,0,9,213,22,0
67,10,0,10,211,20,11
67,7,0,7,210,24,10
68,7,0,7,209,22,13
65,9,0,9,211,23,7
64,9,1,8,215,21,19
64,8,1,7,219,23,5
63,8,1,7,225,23,16
56,4,0,4,241,26,6
57,4,0,4,240,32,19
57,4,0,4,241,34,10
57,3,0,3,238,36,7
58,4,0,4,236,36,6
59,4,0,4,235,35,2
63,5,0,5,230,34,8
63,5,0,5,224,36,2
65,8,1,7,222,36,3
66,5,0,5,220,36,12
67,5,0,5,219,36,5
67,5,0,5,218,34,16
67,5,0,5,217,33,0
68,5,0,5,213,31,12
71,6,0,6,208,29,0
74,7,0,7,202,23,7
75,7,0,7,199,20,7
77,6,0,6,195,19,5
77,8,0,8,193,18,9
77,13,0,13,190,17,8
76,10,1,9,194,14,10
67,4,0,4,210,19,19
56,3,0,3,226,25,30
53,3,0,3,247,30,5
50,2,0,2,261,31,23
50,2,0,2,264,33,20
50,2,0,2,273,34,8
53,2,0,2,274,35,5
56,2,0,2,266,35,6
64,2,0,2,248,34,0
69,2,0,2,241,33,0
74,2,0,2,233,33,0
77,3,0,3,229,33,5
79,2,0,2,226,34,2
87,2,0,2,220,32,10
89,3,0,3,217,29,0
90,3,0,3,215,26,10
91,4,0,4,213,23,0
92,4,0,4,212,22,3
91,16.19994543,3.0885119,13.11143353,212,21,2
91,16.19994543,3.0885119,13.11143353,212,20,0
91,3,0,3,212,20,5
91,4,0,4,210,18,10
92,5,0,5,210,15,0
92,7,0,7,213,12,11
92,8,1,7,223,8,6
87,13,4,9,263,8,13
79,6,2,4,280,7,20
71,5,2,3,292,6,20
71,5,2,3,292,8,20
69,4,1,3,298,9,13
68,4,1,3,299,12,18
63,4,1,3,303,15,15
65,5,1,4,294,17,15
71,5,1,4,283,21,10
73,3,0,3,277,23,6
71,4,0,4,278,21,10
69,8,0,8,279,23,14
71,7,0,7,276,23,14
65,8,0,8,280,27,15
61,9,0,9,279,29,10
59,8,0,8,277,30,9
62,6,0,6,272,28,8
66,9,0,9,266,24,13
67,10,0,10,262,19,10
60,10,0,10,254,13,8
60,9,0,9,247,16,0
59,11,0,11,243,13,1
58,22,4,18,247,10,2
52,15,3,12,259,12,17
49,11,2,9,270,17,11
50,8,1,7,278,25.15307986,3
54,16.19122162,3.086226265,13.10499535,284,30,8
52,7,0,7,297,35,8
55,6,0,6,299,47,10
48,7,0,7,294,42,9
55,12,0,12,282,40,9
67,14,0,14,270,27,0
70,17,1,16,260,20,1
68,13,0,13,250,18,4
69,10,0,10,244,20,0
73,9,1,8,240,22,4
75,7,0,7,238,23,0
75,6,0,6,237,22,3
75,6,0,6,236,21,0
76,7,0,7,235,20,14
73,8,0,8,233,18,0
78,6,0,6,230,16,10
79,6,0,6,230,9,2
80,8,0,8,229,6,3
78,10,0,10,228,3,11
70,10,0,10,226,9,0
71,11,1,10,224,11,6
68,8,1,7,231,15,5
61,6,1,5,248,19,10
58,6,1,5,248,22,11
53,4,0,4,258,24,6
49,4,0,4,265,30,15
46,3,0,3,274,38,17
40,3,0,3,278,42,2
39,4,0,4,287,44,3
39,4,0,4,284,43,4
45,5,0,5,273,40,6
48,8,0,8,262,36,6
51,9,0,9,252,31,0
54,9,0,9,245,25,0
53,11,0,11,241,21,1
55,18,1,17,240,21,8
59,9,0,9,230,24,8
64,6,0,6,223,33,7
67,5,0,5,218,35,3
69,5,0,5,217,35,4
71,4,0,4,216,35,11
73,4,0,4,215,34,0
75,5,0,5,207,24,16
73,11,0,11,200,11,0
67,12,1,11,201,9,12
65,10,1,9,210,12,12
57,8,1,7,229,20,11
53,5,0,5,243,25,25
51,4,0,4,250,30,12
50,3,0,3,253,35,19
49,4,0,4,255,38,13
49,4,0,4,263,40,11
48,5,0,5,265,41,18
50,5,0,5,263,41,7
53,11,1,10,250,40,9
57,10,0,10,236,39,0
60,12,1,11,224,32,0
63,11,0,11,218,29,13
63,11,0,11,214,29,0
64,11,0,11,213,26,9
65,10,0,10,211,23,5
68,11,0,11,205,23,12
69,8,0,8,203,25,8
74,7,0,7,200,20,9
75,7,0,7,197,16,0
74,9,0,9,194,11,12
75,11,0,11,191,9,11
74,13,0,13,190,9,6
72,18,3,15,198,13,8
66,16,2,14,212,18,25
59,11,1,10,239,25,29
54,10,1,9,255,32,20
51,7,0,7,263,38,22
50,6,0,6,271,50,16
47,6,0,6,276,58,10
42,6,0,6,278,66,15
46,11,0,11,276,69,21
49,14,0,14,271,69,20
54,12,0,12,263,59,19
57,9,0,9,254,48,13
61,8,0,8,245,42,10
63,9,0,9,239,41,11
64,13,0,13,237,33,11
65,11,0,11,236,29,9
66,13,0,13,233,33,19
67,13,0,13,231,34,5
68,13,0,13,230,29,9
69,17,0,17,227,20,13
70,16,0,16,226,16,7
72,19,0,19,224,15,22
74,22,1,21,221,11,5
75,25,2,23,223,4,14
74,37,9,28,229,6,11
69,30,5,25,240,11,23
58,16,2,14,251,24,17
49,15,2,13,270,29,12
46,11,1,10,274,32,24
48,8,1,7,276,35,15
44,6,0,6,283,38,5
48,8,0,8,279,41,5
48,8,0,8,274,35,6
50,7,0,7,270,31,0
53,9,0,9,264,29,2
56,9,0,9,259,30,1
59,13,0,13,255,25,1
63,16,0,16,252,24,5
64,10,0,10,249,24,15
62,5,0,5,250,25,5
65,8,0,8,248,24,7
64,11,0,11,248,23,14
65,11,0,11,247,22,6
66,12,0,12,247,25,11
66,9,0,9,246,29,3
68,10,0,10,246,28,7
70,7,0,7,245,25,7
67,9,0,9,238,15,13
66,10,0,10,237,10,10
65,11,1,10,241,13,23
66,11,1,10,241,16,23
66,13,1,12,249,21,32
66,16,2,14,256,20,28
63,12,1,11,265,24,25
64,13,2,11,269,30,21
64,8,1,7,270,29,15
66,9,1,8,268,28,9
63,9,1,8,270,24,10
64,10,1,9,265,24,5
68,10,0,10,262,20,0
73,10,0,10,259,17,0
76,15,0,15,256,10,5
75,9,0,9,254,13,8
77,9,0,9,253,13,4
78,10,0,10,251,11,8
80,11,0,11,249,8,10
80,12,0,12,249,6,7
80,16.16385943,3.07449491,13.08936452,248,3,16
81,16.16385943,3.07449491,13.08936452,245,3,7
82,16,1,15,240,3,2
83,15,1,14,237,2,9
81,9,0,9,238,6,15
79,8,1,7,241,10,8
72,8,1,7,250,12,16
63,7,1,6,268,17,25
54,6,1,5,284,21,28
43,4,0,4,287,25,12
42,4,0,4,290,29,9
34,3,0,3,293,30,8
35,3,0,3,291,31,8
32,4,0,4,298,32,10
36,4,0,4,289,34,7
42,6,0,6,274,34,12
48,9,0,9,258,29,5
54,11,1,10,248,25,0
56,10,0,10,241,25,4
59,8,0,8,236,27,18
62,9,0,9,233,27,9
64,7,0,7,233,26,21
65,7,0,7,231,31,10
65,7,0,7,230,30,10
64,6,0,6,227,30,14
66,8,0,8,223,24,6
64,11,0,11,221,16,20
64,13,0,13,220,12,8
67,21,1,20,219,10,20
67,34,10,24,221,5,11
59,25,6,19,233,10,27
53,16.15780493,3.072371039,13.08543389,255,20,29
42,9,1,8,278,26,12.31167003
42,5,0,5,283,25.15377351,16
40,5,0,5,289,45,17
39,5,0,5,294,48,16
40,4,0,4,296,47,7
36,4,0,4,301,46,14
41,4,0,4,302,45,14
47,7,0,7,286,44,18
52,11,0,11,271,35,22
56,10,1,9,252,29,14
56,7,0,7,243,28,0
62,9,0,9,238,25,2
67,9,0,9,234,22,13
73,9,0,9,230,21,9
76,10,0,10,224,20,8
77,8,0,8,223,16,14
78,12,0,12,218,15,7
81,10,0,10,216,13,22
82,9,0,9,212,14,13
83,8,0,8,210,11,14
86,9,0,9,209,5,8
86,16,3,13,211,5,10
80,19,5,14,221,10,27
71,16,4,12,240,12,25
62,14,2,12,256,24,33
52,12,1,11,267,43,41
47,9,0,9,282,57,36
35,8,0,8,294,63,18
36,6,0,6,300,65,17
37,6,0,6,299,83,21
34,8,0,8,298,82,19
38,15,0,15,284,80,20
57,20,0,20,264,92,25
61,22,0,22,258,73,26
63,13,0,13,253,64,25
60,18,0,18,247,48,19
54,19,0,19,242,39,21
60,17,0,17,237,39,14
65,13,0,13,235,34,18
68,14,0,14,231,31,16
69,16,0,16,229,27,24
72,18,0,18,222,24,12
74,23,1,22,221,11,24
73,19,0,19,219,4,14
74,24,2,22,218,6,21
72,23,3,20,225,8,21
69,19,2,17,237,10,19
60,24,4,20,258,28,23
55,11,1,10,266,37,26
54,10,1,9,263,40,25
48,11,1,10,275,40,18
47,11,1,10,279,43,16
47,9,0,9,281,44,16
45,7,0,7,276,45,16
45,8,0,8,271,46,11
54,11,0,11,264,44,9
57,14,0,14,258,44,10
56,12,0,12,254,47,13
58,14,0,14,252,48,16
60,11,0,11,250,43,21
62,11,0,11,249,45,18
62,11,0,11,248,49,13
60,12,0,12,247,50,16
60,14,0,14,246,50,10
60,11,0,11,246,48,17
59,11,0,11,245,48,16
58,12,0,12,246,48,11
58,11,0,11,247,50,14
62,10,0,10,244,49,13
78,14,0,14,229,45,13
84,10,0,10,226,34,9
87,13,0,13,230,39,19
73,10,1,9,253,35,9
71,9,1,8,259,33,27
66,9,1,8,271,27,12
63,8,1,7,273,29,11
56,6,1,5,281,34,10
53,6,0,6,282,39,13
58,8,0,8,275,42,6
57,9,0,9,271,42,11
51,17,0,17,272,23,5
50,26,1,25,271,13,7
54,29,1,28,264,13,6
56,25,0,25,259,5,9
53,34,1,33,257,3,8
54,33,1,32,254,3,9
49,33,1,32,263,9,9
41,31,1,30,268,23,11
41,11,0,11,269,28,0
44,14,0,14,262,29,0
44,5,0,5,258,27,0
45,5,0,5,254,29,0
47,6,0,6,249,26,1
45,5,0,5,249,28,0
40,4,0,4,257,31,8
37,4,0,4,273,35,5
33,3,0,3,286,37,10
31,3,0,3,291,38,22
30,3,0,3,294,39,19
28,3,0,3,301,40,11
27,3,0,3,306,45,6
29,4,0,4,309,53,9
34,6,0,6,306,55,7
47,6,0,6,281,49,0
50,5,0,5,264,43,6
50,6,0,6,253,43,0
57,5,0,5,249,41,0
59,6,0,6,245,40,4
62,6,0,6,242,38,12
63,9,0,9,237,35,8
63,4,0,4,234,37,8
66,3,0,3,230,39,11
67,3,0,3,229,41,3
70,3,0,3,228,41,12
72,2,0,2,227,38,0
73,2,0,2,227,37,16
72,3,0,3,223,32,0
72,4,0,4,223,29,10
72,4,0,4,222,25,4
72,4,0,4,222,25,15
78,5,0,5,212,29,3
82,5,0,5,206,31,13
80,4,0,4,206,30,0
80,3,0,3,202,32,12
72,3,0,3,206,25,0
65,3,0,3,216,23,9
62,2,0,2,213,26,3
63,2,0,2,207,29,0
65,3,0,3,201,29,1
69,3,0,3,199,29,1
68,3,0,3,200,29,3
67,3,0,3,199,30,4
67,6,1,5,197,30,0
69,4,0,4,194,27,6
68,4,0,4,191,24,3
66,3,0,3,191,25,1
67,16.13085677,3.060272442,13.07058433,189,23,1
69,16.13085677,3.060272442,13.07058433,187,20,1
70,5,0,5,183,16,1
71,6,0,6,180,14,0
73,9,0,9,176,12,2
70,10,1,9,180,11,2
65,8,1,7,189,13,4
62,8,1,7,196,25.1934607,12
59,16.12920924,3.059774092,13.06943515,206,20,8
54,6,1,5,222,22,15
52,6,1,5,232,26,12
50,4,0,4,240,30,12
51,3,0,3,241,34,15
53,3,0,3,239,33,3
55,4,0,4,239,32,4
61,5,0,5,230,33,0
65,6,0,6,224,31,0
76,11,1,10,216,28,8
81,8,0,8,209,27,0
84,6,0,6,205,27,11
88,6,0,6,203,24,0
89,6,0,6,198,21,5
90,5,0,5,196,22,3
90,4,0,4,190,25,2
91,6,0,6,186,26,0
91,5,0,5,189,24,0
90,4,0,4,189,23,0
91,5,0,5,189,19,4
91,10,0,10,189,20,0
90,10,0,10,191,17,2
89,11,1,10,194,15,6
87,14,2,12,200,15,8
86,22,5,17,210,12,13
81,23,5,18,231,13,11
75,15,2,13,249,20,23
62,15,2,13,266,28,18
65,12,1,11,258,28,17
60,14,1,13,262,18,14
68,13,1,12,250,26,8
73,18,1,17,232,12,16
76,20,0,20,223,20,0
77,16,0,16,223,19,4
78,18,0,18,222,15,9
79,19,0,19,222,8,16
79,22,0,22,219,5,9
80,21,0,21,218,6,20
79,21,0,21,219,4,13
60,21,0,21,213,17,18
45,8,0,8,207,27,0
39,5,0,5,208,34,4
41,5,0,5,204,36,0
47,5,0,5,199,32,5
54,6,0,6,185,26,4
46,8,0,8,185,19,0
37,9,1,8,195,22,2
31,6,1,5,214,27,17
31,5,0,5,226,28,6
23,5,0,5,232,28,9
21,5,0,5,241,31,11
22,4,0,4,241,33,4
24,5,0,5,246,38,11
25,5,0,5,250,44,18
24,5,0,5,250,45,12
31,6,0,6,237,47,6
46,7,0,7,216,36,0
47,15,1,14,205,34,0
46,10,0,10,199,29,1
49,11,0,11,198,27,0
52,9,0,9,194,26,10
54,12,0,12,187,27,9
56,13,0,13,182,20,4
61,10,0,10,174,17,6
64,13,0,13,166,13,7
64,19,0,19,159,12,7
65,12,0,12,151,10,9
65,16,0,16,150,5,7
66,21,2,19,151,4,7
61,21,5,16,159,5,7
56,23,8,15,171,9,15
50,20,6,14,199,15,26
47,10,2,8,224,20,26
47,9,1,8,231,26,19
47,5,0,5,239,34,19
46,4,0,4,241,37,9
47,5,0,5,245,40,6
45,4,0,4,246,40,6
47,5,0,5,240,37,12
47,5,0,5,232,35,0
49,7,0,7,227,34,0
55,8,0,8,220,32,8
81,6,0,6,185,36,0
82,6,0,6,175,32,0
89,6,0,6,171,33,1
90,5,0,5,174,34,0
91,5,0,5,174,34,0
91,3,0,3,175,35,0
91,3,0,3,174,38,2
91,3,0,3,172,32,2
90,4,0,4,171,27,5
90,5,0,5,171,27,7
88,7,0,7,174,28,10
87,10,0,10,178,27,13
85,11,0,11,183,22,17
83,12,1,11,190,22,17
81,14,2,12,199,19,11
83,14,2,12,204,17,15
81,14,2,12,212,17,15
84,14,2,12,217,16,20
83,10,1,9,221,19,5
88,12,1,11,221,16,19
89,10,0,10,222,11,0
88,8,0,8,222,13,18
89,9,1,8,215,18,5
90,6,0,6,212,21,0
91,5,0,5,212,23,9
91,4,0,4,212,23,0
92,3,0,3,213,24,10
92,3,0,3,212,24,0
92,2,0,2,213,25,9
92,2,0,2,214,24,0
92,3,0,3,215,21,11
92,3,0,3,216,19,2
93,3,0,3,219,21,8
93,1,0,1,222,23,0
92,2,0,2,223,25,0
92,2,0,2,224,25,7
93,2,0,2,227,23,0
94,3,0,3,233,21,9
93,3,0,3,242,19,0
92,2,0,2,248,18,15
91,1,0,1,252,17,0
91,1,0,1,252,15,13
92,1,0,1,250,15,0
91,0,0,0,253,15,0
88,0,0,0,259,17,10
87,0,0,0,258,19,0
90,1,0,1,253,23,6
87,1,0,1,251,26,7
85,1,0,1,248,26,3
88,1,0,1,237,24,0
89,2,0,2,234,24,6
80,2,0,2,208,28,3
64,1,0,1,227,27,0
55,2,0,2,252,25,7
48,5,0,5,255,20,14
46,2,0,2,257,26,0
46,2,0,2,256,30,3
45,3,0,3,260,31,0
45,2,0,2,258,32,5
45,3,0,3,255,29,0
45,8,1,7,260,25,12
40,3,0,3,270,26,4
37,2,0,2,275,27,3
37,2,0,2,277,25,2
33,2,0,2,280,26,0
35,2,0,2,282,25,2
37,2,0,2,283,27,9
34,2,0,2,283,29,10
36,2,0,2,268,29,6
41,3,0,3,256,28,0
35,6,0,6,238,33,0
40,7,0,7,228,28,0
46,5,0,5,217,28,4
42,4,0,4,211,28,0
40,4,0,4,206,28,14
41,4,0,4,202,28,1
41,4,0,4,198,29,12
44,3,0,3,197,29,1
50,16.08387943,3.04613833,13.0377411,192,27,11
54,16.08387943,3.04613833,13.0377411,186,27,6
58,3,0,3,184,26,9
62,3,0,3,183,26,7
62,3,0,3,182,25,8
66,5,0,5,176,9,7
70,9,1,8,172,15,3
68,9,1,8,175,12,7
65,11,2,9,179,10,12
80,9,1,8,172,12,15
78,9,2,7,178,19,9
78,8,1,7,182,21,18
83,8,0,8,177,15,11
87,7,0,7,173,17,8
87,7,0,7,173,23,5
87,9,0,9,172,22,10
87,7,0,7,170,26,10
89,5,0,5,167,22,9
88,7,0,7,160,18,4
90,7,0,7,162,17,5
91,7,0,7,164,15,8
92,7,0,7,165,15,9
91,6,0,6,166,13,6
91,5,0,5,167,12,10
92,4,0,4,168,21,7
91,6,0,6,170,20,5
90,5,0,5,171,16,2
90,5,0,5,171,17,4
90,8,0,8,171,19,1
88,11,0,11,174,17,0
85,11,1,10,180,13,6
77,8,1,7,186,18,12
72,16.07506115,3.043514474,13.03154668,193,25.18226863,12
55,6,1,5,205,17,12
55,5,0,5,203,24,4
55,5,1,4,208,25,7
51,3,0,3,215,29,9
57,3,0,3,205,31,8
59,5,0,5,196,32,0
62,5,0,5,187,34,0
61,8,1,7,183,34,0
65,7,0,7,180,33,2
62,5,0,5,177,34,4
63,4,0,4,173,36,4
62,6,0,6,170,36,4
59,5,0,5,170,34,2
54,5,0,5,165,29,6
54,5,0,5,163,29,6
57,5,0,5,158,27,4
59,4,0,4,154,24,3
60,5,0,5,150,22,4
63,8,0,8,148,20,6
62,8,0,8,148,17,4
62,9,0,9,147,15,6
59,9,0,9,149,15,6
55,9,1,8,156,18,8
57,7,0,7,162,23,10
52,5,0,5,171,27,10
49,4,0,4,181,29,13
50,3,0,3,185,33,17
51,3,0,3,186,34,16
51,3,0,3,183,35,0
51,4,0,4,180,36,8
53,5,0,5,176,36,3
55,8,0,8,172,33,4
58,12,1,11,168,32,1
59,7,0,7,166,32,6
61,8,0,8,161,35,6
64,9,0,9,158,32,4
64,11,0,11,158,29,4
65,10,0,10,156,28,6
65,7,0,7,158,29,6
66,7,0,7,158,28,8
65,7,0,7,159,27,9
66,7,0,7,158,25,9
68,8,0,8,158,21,10
70,9,0,9,156,14,6
70,12,0,12,157,10,9
69,12,1,11,157,10,9
67,16,3,13,164,11,10
63,13,2,11,173,15,13
60,12,2,10,182,19,18
57,10,1,9,190,21,23
56,9,1,8,193,28,24
55,6,0,6,195,32,0
67,6,0,6,189,35,11
74,8,0,8,181,36,5
82,11,0,11,173,28,9
87,19,1,18,170,22,4
87,12,0,12,171,24,5
85,9,0,9,167,29,8
85,8,0,8,167,30,4
84,12,0,12,168,26,8
86,12,0,12,169,23,8
84,13,0,13,171,20,7
84,12,0,12,170,20,11
86,10,0,10,168,21,9
87,10,0,10,168,21,8
85,7,0,7,168,18,12
83,6,0,6,164,26,11
83,8,0,8,161,26,11
81,9,0,9,161,26,6
77,9,0,9,167,23,8
71,6,0,6,176,26,12
70,6,0,6,178,25,12
67,6,0,6,181,25,12
66,5,0,5,193,26,12
63,3,0,3,195,28,23
63,4,0,4,190,32,4
62,4,0,4,188,32,5
66,4,0,4,181,36,0
71,5,0,5,177,34,5
73,5,0,5,174,33,3
73,6,0,6,174,30,3
74,6,0,6,172,27,5
82,6,0,6,164,25,6
88,9,0,9,159,23,1
90,10,0,10,156,21,2
90,9,0,9,155,19,7
91,6,0,6,152,22,5
92,6,0,6,152,19,3
92,5,0,5,151,21,5
92,5,0,5,153,22,7
93,5,0,5,156,23,2
93,7,0,7,156,22,3
93,8,0,8,160,18,3
93,7,0,7,162,20,5
61.6562851,9,0,9,175.5253905,25.18467499,12.25873167
61.6562851,12,1,11,175.5253905,25.18467499,12.25873167
61.6562851,11,2,9,175.5253905,25.18467499,12.25873167
61.6562851,8,1,7,175.5253905,25.18467499,12.25873167
61.6562851,10,1,9,175.5253905,25.18467499,12.25873167
61.6562851,14,2,12,175.5253905,25.18467499,12.25873167
61.6562851,24,2,22,175.5253905,25.18467499,12.25873167
82,38,4,34,200,25.18467499,9
84,36,2,34,201,25.18467499,47
83,36,1,35,200,4,35
85,35,1,34,199,4,19
85,37,2,35,197,3,14
87,38,5,33,194,1,0
88,50,18,32,191,0,18
89,49,20,29,189,0,13
89,45,17,28,188,0,15
89,43,19,24,188,0,16
89,38,14,24,186,0,10
89,26,3,23,188,1,12
90,25,6,19,187,1,9
90,23,6,17,187,1,9
90,18,1,17,186,1,10
91,19,3,16,186,2,9
89,13,2,11,192,5,7
82,14,2,12,200,8,11
77,8,1,7,208,12,19
74,7,1,6,219,16,6
65,3,0,3,228,21,10
60,3,0,3,229,26,9
59,2,0,2,226,30,1
60,3,0,3,224,33,3
60,3,0,3,216,35,2
61,4,0,4,209,37,3
65,6,0,6,203,36,0
67,10,0,10,199,34,7
67,7,0,7,197,33,4
68,8,0,8,195,33,7
69,8,0,8,194,32,1
70,7,0,7,193,32,8
71,5,0,5,191,31,9
73,5,0,5,188,29,8
73,16.05200934,3.035236798,13.01677254,186,26,7
71,16.05200934,3.035236798,13.01677254,185,27,7
70,5,0,5,183,25,1
66,5,0,5,183,27,7
66,7,0,7,181,26,0
67,9,0,9,180,24,6
69,10,1,9,183,24,4
64,6,0,6,190,25,9
58,16.05026639,3.034684459,13.01558193,195,25.17497097,16
55,5,0,5,202,27,6
52,4,0,4,208,32,11
55,3,0,3,207,33,4
51,4,0,4,203,33,1
55,5,0,5,197,33,0
59,5,0,5,192,34,4
60,5,0,5,186,33,0
60,6,0,6,183,35,6
62,6,0,6,179,38,6
64,5,0,5,178,37,5
72,6,0,6,172,34,9
76,7,0,7,166,31,4
81,8,0,8,162,26,1
85,9,0,9,158,22,9
89,8,0,8,155,24,8
90,5,0,5,155,22,2
91,5,0,5,154,18,7
91,4,0,4,151,22,4
91,3,0,3,150,26,4
92,3,0,3,151,27,6
89,2,0,2,155,35,6
89,2,0,2,152,34,2
88,4,0,4,147,29,1
92,4,0,4,148,34,1
89,4,0,4,149,37,0
86,3,0,3,146,40,4
87,3,0,3,148,41,0
80,3,0,3,160,40,2
79,3,0,3,158,39,11
77,3,0,3,161,38,1
75,3,0,3,160,35,0
74,4,0,4,159,34,2
73,5,0,5,160,36,0
68,4,0,4,165,37,0
67,4,0,4,167,38,3
70,5,0,5,163,36,1
67,3,0,3,165,35,1
62,2,0,2,175,37,0
67,2,0,2,168,35,1
73,4,0,4,156,25,2
75,6,0,6,154,17,0
76,8,0,8,151,13,0
78,12,0,12,147,4,0
80,32,3,29,145,0,3
81,45,16,29,147,1,2
77,65,35,30,160,1,15
66,37,15,22,184,5,32
58,26,8,18,208,10,36
44,21,5,16,224,18,14
44,13,2,11,233,25,11
44,9,1,8,236,30,5
42,7,0,7,238,42,10
44,8,0,8,240,45,6
47,6,0,6,229,41,2
53,6,0,6,215,39,0
59,13,0,13,200,32,0
62,21,1,20,193,28,2
62,20,0,20,192,26,1
64,19,1,18,188,22,4
67,16,0,16,186,20,5
68,18,0,18,184,21,3
70,11,0,11,183,27,7
74,8,0,8,180,26,6
76,7,0,7,179,25,7
76,6,0,6,179,21,4
76,6,0,6,178,25,6
77,8,0,8,176,23,8
77,10,0,10,175,21,4
76,11,0,11,177,25,6
73,8,0,8,181,29,6
69,6,0,6,189,29,9
65,5,0,5,196,32,15
62,4,0,4,202,36,13
58,3,0,3,206,36,3
57,3,0,3,204,39,15
59,3,0,3,204,38,0
59,3,0,3,199,38,12
61,3,0,3,194,39,4
61,3,0,3,187,38,1
65,5,0,5,182,36,1
65,8,1,7,177,35,5
69,4,0,4,176,36,6
70,4,0,4,176,37,6
74,3,0,3,174,37,7
81,3,0,3,170,36,5
84,3,0,3,161,30,4
86,3,0,3,155,31,3
86,3,0,3,152,32,4
86,4,0,4,153,30,5
87,4,0,4,154,30,8
89,5,0,5,153,29,11
90,3,0,3,162,29,7
90,4,0,4,159,33,9
92,4,0,4,152,22,6
92,5,0,5,150,23,3
92,7,0,7,152,26,1
92,5,0,5,155,29,3
92,5,0,5,159,33,1
91,4,0,4,159,36,5
90,3,0,3,163,38,1
91,3,0,3,163,38,4
91,3,0,3,163,37,1
91,6,0,6,153,27,0
90,7,0,7,153,22,0
91,7,0,7,153,27,0
90,7,0,7,156,29,0
87,6,0,6,159,29,2
82,7,0,7,164,28,3
78,7,0,7,168,27,5
79,6,0,6,168,24,4
72,5,0,5,169,18,3
68,5,0,5,172,24,0
69,7,0,7,168,20,2
72,13,0,13,165,17,3
72,13,0,13,160,9,5
71,10,0,10,158,9,0
69,12,1,11,163,11,1
68,12,2,10,174,5,8
66,24,6,18,182,8,28
53,20,6,14,213,12,11
55,17,4,13,226,16,15
53,32,7,25,232,17,20
48,36,9,27,238,21,11
50,21,3,18,238,24,7
50,9,1,8,233,30,1
52,11,0,11,228,25,0
53,16,0,16,220,25,0
59,23,0,23,214,16,2
66,29,2,27,206,10,6
68,31,2,29,203,3,13
69,45,12,33,201,2,4
69,45,12,33,197,2,17
63,42,12,30,193,2,0
65,44,14,30,187,4,9
68,43,14,29,181,3,6
74,30,3,27,178,3,6
74,21,1,20,174,3,8
77,13,0,13,175,6,6
79,11,0,11,171,6,6
77,9,0,9,169,5,4
72,11,1,10,167,4,6
67,12,2,10,171,9,10
62,11,2,9,179,14,9
62,8,1,7,182,16,14
61,9,1,8,191,16,12
58,7,1,6,205,18,16
57,8,1,7,213,25,31
56,8,1,7,220,33,12
61,7,0,7,220,31,22
65,6,0,6,208,30,1
68,5,0,5,198,33,0
68,9,1,8,189,33,10
73,9,1,8,183,32,3
71,5,0,5,182,33,2
76,6,0,6,180,33,5
73,5,0,5,177,32,10
72,5,0,5,176,31,6
76,5,0,5,173,27,5
76,8,0,8,168,24,4
79,16.02082951,3.02601568,12.99481383,165,22,0
79,16.02082951,3.02601568,12.99481383,162,20,2
80,8,0,8,160,15,3
62,6,0,6,154,18,5
64,6,0,6,153,21,4
76,12,1,11,153,5,6
63,10,1,9,160,10,6
53,16.01961322,3.025596564,12.99401665,170,16,14
48,7,1,6,183,23,25
44,4,0,4,195,25.17483068,19
41,3,0,3,202,31,4
42,3,0,3,206,34,9
43,4,0,4,210,36,9
43,4,0,4,209,37,2
48,7,0,7,198,36,3
51,11,0,11,187,33,0
55,13,1,12,176,32,0
57,14,1,13,170,30,1
59,13,0,13,166,31,4
62,12,0,12,161,30,3
64,10,0,10,158,28,3
67,8,0,8,155,29,3
70,9,0,9,151,28,1
68,8,0,8,153,24,6
68,8,0,8,152,20,8
69,9,0,9,154,19,7
68,11,0,11,154,16,7
71,12,0,12,153,15,6
70,19,0,19,153,11,6
70,24,1,23,152,10,8
76,26,3,23,153,9,6
82,25,4,21,149,9,9
84,25,5,20,149,13,3
87,20,3,17,151,13,4
88,19,2,17,150,12,8
89,20,2,18,151,12,4
89,19,2,17,153,11,8
89,21,2,19,154,11,6
89,25,2,23,153,7,12
90,26,1,25,153,8,9
90,24,1,23,153,4,9
89,26,1,25,151,5,7
89,25,1,24,150,8,11
89,26,1,25,147,6,10
90,34,6,28,146,3,9
89,33,6,27,145,1,11
89,44,17,27,143,1,11
90,42,18,24,142,1,11
90,38,17,21,140,1,10
90,37,17,20,137,1,11
92,44,23,21,130,1,12
93,28,6,22,129,0,7
93,26,5,21,127,0,8
94,32,11,21,126,0,6
94,40,18,22,131,1,8
94,51,26,25,136,2,14
92,43,19,24,147,4,19
76,33,13,20,170,8,27
63,17,4,13,191,14,43
56,16,3,13,200,22,28
48,18,2,16,212,30,14
44,13,1,12,219,37,23
48,12,0,12,216,40,20
58,17,0,17,202,33,14
63,24,0,24,191,23,0
66,36,3,33,182,19,0
73,24,1,23,176,22,17
77,21,0,21,170,20,16
77,17,0,17,168,25,10
78,21,0,21,167,22,9
81,16,0,16,164,20,10
83,12,0,12,158,17,11
85,13,0,13,153,5,14
86,13,0,13,151,3,18
86,23,2,21,146,2,18
85,21,1,20,145,2,15
83,27,4,23,146,2,17
81,36,12,24,147,2,19
78,34,12,22,153,4,23
72,29,9,20,166,13,26
62,13,2,11,189,19,30
57,10,1,9,201,27,37
53,7,0,7,205,38,21
52,7,0,7,207,43,20
50,7,0,7,213,46,19
49,9,0,9,213,49,23
48,11,0,11,211,46,15
60,14,0,14,203,38,12
62,16,0,16,193,30,5
66,25,2,23,185,22,18
70,23,1,22,178,12,11
72,28,2,26,175,12,19
75,37,5,32,171,5,22
78,41,10,31,166,1,24
80,41,13,28,162,2,24
81,37,15,22,156,1,26
83,44,15,29,150,1,21
82,44,13,31,145,1,23
84,28,3,25,140,1,21
82,21,1,20,138,1,21
82,22,2,20,134,2,21
81,27,7,20,134,2,18
77,25,9,16,142,4,23
72,20,7,13,158,6,34
63,22,7,15,186,9,46
54,18,3,15,202,16,43
47,22,4,18,215,23,29
41,22,3,19,223,36,33
34,20,2,18,231,39,32
32,18,1,17,238,41,28
42,40,2,38,224,37,22
48,45,1,44,213,24,13
54,52,1,51,202,9,3
54,78,16,62,195,2,14
50,59,5,54,188,8,32
47,25,0,25,179,18,4
41,15,0,15,175,33,3
40,8,0,8,168,36,7
41,7,0,7,161,34,6
46,11,0,11,153,30,5
51,8,0,8,144,27,10
55,6,0,6,137,25,9
57,6,0,6,131,19,10
49,11,0,11,131,16,9
51,14,0,14,128,18,8
51,18,2,16,127,13,9
49,15,2,13,141,9,11
41,23,6,17,156,16,23
41,11,2,9,168,25,18
41,9,1,8,178,26,22
39,5,0,5,183,28,19
40,5,0,5,188,31,10
42,4,0,4,193,36,7
44,5,0,5,197,38,10
46,7,0,7,189,37,11
49,11,0,11,173,35,0
55,17,0,17,166,25,0
57,18,0,18,163,20,7
57,15,0,15,163,21,10
56,12,0,12,161,23,9
57,14,0,14,158,24,9
57,15,0,15,158,19,10
59,15,0,15,155,19,11
63,17,0,17,151,12,11
65,12,0,12,147,12,6
66,10,0,10,143,13,8
65,11,0,11,140,11,10
63,10,0,10,136,13,13
66,11,0,11,133,14,14
67,13,1,12,132,12,13
64,13,2,11,143,12,14
59,12,2,10,150,18,25
55,12,2,10,162,21,19
52,10,1,9,179,25,47
53,8,0,8,185,30,38
56,7,0,7,190,34,29
58,8,0,8,188,35,7
62,7,0,7,187,34,15
63,7,0,7,184,35,14
67,8,0,8,181,35,13
67,10,0,10,182,32,19
73,7,0,7,179,35,18
73,5,0,5,171,38,11
71,6,0,6,168,36,6
67,6,0,6,163,35,5
80,5,0,5,144,34,1
86,3,0,3,134,38,0
87,3,0,3,132,38,0
87,16.03440765,3.02495839,13.00944926,132,35,2
84,16.03440765,3.02495839,13.00944926,133,32,5
84,4,0,4,131,29,7
86,6,0,6,130,23,5
87,7,0,7,129,14,7
85,10,1,9,128,20,5
79,10,1,9,137,20,6
66,9,1,8,149,22,20
55,6,1,5,169,25,20
52,4,0,4,177,27,28
47,4,0,4,183,30,28
43,3,0,3,187,34,8
41,3,0,3,191,37,9
33,4,0,4,199,37,8
40,4,0,4,192,35,0
57,5,0,5,170,35,0
60,8,1,7,153,34,0
61,8,0,8,147,32,0
60,10,0,10,143,28,0
62,12,0,12,140,24,4
62,22,1,21,137,20,6
61,25,1,24,134,15,3
59,24,1,23,133,15,8
54,19,1,18,129,17,8
47,12,0,12,123,18,4
53,10,0,10,114,22,0
54,8,0,8,108,18,1
57,10,0,10,101,18,1
56,12,0,12,100,16,2
57,17,1,16,100,7,2
50,13,2,11,114,13,3
44,11,2,9,133,16,21
36,16.02866442,3.022523545,13.00614088,158,19,25
35,9,2,7,168,25.1444902,12.22287517
34,7,1,6,170,24,15
35,7,1,6,175,28,14
34,6,0,6,182,29,5
32,6,0,6,187,31,14
35,8,0,8,181,35,11
38,12,0,12,170,31,1
41,30,3,27,161,22,0
47,33,2,31,157,20,5
50,37,2,35,151,15,5
53,42,4,38,147,8,7
51,57,16,41,146,7,11
57,60,22,38,140,6,14
61,54,19,35,135,2,15
66,41,6,35,125,1,15
70,33,2,31,115,1,12
65,26,1,25,108,2,9
64,24,1,23,104,2,10
63,19,0,19,101,2,10
62,17,0,17,98,3,8
64,24,4,20,96,3,7
61,24,8,16,105,6,5
54,20,7,13,126,7,22
44,21,7,14,161,9,28
37,21,6,15,184,16,33
26,24,6,18,195,25,31
21,17,3,14,201,30,15
18,14,1,13,208,32,16
18,10,0,10,212,35,17
26,24,1,23,202,32,13
25,27,0,27,190,27,2
40,39,0,39,180,14,0
47,58,8,50,172,11,3
52,85,32,53,165,5,4
57,78,28,50,158,1,12
58,92,43,49,152,2,14
58,78,33,45,143,1,17
60,73,31,42,137,1,12
63,53,13,40,130,1,15
65,54,16,38,122,1,17
67,53,18,35,117,1,19
69,29,3,26,113,1,14
69,21,1,20,110,2,12
69,23,2,21,106,2,9
69,29,7,22,104,3,9
62,33,13,20,113,3,14
57,31,12,19,133,6,21
48,36,14,22,167,9,32
43,41,13,28,183,17,41
39,46,12,34,203,18,35
40,29,5,24,211,31,19
45,16,1,15,215,35,4
51,14,1,13,210,38,2
54,14,0,14,207,38,0
44,12,0,12,207,32,7
44,14,0,14,203,37,0
44,13,0,13,191,30,8
48,29,0,29,175,11,15
49,29,0,29,169,13,18
54,26,0,26,160,10,25
54,27,0,27,154,9,22
52,26,0,26,152,15,21
49,19,0,19,151,20,17
49,11,0,11,150,27,9
50,6,0,6,145,30,2
52,7,0,7,137,27,0
60,12,0,12,128,21,1
64,26,3,23,122,7,6
65,33,7,26,121,3,10
58,24,6,18,130,12,10
46,9,1,8,146,26,24
37,7,1,6,174,31,32
37,5,0,5,180,35,34
36,4,0,4,182,38,5
38,4,0,4,183,39,12
41,5,0,5,185,43,10
43,7,0,7,179,38,5
45,9,0,9,168,35,0
49,9,0,9,158,36,1
52,15,1,14,150,32,0
51,18,1,17,148,31,4
52,16,0,16,146,30,4
56,12,0,12,139,31,3
56,10,0,10,138,32,5
56,9,0,9,138,32,6
53,7,0,7,133,27,10
53,6,0,6,124,23,10
56,5,0,5,119,25,2
59,5,0,5,114,20,3
58,8,0,8,113,20,7
57,7,0,7,112,16,8
57,8,0,8,113,18,5
56,10,0,10,114,21,8
55,14,2,12,118,18,9
51,10,1,9,130,19,14
49,8,1,7,143,25,23
43,5,0,5,159,29,15
42,3,0,3,160,34,22
42,4,0,4,166,37,23
42,4,0,4,169,39,5
39,5,0,5,172,40,7
42,5,0,5,164,40,6
45,7,0,7,153,39,0
48,15,2,13,142,35,0
51,16,1,15,135,31,0
54,15,0,15,129,28,5
55,19,0,19,125,25,7
56,19,0,19,125,23,5
58,17,0,17,124,15,10
60,16,0,16,118,13,12
62,12,0,12,114,19,8
64,12,0,12,109,17,13
66,15,0,15,105,14,16
67,13,0,13,102,13,17
65,12,0,12,101,13,16
62,9,0,9,102,16,12
67,10,0,10,96,12,12
65,11,2,9,103,12,14
56,10,2,8,123,16,29
46,8,1,7,158,24,35
43,5,0,5,171,32,34
38,4,0,4,171,35,39
38,4,0,4,175,38,6
36,4,0,4,182,41,2
35,4,0,4,185,42,12
37,4,0,4,178,43,4
43,7,0,7,165,38,0
54,18,3,15,156,34,0
56,10,0,10,147,33,0
56,10,0,10,142,32,2
56,13,0,13,140,32,4
56,19,0,19,141,25,3
57,15,0,15,142,25,5
59,11,0,11,140,27,8
61,10,0,10,137,27,8
64,16.0462318,3.024354398,13.0218774,132,25,8
69,16.0462318,3.024354398,13.0218774,128,21,10
68,8,0,8,126,16,10
78,12,0,12,119,9,9
84,14,0,14,114,10,4
89,16,1,15,113,11,6
88,15,2,13,118,14,3
86,20,4,16,125,11,12
83,18,4,14,132,10,13
80,28,7,21,135,11,15
75,27,7,20,143,15,15
67,26,7,19,158,23,25
62,26,5,21,166,27,38
61,28,3,25,168,25,23
61,30,1,29,167,23,0
76,23,1,22,153,18,6
75,20,0,20,146,15,0
79,37,5,32,140,15,4
81,35,3,32,137,6,9
81,40,5,35,133,2,10
82,47,9,38,131,1,14
84,35,2,33,128,2,13
83,36,4,32,126,2,14
82,31,2,29,124,5,14
81,27,1,26,126,5,15
78,26,1,25,127,3,13
80,30,2,28,120,1,15
81,34,6,28,117,0,7
73,42,13,29,122,0,10
71,48,18,30,122,2,10
61,53,22,31,138,6,9
44,42,15,27,171,25.11451542,22
36,14,2,12,193,25.11451542,24
34,8,1,7,205,25.11451542,12
34,16.05830212,3.026128424,13.03217369,209,37,9
31,5,0,5,208,41,0
29,4,0,4,210,41,5
28,4,0,4,206,40,4
29,5,0,5,197,38,0
31,10,0,10,185,33,10
33,19,0,19,172,24,0
34,19,0,19,163,23,2
37,19,0,19,154,19,0
39,22,0,22,146,18,4
42,25,1,24,139,16,7
43,23,0,23,133,15,6
39,22,0,22,133,14,7
41,17,0,17,128,23,7
43,15,0,15,126,20,8
42,13,0,13,128,15,7
44,12,0,12,124,16,9
48,18,0,18,121,14,9
51,26,1,25,119,3,7
54,31,4,27,118,3,13
53,32,8,24,118,5,10
53,43,18,25,125,6,14
48,39,16,23,133,6,17
47,34,13,21,145,8,23
43,29,9,20,155,11,25
45,25,7,18,164,17,26
45,16,2,14,169,18,29
46,15,1,14,164,17,4
53,25,1,24,158,16,15
49,28,1,27,151,13,14
52,30,1,29,143,14,12
53,29,1,28,141,11,11
53,35,3,32,141,9,14
53,36,3,33,141,4,20
52,43,6,37,142,3,21
56,52,12,40,137,2,21
60,55,17,38,135,1,19
68,53,17,36,157,2,15
63,15,0,15,143,5,17
66,30,3,27,130,1,21
67,37,4,33,131,1,14
71,13,0,13,130,1,18
69,9,0,9,139,2,17
70,17,0,17,131,1,18
72,53,20,33,128,1,14
69,49,23,26,132,3,15
62,41,17,24,150,4,24
57,33,11,22,168,7,22
55,18,4,14,186,18,25
42,12,1,11,211,31,35
37,10,1,9,216,37,33
31,7,0,7,215,38,0
30,6,0,6,203,35,0
31,7,0,7,187,29,0
28,8,0,8,180,27,0
30,8,0,8,168,27,0
32,12,0,12,159,24,0
41,13,0,13,148,21,0
44,7,0,7,137,23,1
46,7,0,7,127,29,0
48,7,0,7,122,26,0
47,6,0,6,119,27,0
48,5,0,5,117,26,0
50,6,0,6,115,21,0
51,9,0,9,111,16,2
54,10,0,10,110,13,0
55,15,1,14,110,9,1
56,23,2,21,106,3,2
54,17,3,14,112,11,4
52,14,3,11,119,12,10
47,10,2,8,145,17,12
45,9,2,7,155,22,20
45,7,1,6,151,26,21
44,7,1,6,160,28,8
40,10,1,9,168,30,7
39,12,1,11,171,30,14
44,16,1,15,165,29,0
48,14,0,14,158,30,0
52,21,0,21,149,16,0
55,28,1,27,141,10,1
59,39,5,34,134,6,6
61,52,15,37,130,2,11
62,48,13,35,125,2,8
64,53,21,32,122,2,9
66,64,34,30,117,1,9
68,50,19,31,109,2,12
68,37,5,32,104,2,11
67,26,1,25,101,2,13
67,19,0,19,95,1,15
69,24,2,22,87,1,10
68,26,3,23,86,0,8
65,34,10,24,84,0,10
55,22,6,16,96,5,10
50,36,15,21,119,8,23
42,27,9,18,151,11,33
35,16,3,13,169,22,35
31,13,2,11,175,33,33
30,7,0,7,180,40,12
28,16,3,13,188,42,11
24,13,1,12,189,44,10
26,12,0,12,182,45,6
31,16,0,16,174,39,0
48,34,4,30,161,25,0
52,31,2,29,151,23,11
47,28,0,28,148,20,13
48,29,1,28,144,21,12
59,26,1,25,133,18,18
67,26,1,25,127,18,20
72,26,1,25,119,8,20
70,17,0,17,109,14,14
70,13,0,13,104,16,11
68,9,0,9,104,17,8
70,8,0,8,101,17,11
67,9,0,9,102,13,11
66,17,0,17,99,9,15
62,24,4,20,100,14,15
58,23,6,17,105,15,14
45,12,2,10,134,21,29
27,7,1,6,172,35,25
25,4,0,4,180,41,12
30,3,0,3,185,40,10
29,3,0,3,187,39,13
28,3,0,3,189,39,13
27,3,0,3,186,38,0
27,3,0,3,173,38,8
29,6,0,6,162,36,0
29,11,0,11,154,32,0
31,18,0,18,146,29,0
36,24,1,23,138,22,2
40,31,2,29,134,12,5
51,25,1,24,133,14,8
52,20,1,19,133,16,15
53,16,0,16,128,14,14
55,13,0,13,122,16,10
56,16.07785422,3.027307526,13.0505467,116,12,11
53,16.07785422,3.027307526,13.0505467,113,12,10
53,11,0,11,113,13,7
53,13,0,13,113,3,9
52,19,0,19,111,2,8
54,22,1,21,111,2,8
56,23,3,20,114,2,8
76,38,14,24,103,5,11
69,16.07878197,3.027302379,13.05147959,117,8,5
61,28,10,18,143,11,20
59,45,17,28,163,14,33
60,43,14,29,182,15,24
58,23,4,19,202,27,21
39,11,1,10,214,37,6
49,11,0,11,205,45,14
52,10,0,10,201,40,0
55,11,0,11,201,43,13
60,12,0,12,203,44,10
62,8,0,8,205,41,12
64,5,0,5,207,41,12
72,6,0,6,204,42,13
72,5,0,5,209,40,14
71,6,0,6,210,41,13
83,6,0,6,202,42,11
79,18,0,18,148,14,12
82,29,1,28,141,3,6
84,20,0,20,139,7,10
85,14,0,14,139,10,10
83,14,0,14,142,12,14
82,20,1,19,143,8,15
81,29,4,25,149,11,14
84,16,2,14,152,15,15
61.65605475,14,2,12,175.1909353,25.08048806,13
61.65605475,10,1,9,175.1909353,23,17
61.65605475,8,1,7,175.1909353,26,23
61.65605475,8,1,7,175.1909353,28,31
61.65605475,6,0,6,175.1909353,36,24
61.65605475,6,0,6,175.1909353,38,15
56,6,0,6,193,35,0
58,11,0,11,186,31,0
43,24,2,22,177,26,4
43,18,0,18,166,20,0
51,16,0,16,160,16,0
46,7,0,7,151,24,0
30,8,0,8,149,28,0
31,5,0,5,137,33,0
36,6,0,6,126,29,0
39,5,0,5,120,25,1
36,4,0,4,118,28,0
36,5,0,5,112,31,0
36,5,0,5,110,29,0
36,6,0,6,109,28,1
37,7,0,7,107,24,1
37,9,0,9,109,19,5
32,6,0,6,120,27,2
32,9,2,7,126,29,7
29,7,1,6,139,29,8
28,6,1,5,151,30,7
28,6,1,5,149,30,8
27,3,0,3,145,30,3
24,5,1,4,136,31,3
23,7,2,5,139,32,0
24,7,1,6,128,32,0
25,10,1,9,123,29,0
28,9,0,9,119,23,0
33,9,0,9,115,22,0
35,9,0,9,109,29,4
32,10,0,10,108,27,5
35,8,0,8,104,28,0
37,8,0,8,99,27,0
39,6,0,6,98,25,0
42,7,0,7,91,26,0
41,7,0,7,91,25,0
38,7,0,7,91,25,3
38,8,0,8,92,24,4
39,9,0,9,86,22,5
41,13,0,13,83,11,3
41,14,0,14,83,10,2
46,20,3,17,78,16,6
39,15,3,12,99,19,6
32,17,5,12,126,23,14
30,10,2,8,137,25,21
31,12,3,9,140,26,21
27,9,1,8,147,30,24
24,8,1,7,155,35,13
25,8,0,8,159,34,0
33,9,0,9,143,31,9
36,15,1,14,132,29,0
40,22,2,20,123,25,0
45,23,2,21,116,23,6
44,26,1,25,113,18,6
44,27,1,26,110,20,9
47,26,1,25,106,18,7
52,34,2,32,97,17,12
57,24,1,23,89,12,12
57,13,0,13,81,11,13
54,21,0,21,77,4,12
56,18,0,18,75,10,12
57,19,0,19,74,8,8
54,22,1,21,76,8,8
59,24,1,23,77,5,10
64,31,5,26,72,2,9
75,34,9,25,63,2,11
81,31,8,23,67,3,9
85,34,10,24,64,3,10
89,29,7,22,68,7,11
90,24,4,20,70,6,13
89,28,6,22,74,4,16
90,30,5,25,78,3,17
91,30,5,25,80,4,15
91,29,3,26,81,3,17
91,28,2,26,84,2,15
91,20,1,19,86,9,12
92,18,0,18,86,8,9
91,20,1,19,84,12,7
92,16,0,16,84,19,7
92,12,0,12,85,15,7
93,18,0,18,88,9,9
93,16,0,16,90,9,11
93,12,0,12,92,11,10
92,7,0,7,95,20,6
92,6,0,6,94,23,8
92,4,0,4,94,22,6
92,7,0,7,94,26,1
92,7,0,7,96,28,2
93,5,0,5,96,27,2
93,6,0,6,98,26,0
93,7,0,7,100,26,3
93,6,0,6,104,25,4
93,8,1,7,109,25,5
93,9,1,8,113,25,4
93,10,1,9,118,26,3
93,8,1,7,122,26,5
93,8,0,8,122,26,3
93,7,0,7,122,27,2
93,7,0,7,122,26,0
93,6,0,6,123,26,1
93,7,0,7,124,26,2
93,6,0,6,126,26,4
93,7,0,7,126,25,4
94,6,0,6,127,24,2
94,4,0,4,127,24,5
94,4,0,4,127,24,3
94,4,0,4,128,24,2
94,4,0,4,130,25,3
94,3,0,3,131,24,0
94,4,0,4,133,23,3
94,4,0,4,135,20,2
94,4,0,4,137,20,0
94,5,0,5,140,22,0
94,5,0,5,144,20,3
94,5,0,5,149,19,1
94,6,1,5,157,21,2
93,5,1,4,168,20,6
90,4,0,4,177,21,10
88,4,0,4,181,22,8
89,4,0,4,180,21,6
90,4,0,4,177,19,10
90,6,0,6,179,18,9
89,9,0,9,179,14,4
89,22,1,21,177,8,5
89,28,1,27,176,1,4
90,30,2,28,173,1,3
91,30,2,28,178,0,9
91,22,1,21,180,1,6
91,18,0,18,174,2,6
93,22,1,21,175,0,9
92,21,1,20,170,0,5
92,16.06391852,3.01797718,13.04594134,169,0,9
93,16.06391852,3.01797718,13.04594134,168,0,9
93,33,10,23,167,0,13
93,34,8,26,165,0,12
94,23,2,21,162,0,9
94,21,2,19,162,0,4
94,23,5,18,165,1,2
93,20,4,16,168,25.0543184,12
90,16.06571898,3.018380047,13.04733893,171,3,12
86,24,6,18,178,4,14
77,23,7,16,193,6,18
70,16,4,12,200,12,21
64,11,2,9,209,17,33
66,12,1,11,206,22,16
70,13,1,12,199,18,7
76,15,1,14,195,16,1
70,7,0,7,169,27,2
68,7,1,6,158,27,0
79,6,0,6,150,26,0
83,7,0,7,136,23,0
63,6,0,6,134,24,0
60,5,0,5,130,29,0
58,4,0,4,123,29,0
64,3,0,3,115,29,1
70,3,0,3,104,30,0
71,3,0,3,99,30,0
70,3,0,3,97,29,1
78,3,0,3,87,29,3
78,5,0,5,84,27,0
77,6,0,6,81,26,1
78,7,0,7,81,25,0
76,8,0,8,81,23,3
75,8,0,8,79,21,4
75,9,0,9,79,20,6
78,11,1,10,82,20,5
71,11,1,10,88,18,4
68,12,1,11,92,17,7
66,8,0,8,97,21,12
60,7,0,7,98,26,4
61,8,0,8,97,25,3
59,16,2,14,97,24,5
59,10,0,10,96,26,5
61,11,0,11,95,23,5
65,10,0,10,93,21,4
66,11,0,11,92,19,6
66,10,0,10,90,20,9
74,11,0,11,86,16,7
73,9,0,9,83,16,7
73,7,0,7,82,21,6
72,9,0,9,82,22,8
71,10,0,10,83,19,9
74,13,0,13,82,13,10
70,15,0,15,83,9,8
70,25,1,24,84,8,12
68,22,2,20,84,8,12
75,22,3,19,85,8,8
76,29,7,22,90,4,11
81,27,6,21,88,7,10
77,29,7,22,92,9,7
79,20,2,18,93,11,11
76,20,2,18,95,12,11
80,20,2,18,100,11,13
79,18,1,17,101,7,12
79,26,2,24,102,3,12
78,25,1,24,103,6,10
77,27,2,25,104,3,18
78,26,1,25,104,2,16
83,28,2,26,103,2,18
90,25,1,24,99,2,18
89,25,2,23,101,1,16
91,24,2,22,100,1,11
92,19,1,18,103,4,9
90,14,0,14,104,4,11
90,14,0,14,106,3,12
90,18,0,18,106,2,13
89,19,1,18,107,1,11
89,25,5,20,108,0,10
89,29,7,22,108,0,12
75,21,2,19,108,0,11
72,16,1,15,105,6,6
71,13,1,12,105,16,3
72,15,1,14,103,12,7
73,11,0,11,96,14,2
69,13,1,12,93,18,0
64,13,1,12,94,16,0
72,9,0,9,84,20,2
74,12,0,12,78,21,1
75,16,2,14,74,16,1
76,13,2,11,72,18,3
59,11,0,11,73,19,0
57,6,0,6,67,25,4
50,5,0,5,64,26,7
51,5,0,5,61,26,1
51,5,0,5,55,26,0
54,5,0,5,47,26,1
56,4,0,4,41,25,1
54,4,0,4,36,26,1
58,5,0,5,28,26,0
54,5,0,5,28,25,1
53,5,0,5,26,23,2
54,11,0,11,23,24,1
55,18,1,17,21,20,1
52,20,3,17,30,19,3
45,11,2,9,49,20,12
38,9,2,7,69,20,24
35,6,1,5,80,21,21
31,6,1,5,81,23,16
32,6,1,5,85,27,7
33,5,0,5,94,27,0
31,5,0,5,96,27,5
36,8,0,8,86,24,6
43,14,0,14,73,19,3
42,39,5,34,72,8,0
47,46,10,36,65,2,0
46,60,22,38,68,2,7
44,58,18,40,69,0,9
44,77,36,41,70,0,13
45,81,37,44,65,0,9
55,60,18,42,54,0,12
53,64,24,40,55,0,8
55,38,5,33,50,5,7
56,15,0,15,54,17,0
56,4,0,4,53,25,0
53,6,0,6,51,25,2
50,10,0,10,53,19,2
59,25,2,23,40,14,0
57,38,11,27,46,10,4
47,21,5,16,67,18,15
38,11,2,9,90,23,29
34,7,1,6,101,26,22
34,7,1,6,109,28,11
36,7,1,6,104,30,0
35,5,0,5,110,32,6
35,7,0,7,112,32,11
38,8,0,8,103,31,9
43,12,0,12,88,28,2
45,30,3,27,82,19,0
45,31,3,28,79,19,0
47,36,3,33,75,17,2
47,49,10,39,71,10,10
47,61,21,40,68,8,9
45,65,27,38,68,12,12
52,68,33,35,61,8,14
59,62,29,33,54,0,16
64,50,13,37,51,0,15
68,45,8,37,45,0,15
68,34,5,29,41,0,17
66,24,1,23,43,1,20
64,17,0,17,45,3,15
62,14,0,14,46,9,14
60,13,1,12,49,10,13
55,17,4,13,57,12,14
49,14,3,11,67,18,16
45,15,3,12,88,21,14
42,15,3,12,101,23,25
42,17,3,14,109,24,36
47,19,3,16,116,26,20
47,30,3,27,114,22,24
53,35,2,33,115,18,9
55,45,1,44,105,13,20
54,49,3,46,99,11,12
57,37,2,35,92,14,15
60,40,3,37,86,12,25
60,51,11,40,85,5,29
66,68,28,40,78,2,35
65,69,29,40,78,0,34
66,49,12,37,77,0,35
68,44,7,37,74,0,35
65,16.0870041,3.021647283,13.06535681,73,0,36
67,16.0870041,3.021647283,13.06535681,73,1,35
77,34,2,32,71,0,39
78,28,1,27,69,0,38
79,33,5,28,72,0,37
79,47,17,30,76,1,43
81,62,31,31,79,1,39
87,69,39,30,77,1,39
87,16.09249006,3.024036854,13.06845321,87,1,29
91,71,43,28,82,24.99994538,32
91,66,39,27,84,0,32
93,63,32,31,94,0,31
95,76,39,37,140,1,25
93,120,75,45,164,3,24
84,57,19,38,107,2,26
84,46,10,36,105,1,23
82,60,19,41,104,1,24
82,52,12,40,105,1,23
79,52,13,39,110,1,21
79,56,16,40,106,1,21
79,65,26,39,106,1,18
81,62,24,38,107,1,15
82,48,13,35,106,0,19
81,44,11,33,107,0,20
80,42,15,27,103,0,15
78,24,2,22,103,0,10
70,16,0,16,106,1,9
60,15,0,15,108,7,4
52,19,0,19,108,9,2
54,17,0,17,97,9,0
55,23,3,20,96,2,1
46,24,5,19,112,9,9
36,16,3,13,136,18,21
30,10,2,8,151,23,10
29,8,1,7,159,27,3
29,7,1,6,154,30,12
27,6,0,6,162,31,16
25,6,0,6,163,32,12
28,7,0,7,146,29,0
34,19,1,18,132,14,0
40,52,11,41,132,7,0
33,66,23,43,135,5,0
38,48,8,40,127,6,4
44,29,2,27,112,3,4
45,26,1,25,101,3,2
39,29,1,28,102,7,2
36,19,1,18,101,21,1
41,10,0,10,92,21,0
46,9,0,9,82,11,2
51,15,0,15,74,5,1
51,19,0,19,71,6,2
50,21,0,21,70,2,3
49,28,1,27,67,0,3
50,40,7,33,67,1,2
48,51,20,31,74,2,2
40,38,14,24,95,7,15
30,21,6,15,127,13,22
28,14,3,11,141,17,22
28,15,3,12,144,19,22
28,20,4,16,144,22,25
27,27,5,22,151,21,9
26,36,6,30,155,20,6
42,34,3,31,140,14,6
48,41,2,39,129,5,0
53,57,9,48,116,1,0
38,48,8,40,115,6,0
39,26,1,25,107,17,0
41,25,1,24,98,18,0
41,26,1,25,94,19,0
42,36,4,32,90,18,3
45,26,1,25,84,9,3
45,17,0,17,78,15,4
47,13,0,13,73,15,3
47,12,0,12,72,13,3
48,19,0,19,69,13,3
51,22,0,22,66,12,4
51,24,0,24,64,2,3
54,45,13,32,58,1,2
53,64,30,34,62,2,3
47,51,21,30,78,6,14
35,35,12,23,113,9,23
33,18,4,14,119,16,23
32,12,2,10,127,21,15
31,13,2,11,130,23,15
27,12,1,11,141,27,10
22,7,0,7,141,31,9
25,7,0,7,128,29,12
25,17,0,17,125,23,0
39,50,9,41,123,10,0
40,64,18,46,115,1,1
34,53,8,45,111,11,5
37,33,2,31,102,13,0
40,23,1,22,97,5,3
48,19,1,18,91,3,8
49,14,0,14,84,14,6
51,9,0,9,77,21,0
49,9,0,9,75,20,1
48,6,0,6,74,19,0
49,6,0,6,75,17,0
50,7,0,7,76,16,1
55,10,0,10,71,11,0
59,21,1,20,63,1,2
58,27,5,22,59,3,5
56,26,6,20,60,5,5
52,30,8,22,65,6,4
49,27,7,20,74,8,9
37,21,6,15,92,12,16
34,13,2,11,95,22,20
33,11,1,10,99,20,9
34,8,0,8,97,20,11
38,13,1,12,91,21,5
45,23,2,21,84,15,4
43,22,2,20,82,14,5
44,31,3,28,79,12,14
43,40,6,34,77,12,11
43,47,10,37,79,3,10
48,37,6,31,77,3,10
47,23,1,22,74,9,14
45,14,0,14,70,11,11
48,11,0,11,69,14,6
46,21,0,21,66,11,6
47,26,0,26,64,10,5
53,16,0,16,61,4,11
56,12,0,12,60,0,14
56,14,0,14,57,3,19
58,14,0,14,57,2,18
63,23,3,20,56,1,19
65,40,14,26,58,2,13
65,44,17,27,60,1,17
71,49,20,29,57,2,13
75,55,25,30,54,1,12
77,49,19,30,50,2,13
80,43,15,28,51,2,22
77,31,5,26,50,3,25
76,23,2,21,53,7,27
78,21,1,20,55,11,22
76,27,1,26,53,10,11
77,30,2,28,52,11,14
77,29,2,27,52,8,12
76,33,3,30,52,5,13
74,29,2,27,49,1,24
71,32,3,29,49,1,31
69,35,5,30,47,0,33
67,36,6,30,46,0,33
69,36,8,28,41,1,31
72,37,13,24,34,1,35
72,32,9,23,33,1,31
68,24,4,20,35,1,29
63,16,0,16,37,4,26
65,20,1,19,38,5,24
60,25,6,19,49,7,22
53,22,6,16,71,12,31
43,13,3,10,100,21,37
37,7,1,6,119,28,26
35,5,0,5,124,30,14
39,5,0,5,119,33,16
37,5,0,5,130,35,11
37,5,0,5,128,35,6
41,5,0,5,113,34,5
46,8,0,8,100,31,0
51,23,1,22,92,23,0
45,32,2,30,92,16,0
43,28,2,26,82,19,0
46,33,3,30,73,19,0
46,42,7,35,68,16,3
50,53,17,36,61,15,4
57,56,21,35,50,13,5
55,32,2,30,47,13,6
54,16.15504362,3.040467246,13.11457638,44,17,6
58,16.15504362,3.040467246,13.11457638,37,18,11
62,21,0,21,31,10,14
66,23,1,22,26,3,13
66,28,2,26,23,0,15
66,37,9,28,29,1,14
62,33,8,25,34,3,14
60,35,10,25,42,6,14
57,37,11,26,54,24.92662408,12.17375433
49,16.15816424,3.041076954,13.11708729,77,9,14
50,28,9,19,77,13,34
50,27,9,18,75,14,20
49,22,5,17,81,13,14
52,28,5,23,77,11,16
52,35,5,30,77,8,16
50,34,2,32,76,6,16
50,38,2,36,75,4,15
52,45,6,39,76,3,21
54,46,7,39,78,4,21
64,43,5,38,72,3,22
76,34,2,32,69,9,19
81,27,1,26,67,11,15
83,24,1,23,66,13,14
83,20,0,20,67,10,15
85,23,0,23,67,7,17
86,19,0,19,67,11,12
87,18,0,18,67,6,14
85,19,0,19,69,8,13
84,25,1,24,70,3,14
83,30,4,26,68,0,15
81,42,16,26,73,1,17
75,35,13,22,86,4,20
69,23,7,16,104,9,23
68,23,6,17,112,11,23
69,22,6,16,123,11,20
66,20,5,15,129,14,22
66,16,2,14,134,14,30
68,15,1,14,135,15,13
69,21,1,20,129,9,8
71,27,1,26,126,4,5
72,39,3,36,124,0,9
72,40,4,36,123,0,14
72,43,6,37,123,0,15
72,51,12,39,123,0,16
72,50,11,39,123,0,19
73,51,11,40,122,0,17
73,43,6,37,119,0,18
73,39,4,35,117,0,16
75,38,4,34,114,0,18
75,34,4,30,111,0,15
76,33,4,29,108,0,11
77,29,4,25,103,0,13
79,37,13,24,97,0,13
81,52,26,26,97,0,15
83,56,32,24,102,0,12
78,58,36,22,109,0,20
72,53,32,21,118,0,19
67,49,26,23,131,0,25
63,37,15,22,142,3,26
63,28,8,20,146,10,28
62,25,5,20,150,15,25
63,22,3,19,150,13,18
64,23,2,21,146,8,10
65,29,1,28,142,4,11
67,35,2,33,140,2,16
74,38,3,35,134,1,15
75,46,8,38,130,1,16
74,48,10,38,133,1,18
74,52,12,40,132,1,24
77,52,13,39,124,1,21
75,43,6,37,122,1,19
78,35,3,32,114,1,18
79,35,6,29,110,1,17
82,40,12,28,103,1,12
84,42,18,24,98,1,15
85,45,24,21,95,1,16
85,54,33,21,94,1,16
87,92,64,28,87,0,20
86,137,106,31,106,0,21
81,117,78,39,117,0,32
47,86,47,39,156,3,42
41,33,9,24,172,15,40
37,34,9,25,180,15,29
34,24,4,20,177,26,16
27,11,1,10,183,35,11
27,7,0,7,167,35,0
29,7,0,7,153,34,0
28,9,0,9,139,31,0
30,9,0,9,123,27,0
32,7,0,7,114,26,0
32,6,0,6,104,25,0
32,7,0,7,100,27,0
33,5,0,5,95,27,0
34,4,0,4,87,27,0
35,4,0,4,83,25,0
37,4,0,4,77,26,0
39,4,0,4,73,26,0
42,4,0,4,68,26,0
42,4,0,4,67,26,1
43,6,0,6,65,24,6
43,9,0,9,63,21,3
44,13,0,13,62,21,4
45,18,1,17,64,19,2
42,14,1,13,68,14,5
38,9,0,9,73,19,4
37,9,0,9,78,17,8
36,10,1,9,80,19,9
37,11,1,10,84,17,9
38,11,1,10,85,16,6
37,11,1,10,90,18,9
40,14,1,13,89,17,10
43,14,1,13,83,17,7
50,19,2,17,81,14,6
51,21,1,20,80,18,8
51,24,1,23,76,9,10
51,33,3,30,72,0,18
48,35,3,32,71,1,27
49,29,2,27,71,3,29
49,32,2,30,70,3,27
51,22,1,21,66,4,24
54,32,4,28,63,0,28
58,33,5,28,54,0,22
59,31,5,26,49,0,16
60,29,4,25,48,0,11
60,28,4,24,46,0,15
59,32,7,25,43,0,14
57,37,13,24,46,0,14
52,36,15,21,55,5,18
45,30,12,18,77,8,22
42,25,8,17,97,10,29
41,38,13,25,111,8,37
44,55,20,35,114,9,33
41,59,19,40,137,9,29
39,53,13,40,145,12,35
44,38,5,33,136,9,30
48,45,3,42,121,5,6
51,48,3,45,113,5,5
50,40,1,39,103,3,13
42,28,1,27,111,17,22
39,14,0,14,109,22,13
38,7,0,7,106,31,4
41,5,0,5,96,33,0
40,5,0,5,92,34,2
38,4,0,4,88,34,0
37,3,0,3,82,33,2
36,3,0,3,80,34,0
36,2,0,2,77,34,5
37,3,0,3,75,33,7
37,3,0,3,73,31,6
37,4,0,4,75,30,6
37,5,0,5,78,30,8
36,4,0,4,85,29,7
35,4,0,4,93,29,9
33,3,0,3,101,29,11
31,3,0,3,113,29,11
32,4,0,4,113,29,19
29,4,0,4,117,30,24
31,4,0,4,117,32,27
34,5,0,5,104,33,11
35,7,0,7,95,31,0
39,28,6,22,90,26,0
42,24,2,22,82,18,5
45,37,5,32,74,7,9
49,32,4,28,66,5,14
51,21,2,19,58,12,14
51,26,2,24,54,14,11
49,18,0,18,54,12,10
55,12,0,12,46,12,9
59,16.21324656,3.058940444,13.15430612,37,5,13
61,16.21324656,3.058940444,13.15430612,33,2,13
61,21,1,20,31,2,17
62,21,1,20,28,0,11
65,28,4,24,23,0,11
66,41,15,26,20,1,12
63,46,21,25,25,3,10
56,40,18,22,41,5,19
48,16.21631441,3.060221673,13.15609274,69,7,27
43,30,11,19,88,24.85867746,32
43,31,11,20,102,15,31
44,21,5,16,105,16,28
42,13,2,11,120,16,31
42,15,2,13,126,19,27
49,14,1,13,108,19,20
55,19,0,19,98,13,6
58,37,3,34,93,4,0
60,48,8,40,86,2,6
63,50,9,41,82,1,9
63,42,4,38,81,0,17
61,42,4,38,84,0,20
60,60,16,44,86,0,26
61,49,9,40,85,0,38
59,46,9,37,81,1,32
54,30,1,29,79,0,22
61,23,0,23,74,3,22
64,23,0,23,68,3,19
69,19,0,19,68,1,12
68,25,2,23,67,0,13
71,33,7,26,63,0,13
66,33,7,26,62,0,12
68,37,12,25,69,1,12
66,40,14,26,73,1,15
80,38,12,26,68,4,15
79,35,13,22,79,5,17
80,37,13,24,87,4,23
81,29,7,22,89,2,23
80,36,10,26,94,0,21
80,39,9,30,93,0,23
81,53,18,35,93,0,21
84,56,20,36,93,0,20
83,56,20,36,93,0,15
84,63,27,36,93,0,15
85,66,30,36,92,0,18
86,70,34,36,91,0,18
86,74,41,33,93,0,19
87,72,39,33,91,0,21
88,63,32,31,87,0,19
89,56,27,29,88,0,16
89,50,23,27,80,0,15
92,46,21,25,70,0,14
92,47,23,24,65,0,5
93,56,32,24,60,0,4
94,48,25,23,60,0,4
94,40,19,21,64,0,7
94,44,23,21,74,0,10
91,47,26,21,93,0,13
75,45,23,22,112,0,22
72,58,28,30,120,1,28
66,61,30,31,128,2,24
68,41,16,25,134,4,14
65,35,12,23,144,7,20
65,28,6,22,145,6,30
70,31,3,28,135,2,19
58,61,26,35,134,1,2
61,47,15,32,119,4,2
61,17,1,16,109,1,5
60,22,1,21,107,13,2
60,30,3,27,101,12,1
61,37,5,32,95,12,5
58,23,1,22,95,15,5
56,16,1,15,97,20,7
54,12,0,12,96,19,6
54,11,0,11,95,18,9
49,12,0,12,95,17,8
49,13,0,13,94,13,9
51,22,1,21,91,5,5
55,27,2,25,86,0,8
54,20,2,18,90,1,6
57,16,2,14,93,8,9
58,17,1,16,94,2,11
57,15,1,14,98,3,15
63,14,1,13,95,7,14
77,16,1,15,87,8,11
76,17,1,16,86,8,8
77,19,1,18,86,8,9
79,20,1,19,87,7,13
81,18,1,17,87,10,11
81,23,3,20,87,10,11
79,17,1,16,87,11,13
77,18,1,17,86,6,11
77,19,1,18,85,3,13
78,18,1,17,85,8,13
73,18,1,17,84,10,12
72,16,0,16,83,11,15
74,15,0,15,82,6,12
74,11,0,11,79,5,14
76,12,0,12,77,4,14
79,16,0,16,77,1,17
80,16,0,16,78,5,18
79,18,1,17,76,0,17
78,29,6,23,70,0,18
78,42,19,23,73,0,20
71,37,16,21,87,0,25
56,24,8,16,111,3,27
44,24,8,16,133,8,29
38,15,3,12,140,16,26
36,14,2,12,145,24,19
26,8,1,7,156,32,10
27,5,0,5,152,34,4
28,7,0,7,144,31,0
32,13,0,13,128,24,0
50,28,3,25,124,13,0
56,18,2,16,113,24,0
60,9,0,9,102,27,0
56,11,0,11,94,24,0
45,9,0,9,90,22,0
47,9,0,9,89,22,0
48,10,0,10,83,20,3
50,12,0,12,81,14,1
54,9,0,9,80,13,0
56,8,0,8,78,12,4
59,7,0,7,74,12,5
61,8,0,8,72,10,6
61,11,0,11,70,10,6
61,14,0,14,70,9,3
59,20,2,18,72,9,4
57,18,2,16,72,12,6
59,14,2,12,75,11,7
62,11,1,10,77,16,10
64,10,1,9,83,16,10
63,9,1,8,90,19,14
62,7,0,7,92,22,13
63,8,0,8,90,21,9
65,8,0,8,87,16,3
66,10,0,10,86,17,6
66,11,0,11,83,14,6
67,19,1,18,83,10,13
67,19,1,18,81,11,16
67,18,1,17,81,8,18
67,17,1,16,79,6,17
69,17,1,16,76,9,15
70,19,1,18,70,8,12
72,22,2,20,68,4,12
73,21,1,20,66,1,14
74,19,1,18,64,0,14
74,24,5,19,62,0,16
76,22,4,18,60,1,17
76,23,4,19,56,1,18
79,22,3,19,52,1,16
80,24,6,18,50,1,18
80,32,14,18,52,2,22
75,29,14,15,58,3,24
69,25,10,15,70,5,27
66,22,5,17,77,10,33
64,16,3,13,82,13,28
64,15,2,13,85,14,28
65,14,1,13,90,16,28
70,10,0,10,90,16,26
73,6,0,6,88,25,16
77,8,0,8,82,27,10
80,8,0,8,76,27,8
82,6,0,6,73,28,6
83,7,0,7,69,28,8
88,6,0,6,65,30,6
88,5,0,5,62,29,7
89,5,0,5,58,28,9
90,6,0,6,56,28,3
89,16.2614271,3.076980429,13.18444667,50,28,4
90,16.2614271,3.076980429,13.18444667,43,30,1
89,4,0,4,39,29,3
88,6,0,6,39,29,5
88,8,0,8,42,26,4
86,12,0,12,44,14,6
85,15,1,14,49,19,8
85,21,4,17,51,12,4
75,16.26046091,3.07656841,13.1838925,69,10,11
71,22,4,18,78,24.78083578,11
60,23,7,16,96,14,13
57,20,5,15,102,16,24
53,18,3,15,110,18,27
51,18,2,16,113,20,21
51,20,1,19,106,18,5
60,46,7,39,102,3,0
65,89,37,52,91,0,0
63,117,69,48,89,0,0
66,128,84,44,89,0,4
71,116,71,45,85,0,10
72,89,48,41,82,0,12
77,87,48,39,72,0,11
77,83,42,41,69,0,13
80,111,64,47,62,0,12
81,104,61,43,56,0,12
80,52,22,30,55,0,10
75,33,8,25,57,1,9
76,27,3,24,53,3,4
67,24,2,22,55,3,11
63,26,2,24,56,10,8
58,37,10,27,59,12,6
48,23,5,18,77,14,13
35,15,3,12,104,21,18
32,8,1,7,113,27,13
32,7,1,6,119,29,6
35,5,0,5,114,28,4
31,6,0,6,113,27,0
30,6,0,6,108,29,0
30,6,0,6,102,28,0
30,8,0,8,93,28,0
31,9,0,9,84,27,0
31,11,0,11,77,26,0
34,13,0,13,70,26,0
39,19,1,18,59,23,1
38,16,0,16,62,23,2
41,11,0,11,57,26,5
42,8,0,8,54,26,4
41,13,0,13,51,27,2
45,18,0,18,47,23,0
44,9,0,9,49,24,2
42,10,0,10,53,20,7
42,13,0,13,52,18,6
44,15,0,15,50,17,5
46,27,1,26,49,10,6
52,38,6,32,48,3,4
57,61,28,33,46,1,10
47,50,22,28,52,3,15
42,37,12,25,63,9,17
41,30,6,24,70,11,17
39,29,7,22,75,13,17
40,24,4,20,78,13,19
40,22,3,19,82,12,16
44,15,1,14,78,12,24
46,19,0,19,71,6,20
48,36,3,33,67,1,10
48,42,4,38,65,0,12
48,39,3,36,62,3,26
52,54,13,41,60,0,22
54,58,15,43,57,0,19
57,65,20,45,54,0,24
59,64,21,43,50,0,21
59,44,7,37,49,0,17
58,41,6,35,48,0,17
58,39,6,33,48,0,15
58,35,4,31,50,0,15
60,38,9,29,51,0,15
57,49,18,31,56,0,19
60,76,42,34,55,0,15
60,75,42,33,54,0,17
59,58,28,30,55,0,16
54,41,15,26,68,0,19
52,43,16,27,85,0,19
50,44,16,28,103,0,32
53,25,5,20,102,2,38
53,35,7,28,104,4,37
55,47,12,35,103,3,29
55,40,6,34,98,5,21
58,43,8,35,93,1,27
58,53,16,37,92,1,23
59,55,17,38,90,1,27
58,55,17,38,89,1,29
59,63,24,39,88,1,31
62,65,25,40,87,1,27
64,59,20,39,88,0,19
65,46,9,37,86,0,18
67,39,4,35,85,1,17
70,36,3,33,85,0,17
77,34,3,31,83,1,14
86,26,1,25,78,5,16
89,19,1,18,76,5,9
91,16,1,15,76,9,8
90,14,1,13,76,7,7
87,17,2,15,77,8,7
75,18,5,13,90,9,11
62,20,6,14,116,13,16
47,13,3,10,145,21,18
40,7,1,6,133,30,10
35,4,0,4,123,34,0
35,4,0,4,117,35,0
36,4,0,4,111,35,0
37,5,0,5,99,35,0
41,6,0,6,88,33,0
45,6,0,6,79,33,0
47,6,0,6,72,34,0
51,8,0,8,62,31,0
51,12,1,11,57,26,0
51,12,0,12,54,24,0
50,12,0,12,52,25,0
49,6,0,6,51,26,0
50,6,0,6,48,28,1
52,6,0,6,45,27,1
51,5,0,5,43,24,0
46,5,0,5,47,28,0
40,4,0,4,52,33,0
37,5,0,5,52,32,3
37,5,0,5,52,31,2
35,8,0,8,55,31,2
33,11,1,10,65,29,5
27,8,1,7,81,31,13
26,6,1,5,93,32,11
24,4,0,4,97,33,9
26,3,0,3,99,33,0
26,3,0,3,99,34,5
25,3,0,3,98,33,4
27,3,0,3,92,32,5
31,4,0,4,81,32,0
32,6,0,6,74,29,0
35,8,0,8,69,26,0
37,11,0,11,61,27,0
41,12,0,12,54,25,0
44,13,0,13,47,24,1
45,13,0,13,43,25,1
45,16,1,15,41,25,1
47,12,0,12,41,25,2
48,6,0,6,40,27,0
48,5,0,5,39,26,5
48,5,0,5,36,28,2
51,5,0,5,30,27,2
52,6,0,6,27,26,3
53,7,0,7,26,25,2
54,12,1,11,26,19,4
49,12,2,10,40,20,11
44,11,2,9,66,22,23
32,6,1,5,93,23,30
28,3,0,3,102,28,27
31,4,0,4,97,33,20
27,3,0,3,108,34,11
25,3,0,3,112,33,8
33,4,0,4,100,33,9
40,7,0,7,86,32,3
44,17,2,15,83,29,0
46,27,4,23,82,24,4
48,22,1,21,80,19,14
49,16,0,16,77,20,17
49,16,0,16,77,23,14
49,15,0,15,77,17,12
52,12,0,12,73,19,13
54,17,0,17,67,12,12
53,16.30911886,3.09833997,13.21077889,60,12,17
53,16.30911886,3.09833997,13.21077889,56,10,29
52,12,0,12,55,12,18
54,12,0,12,56,10,13
55,12,0,12,55,5,13
56,13,0,13,54,4,13
54,15,1,14,56,7,12
60,15,1,14,57,10,15
67,16.30854474,3.097834808,13.21070993,55,11,18
67,15,2,13,60,24.73585071,16
74,13,2,11,59,18,18
72,13,1,12,64,19,17
71,15,2,13,70,17,21
67,14,2,12,75,17,26
68,18,1,17,75,19,23
69,22,1,21,74,18,16
70,26,1,25,73,14,11
69,33,4,29,73,9,13
73,43,9,34,69,1,14
74,63,27,36,67,1,18
74,55,19,36,67,1,18
77,44,11,33,65,0,15
76,42,11,31,65,0,18
79,33,5,28,61,1,19
79,30,3,27,61,1,17
80,22,1,21,58,1,21
82,18,0,18,56,1,24
82,14,0,14,57,2,23
82,14,0,14,60,3,21
81,17,1,16,56,3,23
81,16,2,14,59,5,15
77,15,4,11,67,4,23
69,19,7,12,93,6,29
61,19,6,13,118,8,40
57,17,5,12,131,11,31
59,11,2,9,140,17,22
43,9,1,8,162,20,27
27,6,0,6,144,32,6
25,5,0,5,111,33,12.18724309
29,4,0,4,90,29,0
28,4,0,4,78,29,0
29,4,0,4,65,32,0
29,3,0,3,56,36,0
31,3,0,3,51,37,0
33,3,0,3,46,38,0
32,3,0,3,45,39,0
31,3,0,3,44,39,3
34,3,0,3,40,39,1
36,3,0,3,37,38,4
39,2,0,2,36,38,7
39,2,0,2,37,36,5
38,2,0,2,41,36,6
40,3,0,3,35,34,8
43,4,0,4,29,30,9
45,8,0,8,27,29,4
40,7,0,7,39,27,2
38,5,0,5,52,28,10
30,4,0,4,72,30,14
30,5,1,4,85,31,22
30,4,0,4,82,32,19
28,3,0,3,89,34,10
26,3,0,3,103,32,11
30,5,0,5,90,32,8
33,8,0,8,84,33,0
38,12,0,12,77,29,0
42,23,1,22,71,23,0
46,32,2,30,69,13,2
49,38,4,34,66,8,5
55,52,13,39,53,3,8
53,58,18,40,53,0,11
51,47,12,35,57,3,9
54,56,21,35,46,6,7
54,51,20,31,41,9,6
55,33,6,27,36,15,4
57,25,2,23,31,11,5
55,26,3,23,34,15,4
58,25,4,21,28,11,6
59,32,12,20,25,3,5
60,43,21,22,29,4,3
51,22,6,16,53,12,13
43,7,1,6,76,23,23
40,7,1,6,87,26,19
38,7,1,6,89,28,6
37,7,1,6,94,30,0
33,7,1,6,108,29,0
28,5,0,5,128,33,25
33,5,0,5,109,31,19
37,8,0,8,97,28,3
42,20,1,19,85,20,0
45,36,4,32,75,8,0
49,41,6,35,68,2,0
52,56,18,38,64,1,5
54,27,2,25,59,2,11
57,34,4,30,53,6,9
60,29,4,25,46,1,8
61,22,1,21,42,7,7
60,21,1,20,34,11,5
61,16,0,16,29,14,3
63,11,0,11,24,12,3
63,8,0,8,21,16,2
65,9,0,9,18,15,4
67,13,1,12,15,9,3
67,18,3,15,17,10,4
60,13,3,10,33,10,7
50,13,4,9,59,16,19
44,11,3,8,86,19,21
38,9,2,7,106,21,25
39,10,2,8,106,22,24
34,8,1,7,120,26,23
33,6,0,6,126,32,16
38,9,0,9,116,32,10
43,16,0,16,101,24,0
50,28,1,27,88,6,0
54,47,9,38,78,0,0
58,72,29,43,71,0,5
60,93,50,43,66,0,10
61,78,36,42,61,0,12
60,75,33,42,56,0,15
62,57,17,40,48,0,17
64,43,10,33,41,1,13
66,21,1,20,39,6,10
66,15,0,15,36,7,9
63,12,0,12,38,15,5
61,8,0,8,37,21,6
62,8,0,8,33,22,1
56,12,1,11,39,23,1
52,17,2,15,46,24,0
42,19,4,15,70,27,6
35,10,2,8,85,32,14
29,4,0,4,101,34,5
26,3,0,3,106,34,8
27,4,0,4,107,35,8
27,3,0,3,109,35,1
27,4,0,4,109,35,1
26,4,0,4,106,34,7
29,8,0,8,94,31,8
33,34,4,30,88,15,0
38,36,5,31,81,10,3
44,20,1,19,73,18,5
46,24,1,23,68,18,8
49,25,1,24,64,18,9
49,9,0,9,64,27,14
70,5,0,5,39,32,6
79,3,0,3,34,34,0
80,4,0,4,32,30,0
82,4,0,4,28,28,0
83,7,0,7,24,25,2
76,7,0,7,26,24,3
70,4,0,4,23,26,1
67,6,0,6,24,25,1
63,6,0,6,33,27,2
59,6,1,5,44,29,6
46,6,1,5,69,30,14
32,4,0,4,84,34,14
29,3,0,3,88,36,6
30,2,0,2,88,36,2
29,2,0,2,91,36,5
29,3,0,3,93,36,6
31,3,0,3,83,36,4
35,4,0,4,72,35,0
39,6,0,6,63,34,0
40,5,0,5,59,33,0
41,8,0,8,57,32,0
45,10,0,10,50,28,0
49,24,2,22,44,26,4
52,25,1,24,38,20,1
51,33,3,30,37,20,2
51,34,5,29,37,19,3
53,16.31723967,3.099908814,13.21733086,29,12,2
52,16.31723967,3.099908814,13.21733086,29,19,3
53,12,0,12,24,17,4
52,12,0,12,25,16,2
53,20,1,19,26,15,4
54,24,2,22,25,10,5
55,42,13,29,25,9,6
48,32,10,22,43,8,12
37,16.31857557,3.100133011,13.21844256,72,18,24
32,13,3,10,90,24.70983172,28
28,12,3,9,104,25,17
29,6,1,5,109,27,1
27,5,0,5,112,27,6
26,5,0,5,120,27,8
31,6,0,6,102,25,9
34,11,0,11,88,19,0
35,32,3,29,88,10,0
36,50,10,40,87,8,4
36,48,8,40,83,7,6
37,23,1,22,78,13,3
40,28,2,26,69,19,5
42,40,4,36,62,16,2
46,26,1,25,56,14,2
46,17,1,16,53,18,7
50,13,0,13,44,18,8
52,9,0,9,39,14,4
56,13,0,13,34,3,3
56,28,2,26,32,1,7
56,37,6,31,33,2,11
58,37,7,30,31,0,10
57,46,17,29,34,1,10
53,40,16,24,41,3,13
46,32,10,22,59,7,18
45,28,9,19,69,13,16
44,20,4,16,80,11,20
47,18,2,16,81,10,21
51,16,1,15,83,14,18
62,17,1,16,74,13,11
71,19,1,18,72,7,10
78,19,1,18,70,6,11
77,14,0,14,62,8,6
81,20,1,19,57,5,16
86,33,3,30,52,9,17
89,17,1,16,47,15,13
89,14,0,14,44,16,7
90,13,1,12,41,17,7
90,10,0,10,41,17,8
91,9,0,9,39,18,8
91,9,0,9,40,18,5
90,10,0,10,41,16,6
89,11,0,11,41,14,6
89,11,0,11,42,9,10
90,13,0,13,42,2,13
90,16,1,15,43,4,15
90,18,1,17,43,2,14
91,23,4,19,45,0,25
92,27,5,22,43,1,24
91,27,7,20,48,4,17
92,26,5,21,47,7,12
90,26,8,18,62,9,4
88,24,7,17,65,9,7
85,24,6,18,71,9,13
84,26,5,21,73,8,13
85,27,3,24,73,4,11
86,36,6,30,72,2,6
87,49,19,30,66,1,7
89,52,21,31,65,1,10
91,31,4,27,68,1,14
93,30,2,28,65,1,16
94,36,6,30,65,1,12
94,47,16,31,61,0,12
88,58,26,32,71,0,12
45,24,6,18,116,16,8
42,6,0,6,116,25,7
51,5,0,5,99,24,4
50,4,0,4,94,25,0
46,5,0,5,94,25,0
47,6,0,6,90,24,0
44,6,0,6,92,24,0
37,8,1,7,106,26,4
32,7,1,6,124,27,7
29,6,1,5,136,28,12
27,5,0,5,137,31,10
26,5,0,5,138,32,5
26,4,0,4,141,33,3
25,4,0,4,141,34,3
29,5,0,5,130,34,1
33,7,0,7,117,30,0
31,12,0,12,114,27,0
34,19,1,18,107,24,0
38,21,1,20,104,18,0
42,17,1,16,96,24,3
48,14,0,14,91,22,3
50,10,0,10,84,23,0
52,6,0,6,80,27,0
50,6,0,6,77,26,2
53,6,0,6,69,20,0
57,10,0,10,57,13,0
60,15,0,15,51,5,5
62,16,0,16,48,4,4
60,24,1,23,51,0,3
63,33,4,29,49,0,8
63,36,10,26,46,3,7
62,30,9,21,52,2,8
51,19,5,14,84,5,14
45,10,2,8,106,10,32
42,8,1,7,113,12,30
43,8,1,7,106,20,18
39,8,1,7,115,24,16
36,6,0,6,129,28,12
47,6,0,6,105,30,2
51,6,0,6,93,30,0
56,19,3,16,82,27,0
59,17,1,16,76,24,0
62,29,2,27,72,20,0
64,44,8,36,66,17,3
66,44,10,34,61,12,5
68,30,2,28,58,8,6
69,32,3,29,52,7,7
68,19,0,19,49,6,5
69,19,0,19,49,5,4
70,17,0,17,50,2,6
68,22,0,22,45,3,10
69,24,1,23,42,1,6
68,29,2,27,43,1,10
68,31,4,27,44,1,12
69,31,6,25,46,1,7
65,39,15,24,52,3,10
60,34,11,23,57,4,15
59,38,14,24,61,6,23
51,32,12,20,82,10,21
51,25,7,18,84,15,30
48,22,5,17,96,16,18
46,17,3,14,109,16,29
50,16,1,15,104,18,25
54,19,1,18,93,13,14
57,33,3,30,82,9,2
58,29,2,27,78,12,3
61,26,1,25,70,2,15
63,30,2,28,64,1,18
65,43,7,36,59,3,18
69,33,4,29,53,0,25
72,28,2,26,45,1,21
74,22,1,21,41,0,18
76,25,2,23,37,0,19
76,27,2,25,34,0,23
77,22,1,21,31,0,19
76,21,1,20,30,0,17
73,22,2,20,33,0,16
74,24,4,20,31,0,18
71,28,6,22,37,1,17
68,33,11,22,46,5,17
62,28,8,20,58,8,24
57,21,4,17,69,12,26
58,19,3,16,73,15,16
55,14,2,12,82,18,23
52,16,2,14,87,23,29
53,13,1,12,91,23,24
57,8,0,8,90,25,22
59,10,0,10,86,25,13
61,15,1,14,84,25,9
61,17,0,17,81,20,9
64,15,0,15,78,16,16
66,16,0,16,78,17,15
67,23,1,22,76,19,13
68,27,1,26,70,17,11
67,31,2,29,72,17,12
65,26,1,25,70,11,14
66,16.34128793,3.100527321,13.24076061,67,7,18
68,16.34128793,3.100527321,13.24076061,65,4,22
68,20,0,20,66,3,21
69,16,0,16,66,3,22
70,18,0,18,64,1,24
69,22,1,21,65,1,20
69,26,6,20,60,4,13
66,23,8,15,67,6,16
56,17,5,12,91,12,25
49,12,2,10,112,16,31
44,11,2,9,122,22,35
41,13,2,11,120,28,32
36,9,1,8,127,33,24
34,11,1,10,134,37,20
38,19,1,18,123,34,6
37,15,0,15,114,33,5
41,44,4,40,103,19,0
53,39,5,34,97,19,4
68,12,0,12,89,29,5
70,11,0,11,85,28,3
72,9,0,9,78,28,1
76,7,0,7,72,29,2
77,8,0,8,67,23,3
71,9,0,9,64,19,6
72,6,0,6,55,23,2
72,6,0,6,53,23,0
73,9,0,9,50,22,1
73,10,0,10,49,19,2
74,15,0,15,46,16,4
75,22,1,21,45,7,5
75,33,6,27,47,4,6
70,40,14,26,60,8,8
57,16.34194338,3.099502779,13.2424406,91,12,22
51,16,4,12,112,24.64520977,12.15592599
50,11,2,9,118,19,22
48,9,1,8,118,22,18
45,9,1,8,126,27,17
43,8,0,8,127,28,14
40,9,0,9,124,32,3
48,13,0,13,115,25,11
51,27,3,24,112,15,1
56,29,3,26,106,14,3
61,30,4,26,101,18,9
64,23,1,22,95,12,10
66,32,2,30,94,9,11
66,28,1,27,93,9,16
67,28,1,27,88,13,17
71,26,1,25,79,7,16
73,15,0,15,81,13,15
80,12,0,12,77,15,13
85,13,0,13,71,3,10
87,21,0,21,69,0,17
89,13,0,13,68,0,17
90,13,0,13,70,0,15
89,14,1,13,67,1,13
88,21,3,18,64,0,11
89,22,4,18,64,4,7
87,23,5,18,64,5,5
85,21,3,18,67,7,3
79,17,3,14,74,10,6
74,13,2,11,83,17,8
63,12,2,10,92,22,10
66,10,1,9,88,22,24
68,12,0,12,84,21,14
66,25,1,24,81,14,0
56,30,3,27,82,11,0
48,14,0,14,79,22,0
45,9,0,9,77,25,0
49,7,0,7,68,26,0
50,7,0,7,62,27,0
49,9,0,9,57,25,1
50,9,0,9,51,25,0
45,5,0,5,56,31,0
44,4,0,4,51,32,0
43,5,0,5,50,29,0
41,7,0,7,50,25,3
42,9,0,9,48,20,3
47,14,0,14,41,20,3
48,15,1,14,43,16,2
40,25,6,19,59,14,6
33,14,3,11,79,20,17
29,8,1,7,92,24,9
27,7,1,6,100,24,13
29,7,1,6,99,25,13
30,6,0,6,96,25,5
31,7,0,7,96,25,5
32,8,0,8,89,21,4
33,14,0,14,88,17,1
37,34,3,31,86,5,0
40,37,4,33,82,2,0
42,39,4,35,76,4,6
41,49,9,40,73,2,11
47,62,19,43,67,0,9
55,45,9,36,53,0,11
59,33,3,30,53,0,11
60,31,2,29,49,0,10
60,27,1,26,45,5,12
59,19,0,19,44,5,9
55,17,0,17,47,9,8
53,19,0,19,47,6,8
57,22,1,21,36,4,9
55,26,2,24,37,3,6
55,27,4,23,40,4,6
54,32,9,23,47,6,8
49,35,13,22,62,7,12
44,23,7,16,82,9,19
42,15,4,11,95,13,26
48,13,3,10,102,17,25
44,11,2,9,108,24,18
45,11,2,9,107,25,9
46,11,2,9,99,25,1
47,11,1,10,92,28,0
50,18,2,16,84,23,0
53,15,0,15,81,20,2
54,21,2,19,79,21,2
54,14,0,14,79,21,5
53,13,0,13,78,20,4
55,12,0,12,76,20,6
54,9,0,9,73,22,3
50,7,0,7,71,21,1
52,6,0,6,66,17,3
50,6,0,6,68,21,2
55,5,0,5,65,20,0
58,6,0,6,58,20,2
58,6,0,6,53,15,4
64,8,0,8,48,16,1
68,7,0,7,42,26,4
70,6,0,6,38,26,2
78,7,0,7,28,29,2
82,6,0,6,22,29,3
82,10,1,9,23,28,1
79,9,0,9,23,29,4
73,8,0,8,32,29,5
70,7,0,7,40,32,6
72,6,0,6,40,31,6
73,7,0,7,41,28,12
67,8,0,8,45,30,6
74,10,0,10,44,24,8
71,11,0,11,43,21,11
67,7,0,7,45,28,7
68,8,0,8,45,29,7
66,8,0,8,47,22,10
74,12,0,12,44,18,12
76,13,0,13,41,13,11
74,10,0,10,41,13,13
72,8,0,8,39,17,13
68,9,0,9,39,19,11
67,10,0,10,34,20,11
69,14,0,14,28,15,9
65,20,2,18,26,18,7
65,30,8,22,29,9,5
59,17,3,14,43,15,11
40,7,1,6,73,26,27
38,4,0,4,95,33,25
35,5,0,5,106,34,22
36,5,0,5,95,34,18
34,7,1,6,100,35,13
33,9,1,8,96,35,9
36,8,0,8,93,35,6
37,10,0,10,87,33,0
36,22,0,22,86,26,0
46,27,1,26,85,21,0
46,18,1,17,84,29,4
48,17,0,17,88,26,3
53,23,1,22,84,25,9
60,19,0,19,83,23,7
63,31,1,30,69,17,7
64,32,2,30,58,3,8
65,16.33941878,3.092830527,13.24658826,49,2,6
66,16.33941878,3.092830527,13.24658826,39,0,7
68,34,3,31,32,1,10
65,24,1,23,31,0,12
66,34,7,27,30,1,9
66,56,24,32,26,1,13
68,67,35,32,28,1,12
61,61,32,29,45,2,16
50,16.34475582,3.095332941,13.24942288,76,5,29
39,33,12,21,105,24.61326396,28
33,32,10,22,123,14,28
32,23,5,18,123,24,26
28,18,3,15,134,30,19
25,15,2,13,142,36,18
28,15,1,14,126,35,13
31,18,0,18,114,30,0
38,35,1,34,105,17,1
41,97,37,60,98,5,0
44,99,41,58,88,1,0
51,143,82,61,79,1,8
55,169,108,61,74,1,14
52,138,78,60,75,1,14
52,63,12,51,68,1,12
54,49,4,45,62,1,8
58,46,4,42,54,0,11
59,46,7,39,53,0,11
57,40,4,36,55,0,10
46,30,1,29,65,5,11
42,16,0,16,72,17,4
43,11,0,11,67,27,3
38,13,1,12,71,24,3
40,13,2,11,72,20,7
32,12,2,10,93,24,21
30,7,1,6,101,29,5
29,5,0,5,111,31,4
27,4,0,4,102,32,6
25,4,0,4,101,33,4
24,4,0,4,101,36,8
26,4,0,4,90,36,9
27,5,0,5,82,34,1
29,7,0,7,75,30,0
31,8,0,8,69,29,0
33,8,0,8,64,29,0
35,7,0,7,59,32,0
35,8,0,8,55,31,1
36,7,0,7,52,32,3
39,9,0,9,44,29,6
41,10,0,10,38,26,8
44,11,0,11,33,26,7
44,13,0,13,30,25,7
47,17,0,17,25,17,11
49,22,0,22,23,8,8
53,20,0,20,27,8,10
52,38,3,35,23,0,12
50,49,12,37,26,0,12
50,56,21,35,29,1,15
51,52,19,33,37,5,16
48,43,13,30,39,8,21
45,33,6,27,45,8,23
43,37,8,29,51,10,25
42,27,3,24,56,10,24
41,27,4,23,59,14,29
41,26,3,23,63,12,26
44,27,1,26,61,13,28
46,28,1,27,59,11,29
48,37,2,35,60,5,31
50,42,4,38,60,3,31
51,45,5,40,59,0,35
51,51,8,43,60,0,29
53,58,15,43,60,0,29
55,68,22,46,56,0,29
55,65,20,45,55,0,28
57,57,15,42,52,0,25
59,59,17,42,48,0,26
60,57,17,40,44,0,25
62,56,19,37,43,0,32
61,67,29,38,46,0,36
61,97,57,40,47,0,36
67,90,52,38,44,1,30
70,71,37,34,48,0,38
75,82,47,35,51,1,33
77,52,22,30,52,1,32
74,39,13,26,65,3,32
70,36,9,27,68,4,34
78,44,10,34,62,0,28
84,52,13,39,61,0,20
87,52,12,40,61,0,24
88,47,8,39,61,0,23
88,57,18,39,63,0,28
84,53,16,37,66,0,31
84,51,16,35,70,0,33
83,50,15,35,75,0,32
83,45,10,35,78,0,26
77,33,3,30,82,2,20
77,33,3,30,82,2,21
76,31,2,29,82,1,18
76,29,2,27,82,0,20
77,31,3,28,83,0,14
77,32,4,28,83,0,18
79,30,4,26,79,0,19
78,28,3,25,78,0,16
78,56,25,31,71,0,19
80,73,41,32,67,0,20
76,66,37,29,85,1,23
67,39,15,24,105,4,38
64,24,6,18,112,9,33
60,14,2,12,125,12,19
59,15,2,13,127,17,18
59,14,2,12,132,20,13
60,16,2,14,134,20,15
59,19,2,17,137,16,13
62,25,2,23,127,12,13
65,42,3,39,121,1,6
68,56,10,46,116,0,6
67,80,29,51,112,0,13
45,61,15,46,104,4,13
45,17,0,17,95,24,0
42,13,0,13,90,26,0
40,11,0,11,84,29,0
45,7,0,7,73,30,0
44,7,0,7,67,28,0
41,6,0,6,64,30,0
40,5,0,5,65,32,3
44,6,0,6,60,31,4
44,11,0,11,58,24,6
45,17,0,17,59,18,8
47,13,1,12,59,17,8
42,10,1,9,62,23,11
38,8,1,7,69,24,8
33,7,1,6,83,26,13
30,7,1,6,96,28,21
34,7,1,6,96,31,23
36,9,1,8,96,32,12
37,9,1,8,94,30,6
40,9,0,9,91,28,0
48,12,0,12,88,27,2
48,20,2,18,82,24,3
48,15,0,15,82,24,7
48,14,0,14,81,27,2
48,14,1,13,80,30,4
50,17,1,16,78,26,7
48,13,0,13,76,23,10
48,13,0,13,72,21,9
46,15,0,15,68,23,10
50,11,0,11,67,20,14
53,8,0,8,62,17,16
52,12,0,12,58,17,13
65,10,0,10,53,18,20
77,4,0,4,42,31,11
82,5,0,5,31,28,3
85,8,0,8,31,27,4
82,9,0,9,34,32,4
77,8,1,7,40,33,1
74,10,1,9,46,28,8
70,10,1,9,52,28,10
68,12,1,11,60,27,9
61,15,2,13,67,26,8
51,13,1,12,71,26,10
54,12,1,11,73,27,12
55,12,0,12,70,25,7
59,23,1,22,64,19,4
61,30,1,29,59,11,4
64,37,4,33,55,7,6
64,38,3,35,51,5,13
65,52,13,39,48,7,12
65,48,10,38,45,8,16
66,41,8,33,46,9,22
68,29,1,28,43,2,25
69,16.41621333,3.119981264,13.29623206,42,2,25
70,16.41621333,3.119981264,13.29623206,38,1,24
69,26,1,25,39,3,26
73,32,5,27,36,2,31
75,33,7,26,34,2,29
74,30,3,27,33,2,30
70,23,2,21,32,2,32
67,23,3,20,37,2,38
59,16.41825739,3.120049301,13.29820809,42,24.56081262,39
55,47,17,30,51,4,28
55,30,6,24,56,4,27
55,33,7,26,61,2,24
56,31,6,25,64,4,31
56,27,3,24,62,4,31
55,36,6,30,61,4,31
57,14,0,14,58,3,29
56,19,1,18,63,3,29
57,16,1,15,64,12,14
58,15,1,14,62,18,7
61,11,0,11,60,24,7
73,7,0,7,47,31,5
77,6,0,6,43,28,1
82,5,0,5,37,28,0
87,5,0,5,15,28,0
90,5,0,5,17,27,0
90,6,0,6,14,26,0
91,5,0,5,15,24,8
91,5,0,5,21,24,7
91,7,0,7,23,20,7
91,9,0,9,27,16,7
91,9,0,9,31,16,7
91,12,1,11,36,17,5
91,12,1,11,41,19,6
91,12,1,11,46,20,5
91,11,1,10,49,18,7
91,11,1,10,52,18,7
92,10,1,9,57,17,4
92,10,1,9,60,18,4
92,13,1,12,63,18,6
93,15,0,15,64,15,4
93,19,1,18,64,14,5
93,18,1,17,66,15,1
94,14,0,14,68,16,2
94,13,0,13,70,15,2
94,15,1,14,72,17,5
94,12,0,12,73,19,3
94,12,1,11,74,22,4
94,6,0,6,81,21,0
94,5,0,5,80,23,3
94,7,0,7,74,26,0
94,5,0,5,78,28,0
91,5,0,5,76,29,0
89,6,0,6,83,26,0
89,6,0,6,84,27,4
86,10,0,10,94,19,3
85,13,1,12,101,17,6
77,23,4,19,117,14,9
63,23,6,17,150,17,11
51,16,4,12,166,21,31
51,12,2,10,166,24,24
47,14,2,12,176,26,26
49,24,4,20,183,25,8
55,26,3,23,171,22,0
62,24,2,22,157,21,0
66,26,1,25,149,18,0
69,39,3,36,144,10,0
70,53,10,43,137,2,0
75,42,6,36,125,1,8
70,30,2,28,115,7,5
69,31,3,28,113,7,2
72,24,1,23,106,7,4
71,20,1,19,103,6,6
66,17,0,17,104,13,3
61,13,0,13,102,8,4
58,11,0,11,100,15,0
59,9,0,9,97,14,4
63,13,0,13,89,2,0
64,37,10,27,85,0,2
64,55,23,32,88,1,0
55,40,16,24,103,3,13
47,31,11,20,132,9,28
49,32,10,22,140,13,29
47,54,20,34,150,11,27
40,53,19,34,153,12,17
28,38,11,27,169,21,4
34,25,5,20,167,24,9
34,18,2,16,159,28,4
38,20,1,19,146,27,0
46,37,2,35,136,12,0
36,44,5,39,134,8,0
37,31,2,29,123,13,0
38,13,0,13,116,24,0
44,8,0,8,104,27,0
47,7,0,7,97,26,0
49,5,0,5,89,28,0
43,6,0,6,97,28,0
44,4,0,4,92,29,0
40,3,0,3,90,31,0
39,3,0,3,87,32,0
37,4,0,4,85,30,0
37,5,0,5,81,30,0
37,6,0,6,76,28,0
38,8,0,8,77,27,0
32,9,1,8,85,28,1
29,7,1,6,97,30,5
23,6,1,5,109,31,2
23,4,0,4,107,32,8
22,4,0,4,109,33,1
23,3,0,3,109,34,3
21,3,0,3,103,35,2
25,3,0,3,95,35,0
29,4,0,4,83,34,0
32,4,0,4,73,33,0
32,5,0,5,69,33,0
36,7,0,7,62,31,0
38,7,0,7,59,31,0
38,8,0,8,57,27,0
37,9,0,9,57,27,1
41,11,0,11,50,25,2
42,13,0,13,47,23,3
41,15,0,15,46,20,0
42,16,0,16,41,18,3
47,10,0,10,35,9,2
46,11,0,11,35,12,2
49,15,0,15,31,5,2
51,19,1,18,28,10,2
50,43,12,31,34,5,1
44,24,6,18,53,7,11
32,21,6,15,94,9,27
26,16,4,12,111,23,22
24,5,1,4,116,26,0
24,3,0,3,116,29,2
23,5,1,4,118,33,1
23,5,1,4,125,35,1
23,4,0,4,117,34,3
25,6,1,5,105,34,0
27,6,0,6,94,30,0
30,9,0,9,85,26,0
33,11,0,11,78,24,0
37,25,1,24,70,24,0
38,35,3,32,66,22,0
41,17,1,16,59,23,2
44,9,0,9,53,23,0
46,9,0,9,50,22,0
48,8,0,8,48,19,1
50,7,0,7,43,26,0
51,6,0,6,38,26,0
49,6,0,6,37,27,0
40,9,0,9,43,27,2
34,8,0,8,49,30,1
35,13,1,12,50,26,6
32,11,1,10,66,28,9
30,8,1,7,93,29,21
27,5,0,5,104,32,22
23,3,0,3,122,33,18
25,3,0,3,121,34,11
23,2,0,2,125,34,6
22,2,0,2,126,36,13
25,4,0,4,117,37,10
31,6,0,6,110,36,0
34,11,0,11,101,37,4
37,15,0,15,90,31,0
39,17,0,17,87,26,5
43,21,0,21,82,22,12
44,30,1,29,85,22,11
45,31,1,30,84,17,17
51,18,0,18,69,14,16
48,12,0,12,63,23,13
51,16.41197631,3.11416661,13.2978097,61,23,7
48,16.41197631,3.11416661,13.2978097,61,23,9
49,7,0,7,59,20,9
51,15,0,15,54,12,12
53,20,0,20,50,11,6
55,23,1,22,50,8,7
52,27,4,23,54,6,11
47,26,5,21,62,7,11
40,24,7,17,80,10,14
35,20,5,15,105,13,24
33,30,9,21,119,16,33
35,42,13,29,122,18,34
36,39,9,30,140,21,28
33,31,4,27,145,24.54022662,20
31,21,2,19,140,34,13
34,18,0,18,133,30,6
36,25,0,25,127,24,4
41,29,0,29,121,12,8
43,58,9,49,113,3,13
48,82,26,56,101,1,15
51,69,16,53,96,1,21
44,63,14,49,95,7,22
42,47,5,42,88,20,15
45,21,0,21,81,21,7
45,22,1,21,74,13,7
42,26,1,25,71,22,7
44,12,0,12,69,20,6
40,7,0,7,68,20,9
39,9,0,9,64,24,2
40,27,3,24,59,20,1
41,39,8,31,58,16,3
43,17,3,14,74,14,12
35,9,1,8,94,18,18
32,6,0,6,98,20,13
29,5,0,5,107,24,10
29,5,0,5,107,26,10
28,7,1,6,115,28,4
26,5,0,5,109,31,1
42,7,0,7,103,32,4
46,11,0,11,94,29,0
50,15,2,13,84,28,0
52,21,2,19,78,25,0
52,22,1,21,77,23,3
56,28,2,26,70,19,7
60,26,1,25,64,11,8
63,27,1,26,58,13,9
66,30,2,28,53,7,6
68,28,1,27,47,3,6
67,20,0,20,47,1,9
66,22,0,22,44,4,6
65,20,0,20,42,4,8
63,23,0,23,45,4,8
64,33,5,28,44,3,11
63,72,40,32,42,0,14
62,85,52,33,48,0,13
55,58,26,32,73,2,20
42,44,16,28,103,10,38
32,16.43042699,3.117923528,13.31250346,121,13,34
24,16.43042699,3.117923528,13.31250346,128,19,26
19,31,7,24,135,28,20
16,24,4,20,144,34,21
16,13,1,12,153,41,18
16,11,1,10,142,41,0
24,8,0,8,117,39,0
28,7,0,7,95,36,0
25,8,0,8,79,33,0
36,8,0,8,65,30,0
27,12,1,11,56,30,0
26,8,0,8,49,32,0
29,6,0,6,43,31,0
32,6,0,6,36,29,1
33,6,0,6,34,29,1
31,6,0,6,32,28,2
30,5,0,5,29,27,4
30,5,0,5,26,29,3
31,6,0,6,23,28,2
32,7,0,7,18,25,0
31,8,0,8,17,24,0
31,10,1,9,18,28,0
27,9,1,8,28,29,1
22,7,1,6,42,30,7
19,16.42596916,3.116394989,13.30957417,47,32,7
17,16.42596916,3.116394989,13.30957417,52,29,6
13,16.42596916,3.116394989,13.30957417,49,30,8
16,5,1,4,54,31,13
15,5,1,4,51,32,7
20,5,0,5,40,31,2
23,6,1,5,31,30,3
24,6,0,6,23,27,0
24,7,0,7,20,30,0
28,6,0,6,15,30,0
31,13,1,12,10,25,1
32,16,1,15,5,24,2
32,10,0,10,0,23,4
35,10,0,10,0,26,0
40,10,0,10,0,26,2
42,10,0,10,0,25,4
44,12,0,12,0,21,1
48,13,0,13,0,19,3
46,13,0,13,0,12,4
51,25,2,23,0,9,4
46,46,14,32,0,3,6
47,62,28,34,0,4,5
39,39,12,27,0,7,13
30,14,3,11,25,16,21
27,16,4,12,38,22,20
27,15,3,12,42,22,21
25,15,3,12,53,20,15
26,15,3,12,64,23,19
25,20,4,16,74,21,17
31,28,5,23,68,18,11
38,36,4,32,60,14,10
42,43,3,40,58,6,7
44,37,4,33,48,0,1
46,41,5,36,42,0,9
49,35,3,32,35,1,14
51,33,3,30,32,0,19
53,37,3,34,28,0,19
55,44,6,38,28,0,18
46,32,1,31,26,0,22
45,29,1,28,21,0,19
46,31,1,30,16,0,16
43,34,2,32,17,1,21
45,36,4,32,19,0,19
47,46,14,32,18,0,20
48,57,23,34,14,0,19
47,48,16,32,18,1,18
43,49,20,29,35,3,24
34,40,16,24,60,7,37
31,32,11,21,83,12,37
26,24,7,17,104,17,29
27,12,2,10,108,29,29
25,9,1,8,124,35,20
25,6,0,6,123,40,12
23,6,0,6,122,40,1
26,8,0,8,114,38,0
39,9,0,9,96,40,0
33,17,3,14,85,37,0
34,8,0,8,74,31,0
39,6,0,6,61,34,0
35,6,0,6,48,31,0
37,7,0,7,39,29,0
39,7,0,7,33,31,0
41,7,0,7,26,30,2
44,10,0,10,18,27,3
43,8,0,8,16,28,5
45,7,0,7,12,26,6
41,6,0,6,21,32,5
36,5,0,5,18,32,3
34,4,0,4,15,34,0
28,5,0,5,22,34,1
26,4,0,4,29,34,3
22,3,0,3,46,35,6
17,2,0,2,58,35,5
17,2,0,2,65,35,7
18,2,0,2,65,33,3
17,2,0,2,71,32,5
17,2,0,2,69,32,5
19,2,0,2,64,32,1
22,3,0,3,53,33,1
23,4,0,4,45,33,0
26,5,0,5,39,33,0
28,7,0,7,35,31,3
30,9,0,9,30,31,1
32,10,0,10,28,31,2
35,8,0,8,23,31,0
37,8,0,8,18,31,1
38,7,0,7,14,29,2
41,16.42771907,3.115721924,13.31199714,10,27,2
45,16.42771907,3.115721924,13.31199714,5,25,1
48,9,0,9,3,19,3
50,14,0,14,0,15,3
49,24,1,23,0,10,6
48,38,7,31,0,4,8
47,46,16,30,2,5,11
44,41,12,29,17,3,18
36,16.42988852,3.116233185,13.31365533,36,8,19
29,22,6,16,66,24.52353366,21
28,17,4,13,79,18,30
28,14,3,11,79,21,25
26,19,4,15,95,24,18
25,22,4,18,100,26,18
26,22,3,19,96,23,11
30,22,1,21,78,21,11
35,37,4,33,70,12,1
39,39,2,37,63,9,0
40,59,11,48,58,2,4
38,74,24,50,59,0,9
39,58,22,36,62,10,13
44,8,0,8,56,29,0
46,6,0,6,50,31,0
47,6,0,6,46,32,0
47,7,0,7,42,28,0
50,8,0,8,34,25,1
52,9,0,9,29,26,1
53,14,0,14,22,19,1
53,21,1,20,20,15,2
55,31,4,27,15,12,2
54,32,8,24,21,11,3
40,16,3,13,48,13,12
31,12,2,10,73,30,25
25,7,1,6,88,35,19
21,4,0,4,101,36,4
21,3,0,3,106,36,0
20,3,0,3,112,35,9
21,3,0,3,118,36,8
21,4,0,4,115,36,14
23,5,0,5,104,35,11
26,12,1,11,96,33,0
29,26,3,23,86,25,0
33,15,0,15,79,20,0
42,20,1,19,72,21,3
39,48,6,42,66,19,8
38,61,13,48,57,12,7
40,58,14,44,51,7,9
43,42,5,37,42,9,6
47,23,0,23,33,10,6
47,18,0,18,29,11,6
49,20,0,20,28,9,10
50,17,0,17,24,7,8
53,25,1,24,17,6,12
54,38,6,32,14,2,11
52,49,19,30,18,4,13
46,43,18,25,37,6,19
35,34,12,22,76,11,33
29,25,7,18,98,14,49
29,30,8,22,116,18,38
32,35,10,25,123,17,33
31,45,12,33,143,18,27
37,41,9,32,153,21,29
34,20,2,18,160,33,9
40,12,0,12,146,38,4
43,21,0,21,140,29,0
42,17,0,17,117,7,1
41,42,3,39,106,4,11
41,49,3,46,104,7,21
42,47,3,44,102,8,30
43,44,2,42,102,4,32
41,43,2,41,98,1,36
42,38,1,37,93,5,34
38,39,1,38,89,2,28
40,37,1,36,88,2,22
44,36,1,35,86,0,24
43,42,3,39,86,0,26
46,45,7,38,85,0,24
49,55,18,37,84,0,22
50,39,7,32,83,0,26
53,43,10,33,83,0,24
65,48,15,33,76,1,22
58,34,8,26,92,9,16
44,31,9,22,127,15,26
38,24,6,18,146,23,41
40,22,4,18,169,27,55
39,23,3,20,182,30,39
45,40,6,34,169,21,21
53,43,3,40,151,12,13
58,63,7,56,145,3,16
60,66,9,57,145,1,2
75,25,1,24,132,14,7
79,18,1,17,120,19,7
84,20,1,19,115,17,1
83,24,2,22,112,12,4
86,28,3,25,117,7,10
86,32,5,27,116,4,16
74,27,2,25,112,5,16
81,28,4,24,103,1,12
84,37,12,25,90,1,15
83,41,16,25,88,0,6
80,46,23,23,86,0,8
79,70,45,25,85,0,14
79,84,57,27,82,0,17
78,87,55,32,85,0,17
69,87,49,38,106,0,25
57,66,33,33,138,4,35
51,49,15,34,154,10,43
47,39,8,31,157,15,39
53,46,8,38,159,21,19
55,40,4,36,157,22,5
55,37,2,35,151,23,4
57,35,2,33,147,17,5
62,29,3,26,143,10,8
65,30,3,27,137,5,6
68,34,2,32,131,1,8
69,45,5,40,127,1,9
72,50,7,43,122,1,10
75,64,23,41,115,1,25
76,69,31,38,111,1,12
70,59,18,41,107,0,15
71,44,9,35,101,2,14
70,23,1,22,93,4,14
74,23,1,22,90,6,12
68,23,2,21,92,8,15
70,31,7,24,86,9,14
65,24,2,22,89,5,11
61,27,5,22,97,9,10
55,22,5,17,114,13,18
45,16,3,13,134,15,25
39,18,3,15,148,21,19
37,16,2,14,156,25,19
37,17,2,15,158,31,19
36,17,2,15,161,34,15
47,20,1,19,160,36,12
48,25,1,24,156,34,2
51,31,1,30,154,33,7
52,26,0,26,147,30,12
57,23,3,20,140,26,11
60,21,1,20,135,28,2
64,23,1,22,125,21,7
66,27,1,26,122,19,9
66,33,2,31,120,16,13
69,37,4,33,113,13,12
73,35,4,31,106,6,11
75,23,1,22,98,10,6
76,22,1,21,93,3,9
70,25,1,24,89,0,17
66,22,1,21,86,4,21
66,16,0,16,83,8,14
65,16,0,16,85,4,17
64,19,2,17,87,6,19
73,20,3,17,90,8,16
78,25,5,20,88,7,19
84,26,5,21,86,7,21
89,27,6,21,89,7,20
89,21,3,18,94,6,25
89,30,6,24,91,5,26
89,26,4,22,93,5,30
89,25,3,22,96,5,34
90,28,4,24,97,4,33
91,33,7,26,96,2,38
92,9,0,9,101,5,34
92,7,0,7,102,26,14
91,7,0,7,100,22,5
91,7,0,7,99,26,3
92,7,0,7,97,24,0
91,9,0,9,96,22,0
91,7,0,7,97,19,0
91,16.49412586,3.129333215,13.36479264,95,15,7
91,16.49412586,3.129333215,13.36479264,93,13,7
90,6,0,6,94,15,7
89,5,0,5,94,16,6
89,8,0,8,95,12,4
90,13,1,12,96,8,4
90,15,3,12,101,6,5
88,15,4,11,105,5,14
85,16.4930392,3.129016432,13.36402277,105,3,16
84,29,14,15,118,5,9
68,11,3,8,144,13,17
62,7,1,6,147,21,28
63,7,1,6,144,24.46833244,12.12166635
62,5,0,5,134,24.46833244,12.12166635
63,5,0,5,127,29,12.12166635
64,8,0,8,119,28,12.12166635
48,19,1,18,122,24,12.12166635
36,19,1,18,117,26,12.12166635
65,17,0,17,106,24.46860065,12.12166635
72,21,0,21,91,24.46860065,12.12166635
74,17,0,17,83,24.46860065,12.12166635
70,9,0,9,67,24.46860065,12.12166635
70,5,0,5,60,24.46860065,12.12166635
70,7,0,7,58,24.46860065,12.12166635
72,7,0,7,52,24.46860065,12.12166635
70,7,0,7,50,24.46860065,12.12166635
56,3,0,3,47,24.46860065,12.12166635
53,6,0,6,50,24.46860065,12.12166635
51,15,0,15,50,24.46860065,12.12166635
54,25,1,24,47,24.46860065,12.12166635
45,31,6,25,58,24.46860065,12.12166635
36,16,3,13,72,24.46860065,12.12166635
27,12,3,9,90,24.46860065,12.12166635
26,7,1,6,105,24.46860065,12.12166635
21,7,1,6,112,24.46860065,12.12166635
22,6,1,5,113,24.46860065,12.12166635
18,5,0,5,117,32,12.12166635
19,5,0,5,115,33,11
20,5,0,5,112,34,4
21,5,0,5,98,33,0
24,6,0,6,87,33,0
27,8,0,8,80,31,0
28,9,0,9,76,29,0
28,7,0,7,69,31,1
33,7,0,7,64,31,0
36,8,0,8,57,29,0
36,7,0,7,55,30,1
35,7,0,7,52,27,2
34,7,0,7,53,29,2
35,7,0,7,50,29,2
36,10,0,10,48,25,3
34,8,0,8,55,26,0
37,10,0,10,49,21,0
40,17,1,16,43,16,4
42,20,3,17,46,14,5
39,14,3,11,63,20,10
32,11,2,9,89,26,11
31,10,2,8,98,28,11
29,11,2,9,107,27,18
27,9,1,8,120,30,23
26,9,1,8,119,37,21
25,9,1,8,126,38,12
25,9,1,8,123,39,9
27,8,0,8,117,35,10
31,12,0,12,111,33,0
41,18,0,18,100,25,0
46,21,1,20,95,28,0
49,35,4,31,90,20,2
50,52,10,42,89,15,7
54,61,16,45,80,5,7
59,44,6,38,73,3,10
62,30,1,29,68,4,10
65,24,1,23,63,4,7
66,28,1,27,50,2,6
55,23,1,22,44,8,6
54,24,1,23,43,7,6
53,25,1,24,45,2,8
53,33,5,28,43,3,9
50,39,13,26,52,8,11
47,34,13,21,67,11,15
41,29,10,19,110,16,26
42,24,6,18,115,20,26
38,19,4,15,130,25,23
38,15,2,13,132,32,27
38,12,1,11,132,35,18
39,13,1,12,130,35,5
41,12,0,12,124,32,2
45,12,0,12,121,33,3
58,9,0,9,111,35,6
62,12,1,11,101,36,0
64,11,1,10,96,36,0
62,10,0,10,96,36,3
62,8,0,8,96,36,3
62,6,0,6,93,37,4
65,5,0,5,87,37,3
64,6,0,6,84,33,4
65,8,0,8,75,28,6
62,8,0,8,72,27,5
63,8,0,8,70,23,4
64,9,0,9,65,18,6
59,13,0,13,63,12,4
61,22,1,21,59,12,7
53,21,3,18,65,13,7
47,12,2,10,82,22,16
35,8,1,7,114,29,24
33,6,1,5,124,31,19
34,5,0,5,129,33,19
33,7,1,6,135,35,16
34,9,1,8,134,39,13
36,10,1,9,139,43,13
37,13,1,12,137,44,1
39,17,0,17,130,41,8
46,23,1,22,117,34,3
50,16,2,14,109,32,0
55,16,1,15,102,31,0
58,19,1,18,99,26,5
61,25,2,23,96,19,8
63,23,1,22,93,15,13
67,25,1,24,101,12,12
67,28,1,27,99,13,12
67,30,1,29,96,3,16
74,32,1,31,90,1,14
75,40,4,36,83,2,12
79,29,1,28,80,6,9
83,24,1,23,75,3,10
83,26,2,24,75,4,12
79,32,8,24,81,10,15
76,34,10,24,104,14,24
70,43,10,33,120,14,32
53,27,4,23,141,21,18
43,10,1,9,155,38,11
42,9,0,9,159,42,19
43,9,1,8,174,42,13
42,9,1,8,179,42,21
45,9,0,9,172,42,12
47,9,0,9,170,40,9
53,10,0,10,165,40,2
75,9,0,9,151,40,3
81,8,0,8,153,34,2
79,9,0,9,152,28,7
79,18,0,18,141,28,14
66,11,0,11,127,29,7
54,9,0,9,119,32,3
48,6,0,6,112,36,0
36,4,0,4,107,41,0
27,3,0,3,104,45,5
26,3,0,3,98,46,7
28,3,0,3,92,44,10
30,4,0,4,87,41,12
29,7,0,7,86,37,13
28,12,1,11,96,33,17
29,12,1,11,109,34,27
24,19,3,16,137,35,40
19,8,1,7,147,39,34
20,3,0,3,144,38,9
18,3,0,3,144,37,0
16,3,0,3,142,37,0
15,3,0,3,140,38,2
18,3,0,3,131,39,4
19,3,0,3,116,39,3
25,4,0,4,99,38,3
25,5,0,5,92,38,0
27,4,0,4,84,37,4
29,5,0,5,79,36,5
31,5,0,5,77,35,10
31,5,0,5,74,37,6
32,4,0,4,70,38,12
31,5,0,5,68,38,10
31,16.4811191,3.121101355,13.36001775,66,38,11
31,16.4811191,3.121101355,13.36001775,65,36,10
30,7,0,7,66,37,13
33,8,0,8,61,33,10
35,11,0,11,59,29,10
36,15,0,15,58,24,12
35,17,2,15,73,26,13
32,11,2,9,97,29,22
25,7,1,6,121,35,28
26,5,0,5,138,37,23
29,6,0,6,141,38,29
30,8,1,7,144,40,29
34,10,1,9,146,41,15
31,9,1,8,148,44,16
33,8,0,8,150,45,4
38,10,0,10,140,44,13
43,15,0,15,130,39,5
48,19,0,19,125,30,0
52,21,0,21,120,24,4
55,26,1,25,115,29,7
57,28,1,27,111,24,7
61,39,3,36,104,12,13
63,39,4,35,101,7,13
57,31,2,29,98,9,13
47,29,1,28,92,17,14
46,15,0,15,85,21,16
45,14,0,14,80,27,15
46,15,0,15,77,27,13
47,17,0,17,74,21,14
49,33,4,29,74,7,17
49,46,14,32,80,5,20
49,40,14,26,91,12,28
43,25,6,19,119,16,36
43,17,2,15,135,24,46
43,17,1,16,137,33,31
41,22,1,21,135,32,19
38,33,3,30,137,24.48407065,21
39,30,2,28,137,24.48407065,23
46,29,2,27,136,21,28
50,12,0,12,132,16,22
52,17,1,16,127,29,23
55,26,3,23,122,32,21
59,19,2,17,116,34,20
66,9,0,9,104,36,20
72,7,0,7,100,28,17
80,6,0,6,94,27,14
87,7,0,7,89,27,18
88,6,0,6,89,27,14
87,5,0,5,88,31,10
87,4,0,4,86,34,8
86,4,0,4,85,36,11
84,5,0,5,84,38,10
83,6,0,6,83,39,10
80,7,0,7,82,38,7
79,8,0,8,80,37,6
81,7,0,7,81,30,9
81,7,0,7,81,25,9
80,8,0,8,82,23,10
78,7,0,7,84,24,8
74,7,0,7,87,25,13
71,7,0,7,91,27,10
71,8,0,8,94,24,12
68,8,0,8,93,27,15
67,9,0,9,94,28,9
68,16,2,14,91,30,9
66,20,2,18,89,28,9
68,16,1,15,88,28,10
67,16,1,15,86,27,10
66,15,0,15,81,24,9
67,11,0,11,78,28,10
71,7,0,7,71,30,8
72,8,0,8,67,28,5
68,7,0,7,62,27,9
70,8,0,8,55,25,10
72,7,0,7,50,21,8
67,12,0,12,47,21,11
69,13,0,13,40,20,7
75,26,3,23,40,7,7
60,33,9,24,54,9,12
48,14,3,11,70,23,18
40,16.47795107,3.116797244,13.36115383,87,31,15
38,9,2,7,98,31,9
37,6,1,5,98,30,11
36,7,1,6,101,33,9
20,5,1,4,109,33,7
19,3,0,3,113,36,1
21,5,0,5,102,34,0
23,4,0,4,83,35,5
28,5,0,5,70,35,0
27,6,0,6,63,35,0
30,6,0,6,56,34,0
35,8,0,8,46,28,0
38,11,1,10,42,30,1
40,13,0,13,42,32,2
44,11,0,11,36,30,2
48,7,0,7,29,28,4
48,7,0,7,27,27,3
50,8,0,8,25,28,2
52,7,0,7,24,26,2
55,12,0,12,19,24,2
55,27,4,23,18,22,3
57,29,4,25,18,17,3
53,25,6,19,27,13,4
41,14,3,11,50,19,20
31,11,3,8,77,27,21
31,9,2,7,88,26,14
29,9,2,7,100,26,17
25,7,1,6,115,28,16
23,5,1,4,117,33,10
23,7,1,6,117,35,2
27,5,0,5,104,35,2
30,15,1,14,97,32,0
29,14,0,14,95,29,0
35,14,1,13,85,26,0
38,18,3,15,80,28,0
41,14,0,14,79,25,1
42,15,0,15,77,23,7
44,15,0,15,77,22,8
46,14,0,14,75,22,9
47,15,0,15,75,26,9
51,10,0,10,74,25,9
52,11,0,11,72,29,6
53,10,0,10,69,25,8
56,10,0,10,63,17,10
56,14,0,14,56,13,9
54,19,1,18,56,10,6
52,21,3,18,60,12,7
51,24,6,18,65,14,13
49,20,6,14,85,15,15
47,16,4,12,114,17,22
48,11,2,9,122,24,36
44,9,1,8,132,32,32
40,7,1,6,139,36,20
45,9,1,8,137,38,21
45,9,1,8,130,36,4
57,10,1,9,124,35,0
62,7,0,7,114,35,0
66,10,1,9,108,34,0
68,11,2,9,103,34,0
69,6,0,6,101,33,0
75,7,0,7,99,30,2
80,8,0,8,93,26,3
80,8,0,8,90,24,2
81,8,0,8,89,25,5
81,8,0,8,87,21,6
79,11,0,11,87,18,6
77,8,0,8,82,16,9
77,10,0,10,76,15,10
77,12,0,12,71,17,9
78,17,1,16,70,14,7
74,15,2,13,78,12,12
63,10,2,8,100,16,23
47,7,1,6,134,24,27
39,6,1,5,149,31,27
33,5,0,5,158,38,31
29,5,0,5,166,41,31
25,5,0,5,172,43,13
29,5,0,5,179,46,10
31,8,0,8,167,52,5
31,9,0,9,160,53,1
35,14,1,13,152,49,2
55,13,2,11,133,39,0
57,9,0,9,123,40,0
55,10,0,10,121,36,0
55,12,0,12,117,34,3
55,6,0,6,115,36,4
58,5,0,5,109,37,3
58,3,0,3,106,37,0
57,16.4627063,3.111173096,13.3515332,103,38,2
70,16.4627063,3.111173096,13.3515332,94,38,2
75,3,0,3,88,36,0
72,4,0,4,84,34,0
74,5,0,5,80,33,2
77,6,0,6,74,29,1
72,7,0,7,72,27,2
81,9,1,8,67,23,4
87,10,1,9,63,22,1
87,11,1,10,63,24.49960638,1
88,11,1,10,63,24.49960638,3
89,11,1,10,64,23,4
90,9,1,8,68,22,4
89,11,1,10,71,22,7
88,12,1,11,73,19,5
87,12,0,12,75,19,11
86,16,1,15,75,18,9
87,19,1,18,75,16,8
87,21,1,20,74,17,6
87,19,1,18,75,17,11
87,17,1,16,75,14,10
86,16,1,15,76,11,6
85,16,0,16,75,9,11
85,15,0,15,73,8,9
86,16,0,16,68,8,8
86,18,1,17,64,9,7
87,21,2,19,59,4,7
89,19,1,18,63,2,7
71,27,4,23,65,7,7
84,45,22,23,56,2,9
63,36,14,22,76,8,12
50,16,4,12,99,17,21
39,13,3,10,128,23,20
27,11,2,9,151,28,11
23,9,1,8,159,33,11
23,16.46118596,3.110164699,13.35102126,168,33,10
18,5,0,5,176,37,9
17,5,0,5,172,39,12
18,10,1,9,170,40,8
29,28,2,26,150,34,10
39,18,0,18,140,37,0
48,16,2,14,121,40,0
50,10,0,10,113,38,0
48,10,0,10,111,36,0
50,11,0,11,111,35,0
54,6,0,6,108,38,2
55,6,0,6,104,38,4
61,5,0,5,101,36,2
64,5,0,5,98,33,2
64,4,0,4,97,33,4
64,4,0,4,95,34,4
63,4,0,4,96,34,3
64,6,0,6,93,26,2
64,10,0,10,93,22,2
66,10,0,10,89,16,3
66,15,2,13,93,16,7
66,13,1,12,98,15,7
76,12,1,11,91,15,10
84,19,2,17,86,16,6
86,22,4,18,87,16,8
86,20,3,17,89,15,10
86,18,3,15,90,15,10
85,15,1,14,93,17,12
85,16,1,15,92,15,13
87,17,1,16,89,13,16
87,17,1,16,87,17,12
86,15,1,14,86,17,11
86,15,1,14,86,16,14
87,18,1,17,86,14,16
88,15,0,15,84,11,14
89,18,0,18,83,12,8
90,16,0,16,82,11,11
90,14,0,14,80,13,11
90,12,0,12,81,14,9
88,13,0,13,81,13,12
87,13,0,13,80,12,13
86,14,0,14,77,8,11
86,22,3,19,77,3,11
81,38,15,23,87,4,14
47,26,7,19,101,15,14
39,13,1,12,112,30,2
34,10,1,9,117,36,6
30,7,0,7,112,39,6
18,4,0,4,128,38,4
18,4,0,4,124,39,5
19,4,0,4,120,38,4
17,5,0,5,119,37,6
22,5,0,5,106,37,8
21,5,0,5,95,38,0
30,7,0,7,83,36,0
33,9,0,9,74,33,0
36,12,0,12,68,31,0
28,10,0,10,73,36,3
33,7,0,7,64,32,3
33,8,0,8,61,26,7
36,9,0,9,56,27,5
33,12,0,12,57,26,5
30,8,0,8,59,41,6
30,8,0,8,58,42,8
31,7,0,7,55,41,8
34,11,0,11,47,26,13
32,16,0,16,53,21,9
33,16,2,14,62,32,8
26,12,2,10,87,35,22
24,7,1,6,105,40,16
22,6,1,5,114,40,10
20,5,0,5,131,38,14
17,4,0,4,143,39,17
19,4,0,4,144,41,16
19,5,0,5,147,42,16
19,5,0,5,145,43,20
21,6,0,6,133,43,13
23,9,0,9,119,38,0
24,12,0,12,109,35,0
25,13,0,13,99,29,0
27,15,0,15,88,30,0
30,18,0,18,81,29,3
33,20,0,20,77,23,3
37,18,0,18,72,21,4
40,13,0,13,67,24,6
42,5,0,5,69,22,9
47,5,0,5,66,21,9
47,7,0,7,65,16,8
43,15,0,15,59,21,6
50,16,0,16,59,18,4
53,19,1,18,57,14,9
59,23,2,21,58,10,10
62,24,4,20,60,15,11
59,13,2,11,77,20,12
58,9,1,8,82,29,20
55,9,1,8,87,33,17
50,7,1,6,96,33,12
46,6,1,5,104,36,12
45,4,0,4,100,40,8
46,6,0,6,97,40,2
51,6,0,6,91,40,4
56,10,1,9,87,40,3
55,12,1,11,86,38,7
61,6,0,6,83,41,6
68,5,0,5,78,43,8
69,5,0,5,76,39,8
75,6,0,6,69,36,7
83,6,0,6,65,38,3
85,4,0,4,61,37,2
86,4,0,4,61,36,6
85,4,0,4,62,36,9
86,4,0,4,60,35,8
83,4,0,4,59,37,8
84,4,0,4,59,34,9
86,5,0,5,59,33,9
86,5,0,5,61,31,8
87,7,0,7,62,30,11
88,9,1,8,65,29,10
87,8,1,7,68,28,11
87,9,1,8,74,28,13
85,9,1,8,81,27,13
83,8,1,7,85,26,18
81,6,0,6,88,27,18
82,7,0,7,90,29,11
84,10,0,10,91,29,9
83,11,0,11,90,28,6
83,12,1,11,92,26,8
83,9,0,9,92,23,5
81,9,0,9,89,23,7
80,6,0,6,81,22,5
81,7,0,7,78,23,7
79,6,0,6,80,26,0
80,5,0,5,80,27,3
78,16.43795191,3.100645337,13.33730658,83,27,1
80,16.43795191,3.100645337,13.33730658,80,18,2
80,5,0,5,82,17,10
80,7,0,7,81,19,6
80,9,0,9,80,19,7
80,10,0,10,84,15,6
76,15,2,13,92,17,4
74,13,2,11,100,17,6
70,17,4,13,119,14,10
67,13,3,10,139,24.50682106,14
64,10,2,8,152,20,20
62,16.4365343,3.100213585,13.33632072,169,21,25
59,6,1,5,183,26,21
56,4,0,4,191,29,23
55,4,0,4,196,31,14
61,5,0,5,178,32,0
67,8,1,7,167,31,0
80,15,2,13,153,28,0
80,12,1,11,145,22,0
82,8,0,8,135,25,0
85,7,0,7,129,29,0
88,5,0,5,127,28,0
89,5,0,5,128,29,3
90,5,0,5,128,28,5
92,4,0,4,127,26,7
92,5,0,5,126,23,1
91,6,0,6,128,17,3
91,8,0,8,130,14,7
91,13,0,13,130,10,9
91,15,1,14,131,8,11
91,15,2,13,133,13,6
92,13,2,11,135,12,9
91,16,3,13,138,8,5
90,16,4,12,148,7,5
89,16,3,13,154,11,12
87,18,3,15,164,9,15
87,26,4,22,164,9,16
90,27,3,24,159,10,12
90,44,10,34,159,8,11
90,44,7,37,159,6,18
91,19,1,18,155,18,8
93,20,3,17,155,22,2
93,11,0,11,162,25,0
92,9,0,9,171,27,4
86,11,0,11,171,20,7
88,6,0,6,173,23,6
83,7,0,7,179,27,13
88,7,0,7,153,12,13
92,15,0,15,148,6,4
93,14,0,14,146,7,2
92,14,0,14,144,3,3
89,21,1,20,146,2,4
64,23,1,22,144,6,6
54,14,1,13,143,19,0
45,10,1,9,150,23,0
37,8,1,7,163,30,4
33,6,1,5,176,34,5
31,4,0,4,184,36,7
28,5,0,5,196,37,7
28,5,0,5,199,40,12
26,5,0,5,208,43,18
25,6,0,6,203,46,13
26,8,0,8,195,48,5
37,10,0,10,185,44,0
39,20,1,19,179,39,9
28,31,3,28,169,36,0
28,8,0,8,155,42,0
30,8,0,8,147,40,0
29,6,0,6,134,36,0
31,4,0,4,119,37,0
33,4,0,4,107,34,0
33,4,0,4,99,37,0
34,3,0,3,94,38,0
35,4,0,4,90,38,0
35,4,0,4,86,38,0
35,4,0,4,82,36,0
35,6,0,6,79,32,2
34,6,0,6,82,31,1
28,6,0,6,94,33,6
25,6,1,5,109,37,15
24,5,0,5,126,36,13
22,4,0,4,133,36,14
21,4,0,4,151,37,13
19,4,0,4,161,39,19
22,12,3,9,156,43,24
25,9,1,8,155,45,17
24,8,0,8,161,46,0
34,10,0,10,141,47,10
48,10,1,9,130,38,2
55,10,1,9,118,39,0
58,8,0,8,113,36,0
58,9,0,9,110,34,0
59,11,0,11,111,36,5
62,11,0,11,110,36,4
64,8,0,8,106,32,8
65,13,0,13,99,29,9
68,13,0,13,89,16,10
68,16,0,16,81,8,7
68,14,0,14,78,10,5
67,18,0,18,79,6,9
68,24,1,23,79,2,11
67,39,10,29,84,2,10
63,31,8,23,97,5,19
57,30,8,22,113,12,25
52,27,6,21,131,20,26
45,39,10,29,145,26,31
44,24,4,20,152,27,26
38,20,3,17,154,33,20
36,7,0,7,173,44,15
33,16,2,14,178,42,15
30,30,7,23,174,44,23
38,21,1,20,168,41,0
38,22,0,22,164,37,0
40,36,3,33,158,31,5
48,22,0,22,149,27,8
51,34,1,33,137,19,9
54,48,4,44,130,5,9
58,67,18,49,122,2,13
57,49,7,42,113,7,19
58,26,0,26,109,13,23
68,8,0,8,102,29,22
68,3,0,3,94,42,9
67,2,0,2,90,42,1
67,3,0,3,88,41,4
66,4,0,4,86,40,4
62,3,0,3,88,40,5
58,4,0,4,89,39,6
71,4,0,4,78,39,7
76,5,0,5,72,35,4
78,5,0,5,63,37,3
79,3,0,3,53,37,1
82,5,0,5,43,34,0
85,7,0,7,33,34,1
86,7,0,7,19,32,0
89,12,0,12,20,27,0
90,11,0,11,21,26,1
89,9,0,9,22,27,3
90,10,0,10,24,25,5
90,10,0,10,31,28,6
89,9,0,9,36,28,8
88,11,0,11,36,28,11
88,9,0,9,35,27,6
87,9,0,9,34,26,5
86,10,0,10,35,21,4
86,11,0,11,35,23,6
87,12,0,12,37,17,7
88,15,0,15,33,9,5
88,16,0,16,31,6,8
87,21,2,19,28,4,8
76,24,6,18,31,11,10
63,12,2,10,43,20,5
60,11,3,8,66,24,15
56,9,2,7,79,24,22
44,9,2,7,94,27,22
41,4,0,4,103,32,21
39,4,0,4,102,38,15
34,4,0,4,120,39,8
33,6,0,6,114,43,20
35,7,0,7,118,43,4
41,10,0,10,106,42,0
46,13,1,12,99,40,0
48,7,0,7,90,41,0
54,9,0,9,84,40,0
57,9,0,9,79,36,0
60,11,0,11,75,33,3
60,12,0,12,77,28,4
60,21,1,20,77,24,8
69,22,0,22,59,16,11
71,16.42035543,3.091458551,13.32889688,54,17,4
72,16.42035543,3.091458551,13.32889688,49,15,2
72,12,0,12,47,10,4
73,14,0,14,44,11,7
73,17,0,17,42,10,7
75,25,4,21,46,2,8
71,25,7,18,55,9,9
62,21,7,14,77,17,16
48,12,3,9,108,24,30
33,8,1,7,117,24.51565245,27
23,16.42043145,3.091379808,13.32905164,130,35,11
27,4,0,4,116,38,3
32,4,0,4,114,39,0
29,3,0,3,111,39,0
28,4,0,4,100,39,0
30,4,0,4,83,40,0
31,5,0,5,70,39,0
33,5,0,5,60,38,0
35,4,0,4,50,37,0
36,4,0,4,45,36,0
38,4,0,4,43,37,0
39,4,0,4,41,37,7
39,4,0,4,40,37,5
37,4,0,4,39,36,3
33,5,0,5,41,35,4
39,8,0,8,32,34,6
37,10,0,10,32,32,5
39,9,0,9,29,28,2
43,26,1,25,23,18,4
46,34,6,28,26,10,5
39,23,5,18,40,17,14
32,10,2,8,61,25,24
27,12,2,10,81,28,21
25,9,1,8,94,30,19
27,15,3,12,97,29,16
27,14,2,12,103,32,2
30,14,2,12,106,33,5
33,16,2,14,115,35,9
36,12,1,11,125,38,12
44,9,0,9,113,40,10
49,12,0,12,105,36,0
50,18,1,17,101,33,0
50,23,2,21,106,29,0
49,24,1,23,106,34,5
48,16,0,16,105,33,11
45,12,0,12,106,41,11
50,15,0,15,94,38,11
61,29,0,29,76,10,12
61,34,1,33,67,2,5
60,33,1,32,64,3,7
59,38,3,35,64,2,8
57,37,3,34,67,1,10
56,43,5,38,72,3,12
52,40,4,36,83,11,12
46,32,7,25,98,19,12
40,17,3,14,127,28,22
33,12,2,10,152,34,21
26,10,1,9,164,37,28
22,6,0,6,171,40,24
22,6,0,6,174,43,31
25,13,1,12,181,42,11
25,15,1,14,179,47,3
24,15,1,14,179,51,9
26,12,0,12,170,56,8
27,17,0,17,164,53,3
31,30,1,29,156,45,0
38,42,2,40,147,28,1
46,44,2,42,140,21,8
52,67,10,57,136,11,14
54,58,8,50,119,6,16
61,33,1,32,109,15,16
62,24,1,23,104,15,15
66,22,0,22,90,7,17
67,22,0,22,83,21,10
62,17,0,17,80,19,11
59,20,0,20,76,5,9
55,25,1,24,74,6,15
56,33,6,27,75,6,12
49,31,8,23,92,9,21
41,27,7,20,118,16,27
38,22,5,17,145,26,31
36,18,3,15,169,31,41
41,31,5,26,177,31,37
39,23,3,20,194,41,10
40,9,1,8,200,53,27
44,8,1,7,201,48,5
59,8,1,7,189,44,18
62,8,0,8,179,42,0
65,9,0,9,172,40,9
67,10,0,10,169,40,3
67,8,0,8,167,39,4
72,7,0,7,169,39,7
85,9,0,9,162,38,12
89,8,0,8,161,36,6
90,11,0,11,159,32,3
90,10,0,10,159,26,7
89,7,0,7,156,32,7
87,10,0,10,158,25,4
83,11,0,11,157,30,5
66,10,0,10,150,34,2
65,10,0,10,134,26,9
46,10,0,10,137,27,11
31,4,0,4,130,36,2
23,5,0,5,137,37,0
19,4,0,4,151,36,1
20,4,0,4,159,34,7
18,4,0,4,170,34,9
18,4,0,4,176,35,12
17,4,0,4,185,35,12
19,4,0,4,177,37,13
20,5,0,5,177,39,1
24,5,0,5,157,39,5
26,5,0,5,144,39,0
26,7,0,7,137,36,0
28,7,0,7,128,38,0
31,10,0,10,120,37,0
30,13,0,13,116,33,4
32,13,0,13,111,34,5
36,12,0,12,104,28,7
38,11,0,11,98,27,6
40,12,0,12,93,28,5
40,10,0,10,91,27,7
40,10,0,10,88,27,8
40,10,0,10,86,28,8
40,11,0,11,84,21,6
38,19,2,17,90,11,9
33,16,2,14,107,15,13
28,20,4,16,140,22,26
25,21,4,17,166,27,31
30,14,2,12,164,30,25
33,15,2,13,172,35,13
29,11,1,10,176,40,7
33,9,1,8,179,42,4
31,8,0,8,190,51,12
27,13,1,12,197,59,14
29,16,1,15,195,43,12
34,24,1,23,185,37,9
37,42,6,36,174,27,0
44,22,0,22,163,22,9
47,29,1,28,159,21,3
52,30,1,29,150,16,9
53,33,2,31,151,11,12
58,36,2,34,142,7,13
59,38,3,35,135,10,12
59,34,2,32,128,2,13
61,30,1,29,125,2,15
58,29,1,28,122,1,16
55,37,4,33,115,3,17
61,39,5,34,104,3,18
57,37,8,29,110,5,16
53,33,9,24,121,8,24
42,30,8,22,151,14,36
33,22,4,18,197,25,42
34,13,1,12,210,48,47
39,7,0,7,211,47,22
34,7,0,7,216,47,12
29,8,0,8,221,52,23
34,8,0,8,217,55,25
34,9,0,9,221,52,14
38,11,0,11,210,54,33
46,13,0,13,192,51,14
47,18,1,17,188,47,12
38,28,1,27,184,41,16
49,11,0,11,169,51,0
56,7,0,7,153,52,5
60,7,0,7,144,53,5
62,7,0,7,136,51,2
64,6,0,6,127,49,7
66,16.42109122,3.083507369,13.33758385,121,48,10
65,16.42109122,3.083507369,13.33758385,120,49,9
62,5,0,5,122,49,11
59,5,0,5,120,46,13
56,6,0,6,116,46,13
55,8,0,8,115,40,10
66,9,0,9,102,33,8
65,8,0,8,93,33,5
63,7,0,7,90,31,5
52,9,1,8,99,30,9
50,7,0,7,103,24.54770645,12.05310687
38,16.41868761,3.082739969,13.33594764,118,34,8
35,5,0,5,128,35,19
40,5,0,5,117,38,27
42,8,0,8,112,35,11
40,7,0,7,107,36,6
42,11,1,10,102,39,11
42,18,2,16,97,37,1
43,18,1,17,94,32,1
43,25,1,24,92,31,7
45,38,3,35,88,28,9
45,25,1,24,87,31,7
44,20,1,19,90,32,10
52,20,1,19,87,34,11
71,6,0,6,70,42,9
73,6,0,6,64,38,1
74,5,0,5,61,33,4
53,8,0,8,59,28,6
45,11,0,11,56,31,6
47,13,1,12,57,34,11
41,9,1,8,70,35,15
34,6,1,5,84,38,17
32,4,0,4,94,37,10
24,4,0,4,105,35,14
23,4,0,4,106,36,9
22,3,0,3,119,38,8
20,3,0,3,119,38,9
19,3,0,3,118,40,8
19,3,0,3,118,41,2
24,3,0,3,103,41,4
22,4,0,4,93,41,0
24,4,0,4,86,41,0
31,6,0,6,78,36,0
32,7,0,7,73,31,3
35,10,0,10,67,31,4
38,11,0,11,61,27,4
38,12,0,12,60,30,1
40,8,0,8,54,30,1
41,10,0,10,50,31,4
42,13,0,13,48,29,3
45,12,0,12,42,24,3
47,15,0,15,40,25,5
48,20,1,19,40,19,3
48,34,9,25,46,21,6
40,16,3,13,63,24,18
33,14,3,11,92,26,25
22,13,3,10,119,31,20
21,4,0,4,127,37,10
19,4,0,4,132,38,2
19,3,0,3,148,39,6
16,4,0,4,153,40,13
15,4,0,4,155,43,19
18,15,2,13,156,40,22
24,18,1,17,139,39,9
37,19,0,19,129,36,0
43,22,0,22,123,32,0
49,22,0,22,119,39,0
54,29,1,28,120,35,5
55,28,1,27,119,34,6
56,48,5,43,116,32,17
55,54,8,46,104,19,10
39,32,1,31,98,17,8
35,31,1,30,93,19,3
43,20,0,20,85,16,4
49,26,0,26,79,6,5
56,28,1,27,75,4,10
53,35,3,32,72,3,12
43,36,7,29,79,6,13
39,28,7,21,92,9,20
35,21,5,16,122,16,44
28,19,4,15,145,19,35
24,14,2,12,162,24.55983529,34
23,14,2,12,182,24.55983529,33
24,16.41617625,3.078878909,13.33729734,192,34,24
25,19,2,17,187,41,7
24,14,1,13,192,50,9
24,17,1,16,194,55,14
30,25,1,24,178,50,0
42,25,1,24,164,44,5
46,31,1,30,155,39,0
53,29,0,29,151,35,0
57,43,1,42,149,33,4
58,39,1,38,145,27,10
60,44,2,42,136,15,12
63,50,4,46,133,13,12
65,44,3,41,127,12,15
67,39,3,36,122,4,17
68,37,4,33,110,2,15
71,37,4,33,106,1,12
73,33,4,29,101,1,13
69,41,12,29,97,1,17
65,62,28,34,108,2,21
63,88,42,46,117,2,32
57,96,44,52,130,3,32
48,82,31,51,155,7,36
53,55,14,41,181,14,43
44,24,4,20,207,28,32
49,11,1,10,203,36,12
46,9,1,8,208,36,0
47,11,1,10,206,39,23
48,11,0,11,199,39,0
54,11,0,11,194,37,11
59,9,0,9,189,33,5
60,8,0,8,188,33,4
65,8,0,8,186,34,2
72,6,0,6,181,32,6
59,7,0,7,188,34,8
76,6,0,6,179,36,11
76,6,0,6,186,31,13
77,5,0,5,187,29,14
77,3,0,3,189,33,14
77,3,0,3,192,32,8
77,3,0,3,193,32,12
78,5,0,5,195,31,11
80,4,0,4,193,28,13
87,5,0,5,187,28,11
70,16,1,15,164,14,10
65,26,3,23,168,12,10
53,28,4,24,181,12,27
48,32,6,26,199,19,34
43,26,4,22,222,33,43
48,22,2,20,218,35,25
68,6,0,6,165,33,1
73,5,0,5,142,39,0
71,4,0,4,131,42,0
68,4,0,4,123,45,0
75,5,0,5,116,44,0
72,3,0,3,110,43,2
77,3,0,3,104,43,3
75,3,0,3,90,42,3
87,3,0,3,82,41,3
87,3,0,3,81,39,2
85,2,0,2,78,40,1
88,2,0,2,77,37,2
88,2,0,2,74,36,2
86,2,0,2,70,35,1
88,2,0,2,66,34,0
89,2,0,2,61,32,0
88,2,0,2,49,32,0
88,3,0,3,40,34,0
88,3,0,3,28,33,0
90,4,0,4,26,33,0
90,5,0,5,28,33,0
90,4,0,4,13,33,0
92,6,0,6,10,31,1
92,7,1,6,10,30,0
92,7,1,6,26,29,2
90,6,1,5,26,32,8
89,7,1,6,32,32,5
87,7,0,7,35,32,6
86,9,0,9,38,32,9
86,11,0,11,40,31,5
84,11,0,11,42,31,6
83,10,0,10,44,30,3
81,10,0,10,45,29,4
81,10,0,10,45,28,4
79,8,0,8,44,26,6
82,7,0,7,40,24,8
81,16.41800511,3.078204213,13.3398009,36,24,5
80,16.41800511,3.078204213,13.3398009,35,24,6
79,9,0,9,34,22,5
79,11,0,11,34,17,6
79,14,0,14,36,11,12
74,20,2,18,42,11,12
70,24,5,19,54,11,8
61,17,4,13,72,17,10
57,10,2,8,92,22,16
51,16.41772172,3.077960182,13.33976154,103,25,24
52,6,1,5,104,29,30
50,5,0,5,104,24.57029138,10
50,5,0,5,105,29,5
49,5,0,5,108,31,1
50,6,0,6,109,31,12
51,7,0,7,106,30,11
53,13,2,11,104,31,9
55,14,2,12,100,35,8
55,11,1,10,96,38,1
59,8,0,8,92,35,1
60,7,0,7,92,37,4
60,7,0,7,91,36,6
60,7,0,7,91,33,7
60,6,0,6,90,32,5
62,6,0,6,89,27,4
63,6,0,6,88,26,5
62,8,0,8,87,26,4
65,12,0,12,87,23,9
70,15,0,15,85,9,8
72,20,2,18,86,5,6
64,23,4,19,92,12,9
64,16,2,14,95,14,11
61,14,2,12,101,15,13
58,12,1,11,111,15,15
55,9,1,8,119,22,21
70,8,0,8,115,25,21
69,9,1,8,121,27,9
68,8,1,7,122,25,8
65,9,1,8,128,22,11
67,8,0,8,125,26,16
70,8,0,8,120,30,8
76,16,0,16,111,19,5
76,26,2,24,109,13,9
74,23,1,22,107,11,16
75,26,1,25,106,12,16
78,21,1,20,101,11,16
81,20,0,20,100,11,14
